"","영화","날짜","스크린수","관객수","누적관객수","개봉일"
"1","택시운전사","2017-07-03","1",182,182,0
"2","택시운전사","2017-07-10","8",4036,4218,0
"3","택시운전사","2017-07-11","83",16990,21208,0
"4","택시운전사","2017-07-12","23",4785,25993,0
"5","택시운전사","2017-07-13","19",3613,29606,0
"6","택시운전사","2017-07-14","27",5003,34609,0
"7","택시운전사","2017-07-15","9",2216,36825,0
"8","택시운전사","2017-07-17","18",3125,39950,0
"9","택시운전사","2017-07-18","73",12873,52823,0
"10","택시운전사","2017-07-19","45",6420,59243,0
"11","택시운전사","2017-07-20","34",4653,63896,0
"12","택시운전사","2017-07-21","21",3055,66951,0
"13","택시운전사","2017-07-22","10",2709,69660,0
"14","택시운전사","2017-07-24","5",1089,70749,0
"15","택시운전사","2017-07-25","27",5226,75975,0
"16","택시운전사","2017-07-26","4",705,76680,0
"17","택시운전사","2017-07-27","32",6513,83193,0
"18","택시운전사","2017-07-28","9",896,84089,0
"19","택시운전사","2017-07-29","7",1575,85664,0
"20","택시운전사","2017-07-31","7",1049,86713,0
"21","택시운전사","2017-08-02","1,446",698088,784801,1
"22","택시운전사","2017-08-03","1,553",651779,1436580,2
"23","택시운전사","2017-08-04","1,677",707113,2143693,3
"24","택시운전사","2017-08-05","1,827",1123443,3267136,4
"25","택시운전사","2017-08-06","1,906",1093911,4361047,5
"26","택시운전사","2017-08-07","1,745",562755,4923802,6
"27","택시운전사","2017-08-08","1,753",484078,5407880,7
"28","택시운전사","2017-08-09","1,446",404935,5812815,8
"29","택시운전사","2017-08-10","1,353",355182,6167997,9
"30","택시운전사","2017-08-11","1,356",382042,6550039,10
"31","택시운전사","2017-08-12","1,410",706852,7256891,11
"32","택시운전사","2017-08-13","1,385",680919,7937810,12
"33","택시운전사","2017-08-14","1,291",508734,8446544,13
"34","택시운전사","2017-08-15","1,040",577296,9023840,14
"35","택시운전사","2017-08-16","986",204856,9228696,15
"36","택시운전사","2017-08-17","934",174377,9403073,16
"37","택시운전사","2017-08-18","956",188683,9591756,17
"38","택시운전사","2017-08-19","1,033",371597,9963353,18
"39","택시운전사","2017-08-20","1,022",389631,10352984,19
"40","택시운전사","2017-08-21","933",149816,10502800,20
"41","택시운전사","2017-08-22","954",132430,10635230,21
"42","택시운전사","2017-08-23","833",105168,10740398,22
"43","택시운전사","2017-08-24","802",100785,10841183,23
"44","택시운전사","2017-08-25","831",110401,10951584,24
"45","택시운전사","2017-08-26","861",218682,11170266,25
"46","택시운전사","2017-08-27","861",198166,11368432,26
"47","택시운전사","2017-08-28","827",65223,11433655,27
"48","택시운전사","2017-08-29","863",64626,11498281,28
"49","택시운전사","2017-08-30","630",79377,11577658,29
"50","택시운전사","2017-08-31","615",47308,11624966,30
"51","택시운전사","2017-09-01","625",48618,11673584,31
"52","택시운전사","2017-09-02","683",98741,11772325,32
"53","택시운전사","2017-09-03","671",90659,11862984,33
"54","택시운전사","2017-09-04","646",29312,11892296,34
"55","택시운전사","2017-09-05","638",27143,11919439,35
"56","택시운전사","2017-09-06","514",22063,11941502,36
"57","택시운전사","2017-09-07","498",19589,11961091,37
"58","택시운전사","2017-09-08","511",20760,11981851,38
"59","택시운전사","2017-09-09","501",41541,12023392,39
"60","택시운전사","2017-09-10","492",44627,12068019,40
"61","택시운전사","2017-09-11","513",17335,12085354,41
"62","택시운전사","2017-09-12","507",13721,12099075,42
"63","택시운전사","2017-09-13","502",12475,12111550,43
"64","택시운전사","2017-09-14","298",6474,12118024,44
"65","택시운전사","2017-09-15","310",7152,12125176,45
"66","택시운전사","2017-09-16","321",13398,12138574,46
"67","택시운전사","2017-09-17","319",14102,12152676,47
"68","택시운전사","2017-09-18","311",4939,12157615,48
"69","택시운전사","2017-09-19","320",4847,12162462,49
"70","택시운전사","2017-09-20","305",4197,12166659,50
"71","택시운전사","2017-09-21","124",1853,12168512,51
"72","택시운전사","2017-09-22","128",1809,12170321,52
"73","택시운전사","2017-09-23","133",3079,12173400,53
"74","택시운전사","2017-09-24","128",3353,12176753,54
"75","택시운전사","2017-09-25","132",1248,12178001,55
"76","택시운전사","2017-09-26","127",1362,12179363,56
"77","택시운전사","2017-09-27","40",808,12180171,57
"78","택시운전사","2017-09-28","25",380,12180551,58
"79","택시운전사","2017-09-29","26",272,12180823,59
"80","택시운전사","2017-09-30","23",527,12181350,60
"81","택시운전사","2017-10-01","27",817,12182167,61
"82","택시운전사","2017-10-02","35",995,12183162,62
"83","택시운전사","2017-10-03","19",401,12183563,63
"84","택시운전사","2017-10-04","16",442,12184005,64
"85","택시운전사","2017-10-05","15",479,12184484,65
"86","택시운전사","2017-10-06","12",313,12184797,66
"87","택시운전사","2017-10-07","12",244,12185041,67
"88","택시운전사","2017-10-08","14",149,12185190,68
"89","택시운전사","2017-10-09","16",256,12185446,69
"90","택시운전사","2017-10-10","10",58,12185504,70
"91","택시운전사","2017-10-11","9",57,12185561,71
"92","택시운전사","2017-10-12","2",2,12185563,72
"93","택시운전사","2017-10-13","3",139,12185702,73
"94","택시운전사","2017-10-16","2",6,12185708,74
"95","택시운전사","2017-10-17","2",9,12185717,75
"96","택시운전사","2017-10-18","2",9,12185726,76
"97","택시운전사","2017-10-19","2",59,12185785,77
"98","택시운전사","2017-10-20","2",201,12185986,78
"99","택시운전사","2017-10-21","2",6,12185992,79
"100","택시운전사","2017-10-22","1",2,12185994,80
"101","택시운전사","2017-10-23","1",3,12185997,81
"102","택시운전사","2017-10-24","1",1,12185998,82
"103","택시운전사","2017-10-31","1",1,12185999,83
"104","택시운전사","2017-11-01","1",2,12186001,84
"105","택시운전사","2017-11-13","1",0,12186001,85
"106","택시운전사","2017-11-16","1",0,12186001,86
"107","택시운전사","2017-11-28","1",0,12186001,87
"108","택시운전사","2017-11-29","1",100,12186101,88
"109","택시운전사","2017-12-09","1",19,12186120,89
"110","택시운전사","2017-12-10","1",27,12186147,90
"111","택시운전사","2017-12-15","1",180,12186327,91
"112","택시운전사","2017-12-29","1",0,12186327,92
"113","택시운전사","2018-01-19","7",63,12186390,93
"114","택시운전사","2018-01-20","7",87,12186477,94
"115","택시운전사","2018-01-21","6",152,12186629,95
"116","택시운전사","2018-01-26","1",9,12186638,96
"117","택시운전사","2018-01-27","3",40,12186678,97
"118","택시운전사","2018-01-28","2",6,12186684,98
"119","택시운전사","2018-04-11","3",6,12186690,99
"120","택시운전사","2018-04-12","2",6,12186696,100
"121","택시운전사","2018-04-13","1",5,12186701,101
"122","택시운전사","2018-04-14","1",5,12186706,102
"123","택시운전사","2018-04-15","2",14,12186720,103
"124","택시운전사","2018-04-16","1",2,12186722,104
"125","택시운전사","2018-04-18","1",2,12186724,105
"126","택시운전사","2018-04-19","1",1,12186725,106
"127","택시운전사","2018-04-21","1",25,12186750,107
"128","택시운전사","2018-04-22","1",6,12186756,108
"129","택시운전사","2018-04-23","1",7,12186763,109
"130","택시운전사","2018-04-24","2",2,12186765,110
"131","택시운전사","2018-05-18","1",100,12186865,111
"132","택시운전사","2018-05-29","2",480,12187345,112
"133","택시운전사","2018-05-30","2",520,12187865,113
"134","택시운전사","2018-05-31","2",500,12188365,114
"135","택시운전사","2018-06-05","1",120,12188485,115
"136","택시운전사","2018-06-07","2",270,12188755,116
"137","택시운전사","2018-06-08","2",270,12189025,117
"138","택시운전사","2018-06-21","1",116,12189141,118
"139","택시운전사","2018-06-29","1",54,12189195,119
"140","택시운전사","2018-07-06","1",0,12189195,120
"141","신과함께-죄와 벌","2017-12-11","1",389,389,0
"142","신과함께-죄와 벌","2017-12-12","4",2027,2416,0
"143","신과함께-죄와 벌","2017-12-14","34",7906,10322,0
"144","신과함께-죄와 벌","2017-12-15","1",150,10472,0
"145","신과함께-죄와 벌","2017-12-18","15",5075,15547,0
"146","신과함께-죄와 벌","2017-12-19","3",652,16199,0
"147","신과함께-죄와 벌","2017-12-20","1,538",406365,422564,1
"148","신과함께-죄와 벌","2017-12-21","1,582",401449,824013,2
"149","신과함께-죄와 벌","2017-12-22","1,653",497810,1321823,3
"150","신과함께-죄와 벌","2017-12-23","1,818",968372,2290195,4
"151","신과함께-죄와 벌","2017-12-24","1,887",1268537,3558732,5
"152","신과함께-죄와 벌","2017-12-25","1,912",1212822,4771554,6
"153","신과함께-죄와 벌","2017-12-26","1,662",430026,5201580,7
"154","신과함께-죄와 벌","2017-12-27","1,428",495106,5696686,8
"155","신과함께-죄와 벌","2017-12-28","1,505",377807,6074493,9
"156","신과함께-죄와 벌","2017-12-29","1,565",532755,6607248,10
"157","신과함께-죄와 벌","2017-12-30","1,666",908290,7515538,11
"158","신과함께-죄와 벌","2017-12-31","1,663",1023957,8539495,12
"159","신과함께-죄와 벌","2018-01-01","1,644",916652,9456147,13
"160","신과함께-죄와 벌","2018-01-02","1,446",294339,9750486,14
"161","신과함께-죄와 벌","2018-01-03","1,241",215987,9966473,15
"162","신과함께-죄와 벌","2018-01-04","1,226",217032,10183505,16
"163","신과함께-죄와 벌","2018-01-05","1,211",268181,10451686,17
"164","신과함께-죄와 벌","2018-01-06","1,260",548337,11000023,18
"165","신과함께-죄와 벌","2018-01-07","1,258",502236,11502259,19
"166","신과함께-죄와 벌","2018-01-08","1,171",174358,11676617,20
"167","신과함께-죄와 벌","2018-01-09","1,182",156343,11832960,21
"168","신과함께-죄와 벌","2018-01-10","1,170",141824,11974784,22
"169","신과함께-죄와 벌","2018-01-11","891",123571,12098355,23
"170","신과함께-죄와 벌","2018-01-12","920",146494,12244849,24
"171","신과함께-죄와 벌","2018-01-13","984",310297,12555146,25
"172","신과함께-죄와 벌","2018-01-14","985",288900,12844046,26
"173","신과함께-죄와 벌","2018-01-15","910",1e+05,12944046,27
"174","신과함께-죄와 벌","2018-01-16","948",95401,13039447,28
"175","신과함께-죄와 벌","2018-01-17","619",71179,13110626,29
"176","신과함께-죄와 벌","2018-01-18","645",68978,13179604,30
"177","신과함께-죄와 벌","2018-01-19","645",76062,13255666,31
"178","신과함께-죄와 벌","2018-01-20","650",149485,13405151,32
"179","신과함께-죄와 벌","2018-01-21","634",136973,13542124,33
"180","신과함께-죄와 벌","2018-01-22","623",50149,13592273,34
"181","신과함께-죄와 벌","2018-01-23","639",49604,13641877,35
"182","신과함께-죄와 벌","2018-01-24","550",39238,13681115,36
"183","신과함께-죄와 벌","2018-01-25","553",36900,13718015,37
"184","신과함께-죄와 벌","2018-01-26","590",42076,13760091,38
"185","신과함께-죄와 벌","2018-01-27","698",94386,13854477,39
"186","신과함께-죄와 벌","2018-01-28","704",93732,13948209,40
"187","신과함께-죄와 벌","2018-01-29","616",34521,13982730,41
"188","신과함께-죄와 벌","2018-01-30","626",34197,14016927,42
"189","신과함께-죄와 벌","2018-01-31","504",34634,14051561,43
"190","신과함께-죄와 벌","2018-02-01","471",19625,14071186,44
"191","신과함께-죄와 벌","2018-02-02","492",23286,14094472,45
"192","신과함께-죄와 벌","2018-02-03","534",52378,14146850,46
"193","신과함께-죄와 벌","2018-02-04","533",49347,14196197,47
"194","신과함께-죄와 벌","2018-02-05","487",19098,14215295,48
"195","신과함께-죄와 벌","2018-02-06","501",17177,14232472,49
"196","신과함께-죄와 벌","2018-02-07","530",17338,14249810,50
"197","신과함께-죄와 벌","2018-02-08","415",12209,14262019,51
"198","신과함께-죄와 벌","2018-02-09","430",14392,14276411,52
"199","신과함께-죄와 벌","2018-02-10","456",29904,14306315,53
"200","신과함께-죄와 벌","2018-02-11","449",27634,14333949,54
"201","신과함께-죄와 벌","2018-02-12","439",10415,14344364,55
"202","신과함께-죄와 벌","2018-02-13","440",11228,14355592,56
"203","신과함께-죄와 벌","2018-02-14","103",3514,14359106,57
"204","신과함께-죄와 벌","2018-02-15","119",7133,14366239,58
"205","신과함께-죄와 벌","2018-02-16","131",10816,14377055,59
"206","신과함께-죄와 벌","2018-02-17","149",13185,14390240,60
"207","신과함께-죄와 벌","2018-02-18","139",7870,14398110,61
"208","신과함께-죄와 벌","2018-02-19","131",3037,14401147,62
"209","신과함께-죄와 벌","2018-02-20","126",1920,14403067,63
"210","신과함께-죄와 벌","2018-02-21","102",1568,14404635,64
"211","신과함께-죄와 벌","2018-02-22","61",806,14405441,65
"212","신과함께-죄와 벌","2018-02-23","59",695,14406136,66
"213","신과함께-죄와 벌","2018-02-24","52",1274,14407410,67
"214","신과함께-죄와 벌","2018-02-25","53",1277,14408687,68
"215","신과함께-죄와 벌","2018-02-26","56",629,14409316,69
"216","신과함께-죄와 벌","2018-02-27","54",709,14410025,70
"217","신과함께-죄와 벌","2018-02-28","3",48,14410073,71
"218","신과함께-죄와 벌","2018-03-01","3",122,14410195,72
"219","신과함께-죄와 벌","2018-03-02","2",27,14410222,73
"220","신과함께-죄와 벌","2018-03-03","2",60,14410282,74
"221","신과함께-죄와 벌","2018-03-04","3",78,14410360,75
"222","신과함께-죄와 벌","2018-03-05","4",31,14410391,76
"223","신과함께-죄와 벌","2018-03-06","3",31,14410422,77
"224","신과함께-죄와 벌","2018-03-07","3",20,14410442,78
"225","신과함께-죄와 벌","2018-03-08","3",17,14410459,79
"226","신과함께-죄와 벌","2018-03-09","3",14,14410473,80
"227","신과함께-죄와 벌","2018-03-10","1",21,14410494,81
"228","신과함께-죄와 벌","2018-03-11","1",9,14410503,82
"229","신과함께-죄와 벌","2018-03-12","1",7,14410510,83
"230","신과함께-죄와 벌","2018-03-13","2",7,14410517,84
"231","신과함께-죄와 벌","2018-03-14","4",11,14410528,85
"232","신과함께-죄와 벌","2018-03-15","2",3,14410531,86
"233","신과함께-죄와 벌","2018-03-16","1",1,14410532,87
"234","신과함께-죄와 벌","2018-03-19","3",6,14410538,88
"235","신과함께-죄와 벌","2018-03-20","2",6,14410544,89
"236","신과함께-죄와 벌","2018-03-26","2",4,14410548,90
"237","신과함께-죄와 벌","2018-03-27","2",5,14410553,91
"238","신과함께-죄와 벌","2018-03-28","3",4,14410557,92
"239","신과함께-죄와 벌","2018-03-29","1",1,14410558,93
"240","신과함께-죄와 벌","2018-03-30","1",7,14410565,94
"241","신과함께-죄와 벌","2018-04-03","1",2,14410567,95
"242","신과함께-죄와 벌","2018-04-04","1",4,14410571,96
"243","신과함께-죄와 벌","2018-04-22","1",67,14410638,97
"244","신과함께-죄와 벌","2018-04-27","1",116,14410754,98
"245","신과함께-죄와 벌","2018-08-15","1",598,14411352,99
"246","신과함께-죄와 벌","2018-10-10","2",4,14411356,100
"247","신과함께-죄와 벌","2018-10-12","1",5,14411361,101
"248","신과함께-죄와 벌","2018-10-13","1",1,14411362,102
"249","신과함께-죄와 벌","2018-10-15","1",3,14411365,103
"250","신과함께-죄와 벌","2018-10-16","2",90,14411455,104
"251","신과함께-죄와 벌","2018-10-17","1",1,14411456,105
"252","신과함께-죄와 벌","2018-10-21","2",21,14411477,106
"253","신과함께-죄와 벌","2018-10-22","1",1,14411478,107
"254","신과함께-죄와 벌","2018-10-27","2",6,14411484,108
"255","신과함께-죄와 벌","2018-10-28","3",18,14411502,109
"256","신과함께-죄와 벌","2018-11-12","1",0,14411502,110
"257","신과함께-죄와 벌","2018-11-17","1",0,14411502,111
"258","공조","2017-01-05","2",564,564,0
"259","공조","2017-01-10","23",4101,4665,0
"260","공조","2017-01-11","9",1816,6481,0
"261","공조","2017-01-12","12",3203,9684,0
"262","공조","2017-01-14","8",1772,11456,0
"263","공조","2017-01-15","6",2036,13492,0
"264","공조","2017-01-17","24",1114,14606,0
"265","공조","2017-01-18","900",151845,166451,1
"266","공조","2017-01-19","918",141569,308020,2
"267","공조","2017-01-20","938",160116,468136,3
"268","공조","2017-01-21","976",333625,801761,4
"269","공조","2017-01-22","972",352228,1153989,5
"270","공조","2017-01-23","928",138338,1292327,6
"271","공조","2017-01-24","955",135694,1428021,7
"272","공조","2017-01-25","987",193551,1621572,8
"273","공조","2017-01-26","991",238425,1859997,9
"274","공조","2017-01-27","1,177",472221,2332218,10
"275","공조","2017-01-28","1,279",664830,2997048,11
"276","공조","2017-01-29","1,383",797994,3795042,12
"277","공조","2017-01-30","1,392",761071,4556113,13
"278","공조","2017-01-31","1,094",304003,4860116,14
"279","공조","2017-02-01","1,075",189579,5049695,15
"280","공조","2017-02-02","998",174342,5224037,16
"281","공조","2017-02-03","1,022",202908,5426945,17
"282","공조","2017-02-04","1,099",442556,5869501,18
"283","공조","2017-02-05","1,094",402889,6272390,19
"284","공조","2017-02-06","1,018",124410,6396800,20
"285","공조","2017-02-07","1,022",118066,6514866,21
"286","공조","2017-02-08","942",113012,6627878,22
"287","공조","2017-02-09","742",90606,6718484,23
"288","공조","2017-02-10","748",104469,6822953,24
"289","공조","2017-02-11","803",225583,7048536,25
"290","공조","2017-02-12","811",213339,7261875,26
"291","공조","2017-02-13","729",65398,7327273,27
"292","공조","2017-02-14","753",69610,7396883,28
"293","공조","2017-02-15","511",40953,7437836,29
"294","공조","2017-02-16","557",36022,7473858,30
"295","공조","2017-02-17","536",41352,7515210,31
"296","공조","2017-02-18","539",80982,7596192,32
"297","공조","2017-02-19","521",71218,7667410,33
"298","공조","2017-02-20","513",26372,7693782,34
"299","공조","2017-02-21","510",25227,7719009,35
"300","공조","2017-02-22","339",15745,7734754,36
"301","공조","2017-02-23","340",10867,7745621,37
"302","공조","2017-02-24","326",10561,7756182,38
"303","공조","2017-02-25","335",20672,7776854,39
"304","공조","2017-02-26","336",19474,7796328,40
"305","공조","2017-02-27","318",8492,7804820,41
"306","공조","2017-02-28","234",6775,7811595,42
"307","공조","2017-03-01","36",2267,7813862,43
"308","공조","2017-03-02","33",330,7814192,44
"309","공조","2017-03-03","34",413,7814605,45
"310","공조","2017-03-04","31",1073,7815678,46
"311","공조","2017-03-05","32",843,7816521,47
"312","공조","2017-03-06","32",290,7816811,48
"313","공조","2017-03-07","31",277,7817088,49
"314","공조","2017-03-08","7",46,7817134,50
"315","공조","2017-03-09","5",165,7817299,51
"316","공조","2017-03-10","3",13,7817312,52
"317","공조","2017-03-11","2",14,7817326,53
"318","공조","2017-03-12","2",16,7817342,54
"319","공조","2017-03-13","4",21,7817363,55
"320","공조","2017-03-14","5",73,7817436,56
"321","공조","2017-03-15","4",10,7817446,57
"322","공조","2017-03-31","1",0,7817446,58
"323","공조","2017-08-10","1",134,7817580,59
"324","공조","2017-11-15","1",0,7817580,60
"325","공조","2017-11-19","1",0,7817580,61
"326","공조","2017-12-08","1",17,7817597,62
"327","공조","2017-12-09","1",21,7817618,63
"328","공조","2018-10-27","1",17,7817635,64
"329","공조","2018-10-28","1",19,7817654,65
"330","범죄도시","2017-09-12","1",126,126,0
"331","범죄도시","2017-09-14","2",498,624,0
"332","범죄도시","2017-09-15","3",1019,1643,0
"333","범죄도시","2017-09-18","13",4025,5668,0
"334","범죄도시","2017-09-19","35",7323,12991,0
"335","범죄도시","2017-09-20","7",1745,14736,0
"336","범죄도시","2017-09-21","20",4059,18795,0
"337","범죄도시","2017-09-22","1",150,18945,0
"338","범죄도시","2017-09-23","10",1475,20420,0
"339","범죄도시","2017-09-24","9",2119,22539,0
"340","범죄도시","2017-09-25","4",400,22939,0
"341","범죄도시","2017-09-26","18",2905,25844,0
"342","범죄도시","2017-09-28","10",1790,27634,0
"343","범죄도시","2017-09-29","2",310,27944,0
"344","범죄도시","2017-09-30","6",600,28544,0
"345","범죄도시","2017-10-01","13",1864,30408,0
"346","범죄도시","2017-10-03","600",164399,194807,1
"347","범죄도시","2017-10-04","687",206458,401265,2
"348","범죄도시","2017-10-05","871",277219,678484,3
"349","범죄도시","2017-10-06","1,007",333298,1011782,4
"350","범죄도시","2017-10-07","1,158",369907,1381689,5
"351","범죄도시","2017-10-08","1,315",425472,1807161,6
"352","범죄도시","2017-10-09","1,266",403114,2210275,7
"353","범죄도시","2017-10-10","1,020",178322,2388597,8
"354","범죄도시","2017-10-11","1,045",177691,2566288,9
"355","범죄도시","2017-10-12","898",155478,2721766,10
"356","범죄도시","2017-10-13","974",195106,2916872,11
"357","범죄도시","2017-10-14","1,127",396245,3313117,12
"358","범죄도시","2017-10-15","1,116",360349,3673466,13
"359","범죄도시","2017-10-16","1,039",132489,3805955,14
"360","범죄도시","2017-10-17","1,070",127832,3933787,15
"361","범죄도시","2017-10-18","1,074",128403,4062190,16
"362","범죄도시","2017-10-19","826",117775,4179965,17
"363","범죄도시","2017-10-20","885",166800,4346765,18
"364","범죄도시","2017-10-21","994",321311,4668076,19
"365","범죄도시","2017-10-22","986",299116,4967192,20
"366","범죄도시","2017-10-23","906",109005,5076197,21
"367","범죄도시","2017-10-24","914",100208,5176405,22
"368","범죄도시","2017-10-25","696",111470,5287875,23
"369","범죄도시","2017-10-26","662",81135,5369010,24
"370","범죄도시","2017-10-27","687",107996,5477006,25
"371","범죄도시","2017-10-28","768",190514,5667520,26
"372","범죄도시","2017-10-29","760",177537,5845057,27
"373","범죄도시","2017-10-30","708",74380,5919437,28
"374","범죄도시","2017-10-31","717",73257,5992694,29
"375","범죄도시","2017-11-01","728",64455,6057149,30
"376","범죄도시","2017-11-02","550",45275,6102424,31
"377","범죄도시","2017-11-03","575",62666,6165090,32
"378","범죄도시","2017-11-04","610",109027,6274117,33
"379","범죄도시","2017-11-05","605",94881,6368998,34
"380","범죄도시","2017-11-06","547",37951,6406949,35
"381","범죄도시","2017-11-07","564",36032,6442981,36
"382","범죄도시","2017-11-08","555",33468,6476449,37
"383","범죄도시","2017-11-09","497",26828,6503277,38
"384","범죄도시","2017-11-10","517",36787,6540064,39
"385","범죄도시","2017-11-11","540",73842,6613906,40
"386","범죄도시","2017-11-12","535",63384,6677290,41
"387","범죄도시","2017-11-13","521",24824,6702114,42
"388","범죄도시","2017-11-14","524",22373,6724487,43
"389","범죄도시","2017-11-15","485",13716,6738203,44
"390","범죄도시","2017-11-16","321",10618,6748821,45
"391","범죄도시","2017-11-17","361",14038,6762859,46
"392","범죄도시","2017-11-18","375",26516,6789375,47
"393","범죄도시","2017-11-19","381",22897,6812272,48
"394","범죄도시","2017-11-20","369",9677,6821949,49
"395","범죄도시","2017-11-21","362",8436,6830385,50
"396","범죄도시","2017-11-22","246",4509,6834894,51
"397","범죄도시","2017-11-23","204",3568,6838462,52
"398","범죄도시","2017-11-24","227",5297,6843759,53
"399","범죄도시","2017-11-25","213",9109,6852868,54
"400","범죄도시","2017-11-26","212",9042,6861910,55
"401","범죄도시","2017-11-27","231",4419,6866329,56
"402","범죄도시","2017-11-28","235",4756,6871085,57
"403","범죄도시","2017-11-29","62",1295,6872380,58
"404","범죄도시","2017-11-30","51",912,6873292,59
"405","범죄도시","2017-12-01","49",867,6874159,60
"406","범죄도시","2017-12-02","48",1591,6875750,61
"407","범죄도시","2017-12-03","45",1299,6877049,62
"408","범죄도시","2017-12-04","51",541,6877590,63
"409","범죄도시","2017-12-05","49",507,6878097,64
"410","범죄도시","2017-12-06","49",609,6878706,65
"411","범죄도시","2017-12-07","10",106,6878812,66
"412","범죄도시","2017-12-08","10",104,6878916,67
"413","범죄도시","2017-12-09","7",306,6879222,68
"414","범죄도시","2017-12-10","9",289,6879511,69
"415","범죄도시","2017-12-11","9",85,6879596,70
"416","범죄도시","2017-12-12","10",74,6879670,71
"417","범죄도시","2017-12-13","10",110,6879780,72
"418","범죄도시","2017-12-14","1",8,6879788,73
"419","범죄도시","2017-12-15","1",10,6879798,74
"420","범죄도시","2017-12-17","1",24,6879822,75
"421","범죄도시","2017-12-18","1",8,6879830,76
"422","범죄도시","2017-12-19","1",11,6879841,77
"423","범죄도시","2018-01-19","10",172,6880013,78
"424","범죄도시","2018-01-20","5",153,6880166,79
"425","범죄도시","2018-01-21","8",185,6880351,80
"426","범죄도시","2018-01-26","2",13,6880364,81
"427","범죄도시","2018-01-27","3",39,6880403,82
"428","범죄도시","2018-01-28","3",100,6880503,83
"429","범죄도시","2018-04-03","1",2,6880505,84
"430","범죄도시","2018-04-04","1",4,6880509,85
"431","범죄도시","2018-04-05","1",1,6880510,86
"432","범죄도시","2018-04-06","1",1,6880511,87
"433","범죄도시","2018-04-08","1",1,6880512,88
"434","범죄도시","2018-04-09","1",4,6880516,89
"435","범죄도시","2018-04-10","1",3,6880519,90
"436","범죄도시","2018-04-11","1",6,6880525,91
"437","범죄도시","2018-04-15","1",4,6880529,92
"438","범죄도시","2018-04-19","1",6,6880535,93
"439","범죄도시","2018-05-01","1",0,6880535,94
"440","범죄도시","2018-05-07","1",0,6880535,95
"441","범죄도시","2018-05-16","1",0,6880535,96
"442","범죄도시","2018-07-05","1",0,6880535,97
"443","범죄도시","2018-11-01","1",2,6880537,98
"444","범죄도시","2018-11-02","1",3,6880540,99
"445","범죄도시","2018-11-06","1",2,6880542,100
"446","범죄도시","2018-11-08","1",1,6880543,101
"447","범죄도시","2018-11-09","1",1,6880544,102
"448","범죄도시","2018-11-12","1",2,6880546,103
"449","군함도","2017-07-10","1",414,414,0
"450","군함도","2017-07-17","1",532,946,0
"451","군함도","2017-07-19","9",2862,3808,0
"452","군함도","2017-07-20","19",3934,7742,0
"453","군함도","2017-07-21","3",554,8296,0
"454","군함도","2017-07-24","26",5412,13708,0
"455","군함도","2017-07-25","34",7921,21629,0
"456","군함도","2017-07-26","2,027",972161,993790,1
"457","군함도","2017-07-27","1,962",559467,1553257,2
"458","군함도","2017-07-28","1,989",582364,2135621,3
"459","군함도","2017-07-29","2,020",1016790,3152411,4
"460","군함도","2017-07-30","1,986",917669,4070080,5
"461","군함도","2017-07-31","1,841",468140,4538220,6
"462","군함도","2017-08-01","1,848",402094,4940314,7
"463","군함도","2017-08-02","1,109",248200,5188514,8
"464","군함도","2017-08-03","1,075",199203,5387717,9
"465","군함도","2017-08-04","1,018",187684,5575401,10
"466","군함도","2017-08-05","957",270522,5845923,11
"467","군함도","2017-08-06","922",234726,6080649,12
"468","군함도","2017-08-07","876",98728,6179377,13
"469","군함도","2017-08-08","857",84579,6263956,14
"470","군함도","2017-08-09","632",47910,6311866,15
"471","군함도","2017-08-10","569",38474,6350340,16
"472","군함도","2017-08-11","538",33018,6383358,17
"473","군함도","2017-08-12","501",43746,6427104,18
"474","군함도","2017-08-13","488",38889,6465993,19
"475","군함도","2017-08-14","471",31555,6497548,20
"476","군함도","2017-08-15","255",18748,6516296,21
"477","군함도","2017-08-16","258",10301,6526597,22
"478","군함도","2017-08-17","192",7677,6534274,23
"479","군함도","2017-08-18","187",6143,6540417,24
"480","군함도","2017-08-19","154",6849,6547266,25
"481","군함도","2017-08-20","148",7154,6554420,26
"482","군함도","2017-08-21","174",5576,6559996,27
"483","군함도","2017-08-22","190",6131,6566127,28
"484","군함도","2017-08-23","54",2050,6568177,29
"485","군함도","2017-08-24","71",3739,6571916,30
"486","군함도","2017-08-25","45",1922,6573838,31
"487","군함도","2017-08-26","30",1499,6575337,32
"488","군함도","2017-08-27","22",975,6576312,33
"489","군함도","2017-08-28","32",781,6577093,34
"490","군함도","2017-08-29","32",675,6577768,35
"491","군함도","2017-08-30","10",459,6578227,36
"492","군함도","2017-08-31","9",498,6578725,37
"493","군함도","2017-09-01","7",74,6578799,38
"494","군함도","2017-09-02","6",78,6578877,39
"495","군함도","2017-09-03","5",131,6579008,40
"496","군함도","2017-09-04","11",635,6579643,41
"497","군함도","2017-09-05","6",31,6579674,42
"498","군함도","2017-09-06","2",8,6579682,43
"499","군함도","2017-09-07","4",218,6579900,44
"500","군함도","2017-09-08","21",417,6580317,45
"501","군함도","2017-09-09","7",243,6580560,46
"502","군함도","2017-09-10","6",104,6580664,47
"503","군함도","2017-09-11","8",116,6580780,48
"504","군함도","2017-09-12","6",104,6580884,49
"505","군함도","2017-09-13","8",121,6581005,50
"506","군함도","2017-09-14","10",727,6581732,51
"507","군함도","2017-09-15","7",145,6581877,52
"508","군함도","2017-09-16","5",100,6581977,53
"509","군함도","2017-09-17","7",449,6582426,54
"510","군함도","2017-09-18","6",102,6582528,55
"511","군함도","2017-09-19","7",307,6582835,56
"512","군함도","2017-09-20","57",7502,6590337,57
"513","군함도","2017-09-21","9",552,6590889,58
"514","군함도","2017-09-22","6",104,6590993,59
"515","군함도","2017-09-23","5",100,6591093,60
"516","군함도","2017-09-24","5",100,6591193,61
"517","군함도","2017-09-25","7",106,6591299,62
"518","군함도","2017-09-26","7",105,6591404,63
"519","군함도","2017-09-27","7",122,6591526,64
"520","군함도","2017-09-28","5",100,6591626,65
"521","군함도","2017-09-29","1",69,6591695,66
"522","군함도","2017-10-01","1",80,6591775,67
"523","군함도","2017-10-02","1",80,6591855,68
"524","군함도","2017-10-03","1",80,6591935,69
"525","군함도","2017-10-04","1",80,6592015,70
"526","군함도","2017-10-13","1",136,6592151,71
"527","군함도","2017-11-14","1",0,6592151,72
"528","군함도","2017-11-17","1",0,6592151,73
"529","청년경찰","2017-07-14","1",401,401,0
"530","청년경찰","2017-07-18","1",8,409,0
"531","청년경찰","2017-07-19","7",1429,1838,0
"532","청년경찰","2017-07-24","7",1271,3109,0
"533","청년경찰","2017-07-25","26",5424,8533,0
"534","청년경찰","2017-07-27","22",4025,12558,0
"535","청년경찰","2017-07-29","4",1700,14258,0
"536","청년경찰","2017-07-31","14",2753,17011,0
"537","청년경찰","2017-08-01","18",3537,20548,0
"538","청년경찰","2017-08-02","18",1913,22461,0
"539","청년경찰","2017-08-03","12",2646,25107,0
"540","청년경찰","2017-08-05","4",1146,26253,0
"541","청년경찰","2017-08-06","14",3931,30184,0
"542","청년경찰","2017-08-07","19",4213,34397,0
"543","청년경찰","2017-08-08","18",2259,36656,0
"544","청년경찰","2017-08-09","1,102",308298,344954,1
"545","청년경찰","2017-08-10","1,065",277400,622354,2
"546","청년경찰","2017-08-11","1,046",304102,926456,3
"547","청년경찰","2017-08-12","1,058",517559,1444015,4
"548","청년경찰","2017-08-13","1,037",504156,1948171,5
"549","청년경찰","2017-08-14","1,019",372146,2320317,6
"550","청년경찰","2017-08-15","881",415335,2735652,7
"551","청년경찰","2017-08-16","823",174950,2910602,8
"552","청년경찰","2017-08-17","752",147050,3057652,9
"553","청년경찰","2017-08-18","813",168999,3226651,10
"554","청년경찰","2017-08-19","918",349115,3575766,11
"555","청년경찰","2017-08-20","918",330638,3906404,12
"556","청년경찰","2017-08-21","798",120575,4026979,13
"557","청년경찰","2017-08-22","817",113654,4140633,14
"558","청년경찰","2017-08-23","747",88872,4229505,15
"559","청년경찰","2017-08-24","717",89912,4319417,16
"560","청년경찰","2017-08-25","742",107490,4426907,17
"561","청년경찰","2017-08-26","779",218153,4645060,18
"562","청년경찰","2017-08-27","771",189064,4834124,19
"563","청년경찰","2017-08-28","716",61716,4895840,20
"564","청년경찰","2017-08-29","733",61798,4957638,21
"565","청년경찰","2017-08-30","627",87406,5045044,22
"566","청년경찰","2017-08-31","575",46169,5091213,23
"567","청년경찰","2017-09-01","640",56997,5148210,24
"568","청년경찰","2017-09-02","681",121617,5269827,25
"569","청년경찰","2017-09-03","686",107474,5377301,26
"570","청년경찰","2017-09-04","638",31458,5408759,27
"571","청년경찰","2017-09-05","633",29679,5438438,28
"572","청년경찰","2017-09-06","509",21507,5459945,29
"573","청년경찰","2017-09-07","503",18568,5478513,30
"574","청년경찰","2017-09-08","513",19545,5498058,31
"575","청년경찰","2017-09-09","519",42322,5540380,32
"576","청년경찰","2017-09-10","495",36483,5576863,33
"577","청년경찰","2017-09-11","479",13707,5590570,34
"578","청년경찰","2017-09-12","488",11126,5601696,35
"579","청년경찰","2017-09-13","490",9865,5611561,36
"580","청년경찰","2017-09-14","247",3506,5615067,37
"581","청년경찰","2017-09-15","248",4566,5619633,38
"582","청년경찰","2017-09-16","259",9802,5629435,39
"583","청년경찰","2017-09-17","251",9201,5638636,40
"584","청년경찰","2017-09-18","251",3142,5641778,41
"585","청년경찰","2017-09-19","255",3186,5644964,42
"586","청년경찰","2017-09-20","259",2816,5647780,43
"587","청년경찰","2017-09-21","48",432,5648212,44
"588","청년경찰","2017-09-22","49",495,5648707,45
"589","청년경찰","2017-09-23","54",945,5649652,46
"590","청년경찰","2017-09-24","53",904,5650556,47
"591","청년경찰","2017-09-25","46",269,5650825,48
"592","청년경찰","2017-09-26","42",257,5651082,49
"593","청년경찰","2017-09-27","9",245,5651327,50
"594","청년경찰","2017-09-28","7",337,5651664,51
"595","청년경찰","2017-09-29","9",445,5652109,52
"596","청년경찰","2017-09-30","8",158,5652267,53
"597","청년경찰","2017-10-01","8",245,5652512,54
"598","청년경찰","2017-10-02","11",273,5652785,55
"599","청년경찰","2017-10-03","3",7,5652792,56
"600","청년경찰","2017-10-04","3",25,5652817,57
"601","청년경찰","2017-10-05","2",20,5652837,58
"602","청년경찰","2017-10-06","3",118,5652955,59
"603","청년경찰","2017-10-07","2",19,5652974,60
"604","청년경찰","2017-10-08","2",22,5652996,61
"605","청년경찰","2017-10-09","3",105,5653101,62
"606","청년경찰","2017-10-12","1",8,5653109,63
"607","청년경찰","2017-10-14","1",2,5653111,64
"608","청년경찰","2017-10-15","2",12,5653123,65
"609","청년경찰","2017-10-17","1",2,5653125,66
"610","청년경찰","2017-10-19","1",2,5653127,67
"611","청년경찰","2017-10-21","1",3,5653130,68
"612","청년경찰","2017-10-27","2",5,5653135,69
"613","청년경찰","2017-10-31","1",135,5653270,70
"614","청년경찰","2017-11-04","1",0,5653270,71
"615","청년경찰","2017-11-21","1",0,5653270,72
"616","청년경찰","2017-12-21","1",0,5653270,73
"617","청년경찰","2018-08-04","1",174,5653444,74
"618","청년경찰","2018-11-07","1",0,5653444,75
"619","더 킹","2017-01-06","1",274,274,0
"620","더 킹","2017-01-12","5",1197,1471,0
"621","더 킹","2017-01-13","26",5509,6980,0
"622","더 킹","2017-01-14","1",253,7233,0
"623","더 킹","2017-01-16","13",2885,10118,0
"624","더 킹","2017-01-17","23",3894,14012,0
"625","더 킹","2017-01-18","1,125",288966,302978,1
"626","더 킹","2017-01-19","1,147",238039,541017,2
"627","더 킹","2017-01-20","1,188",261528,802545,3
"628","더 킹","2017-01-21","1,310",524841,1327386,4
"629","더 킹","2017-01-22","1,289",525513,1852899,5
"630","더 킹","2017-01-23","1,169",163491,2016390,6
"631","더 킹","2017-01-24","1,181",156749,2173139,7
"632","더 킹","2017-01-25","1,071",199750,2372889,8
"633","더 킹","2017-01-26","1,046",212532,2585421,9
"634","더 킹","2017-01-27","1,118",326785,2912206,10
"635","더 킹","2017-01-28","1,113",429935,3342141,11
"636","더 킹","2017-01-29","1,117",493218,3835359,12
"637","더 킹","2017-01-30","1,081",430477,4265836,13
"638","더 킹","2017-01-31","982",144604,4410440,14
"639","더 킹","2017-02-01","909",92503,4502943,15
"640","더 킹","2017-02-02","827",78761,4581704,16
"641","더 킹","2017-02-03","837",86879,4668583,17
"642","더 킹","2017-02-04","832",168326,4836909,18
"643","더 킹","2017-02-05","818",154446,4991355,19
"644","더 킹","2017-02-06","768",50002,5041357,20
"645","더 킹","2017-02-07","777",49014,5090371,21
"646","더 킹","2017-02-08","663",41728,5132099,22
"647","더 킹","2017-02-09","466",25352,5157451,23
"648","더 킹","2017-02-10","479",26656,5184107,24
"649","더 킹","2017-02-11","477",45802,5229909,25
"650","더 킹","2017-02-12","482",41732,5271641,26
"651","더 킹","2017-02-13","477",15844,5287485,27
"652","더 킹","2017-02-14","477",16886,5304371,28
"653","더 킹","2017-02-15","106",2740,5307111,29
"654","더 킹","2017-02-16","60",1268,5308379,30
"655","더 킹","2017-02-17","62",1314,5309693,31
"656","더 킹","2017-02-18","52",1965,5311658,32
"657","더 킹","2017-02-19","47",1412,5313070,33
"658","더 킹","2017-02-20","51",859,5313929,34
"659","더 킹","2017-02-21","55",1286,5315215,35
"660","더 킹","2017-02-22","9",351,5315566,36
"661","더 킹","2017-02-23","7",319,5315885,37
"662","더 킹","2017-02-24","3",32,5315917,38
"663","더 킹","2017-02-25","1",39,5315956,39
"664","더 킹","2017-02-26","2",139,5316095,40
"665","더 킹","2017-02-27","4",87,5316182,41
"666","더 킹","2017-02-28","2",37,5316219,42
"667","더 킹","2017-03-02","2",106,5316325,43
"668","더 킹","2017-04-25","1",0,5316325,44
"669","더 킹","2017-04-28","1",0,5316325,45
"670","더 킹","2017-09-01","1",0,5316325,46
"671","더 킹","2017-11-09","1",242,5316567,47
"672","더 킹","2017-11-10","1",266,5316833,48
"673","더 킹","2017-11-11","1",348,5317181,49
"674","더 킹","2017-11-12","1",280,5317461,50
"675","더 킹","2017-11-13","2",232,5317693,51
"676","더 킹","2017-11-18","1",0,5317693,52
"677","꾼","2017-11-03","1",326,326,0
"678","꾼","2017-11-08","3",572,898,0
"679","꾼","2017-11-09","2",489,1387,0
"680","꾼","2017-11-10","8",1564,2951,0
"681","꾼","2017-11-13","13",5463,8414,0
"682","꾼","2017-11-14","49",9486,17900,0
"683","꾼","2017-11-15","29",6619,24519,0
"684","꾼","2017-11-16","6",1134,25653,0
"685","꾼","2017-11-17","40",7598,33251,0
"686","꾼","2017-11-20","11",3154,36405,0
"687","꾼","2017-11-21","23",2334,38739,0
"688","꾼","2017-11-22","1,195",213172,251911,1
"689","꾼","2017-11-23","1,210",224945,476856,2
"690","꾼","2017-11-24","1,253",263452,740308,3
"691","꾼","2017-11-25","1,314",474990,1215298,4
"692","꾼","2017-11-26","1,294",473846,1689144,5
"693","꾼","2017-11-27","1,249",159897,1849041,6
"694","꾼","2017-11-28","1,275",149371,1998412,7
"695","꾼","2017-11-29","1,008",201523,2199935,8
"696","꾼","2017-11-30","944",124399,2324334,9
"697","꾼","2017-12-01","981",141883,2466217,10
"698","꾼","2017-12-02","1,006",277291,2743508,11
"699","꾼","2017-12-03","1,000",252473,2995981,12
"700","꾼","2017-12-04","954",84468,3080449,13
"701","꾼","2017-12-05","974",80925,3161374,14
"702","꾼","2017-12-06","949",73725,3235099,15
"703","꾼","2017-12-07","820",69214,3304313,16
"704","꾼","2017-12-08","856",90567,3394880,17
"705","꾼","2017-12-09","856",169265,3564145,18
"706","꾼","2017-12-10","847",158299,3722444,19
"707","꾼","2017-12-11","831",57741,3780185,20
"708","꾼","2017-12-12","844",55607,3835792,21
"709","꾼","2017-12-13","857",57588,3893380,22
"710","꾼","2017-12-14","553",21186,3914566,23
"711","꾼","2017-12-15","529",23045,3937611,24
"712","꾼","2017-12-16","494",30267,3967878,25
"713","꾼","2017-12-17","478",24696,3992574,26
"714","꾼","2017-12-18","485",10691,4003265,27
"715","꾼","2017-12-19","496",11146,4014411,28
"716","꾼","2017-12-20","74",1150,4015561,29
"717","꾼","2017-12-21","25",219,4015780,30
"718","꾼","2017-12-22","29",1106,4016886,31
"719","꾼","2017-12-23","6",130,4017016,32
"720","꾼","2017-12-24","8",229,4017245,33
"721","꾼","2017-12-25","5",78,4017323,34
"722","꾼","2017-12-26","8",90,4017413,35
"723","꾼","2017-12-27","3",20,4017433,36
"724","꾼","2017-12-28","6",152,4017585,37
"725","꾼","2017-12-29","5",150,4017735,38
"726","꾼","2017-12-30","5",150,4017885,39
"727","꾼","2017-12-31","5",150,4018035,40
"728","꾼","2018-01-01","5",100,4018135,41
"729","꾼","2018-01-02","5",100,4018235,42
"730","꾼","2018-01-03","6",102,4018337,43
"731","꾼","2018-01-08","1",1,4018338,44
"732","꾼","2018-01-09","1",3,4018341,45
"733","꾼","2018-05-02","1",0,4018341,46
"734","꾼","2018-05-06","1",0,4018341,47
"735","꾼","2018-05-16","1",0,4018341,48
"736","강철비","2017-11-15","3",1404,1404,0
"737","강철비","2017-12-10","1",247,1651,0
"738","강철비","2017-12-11","17",4705,6356,0
"739","강철비","2017-12-12","41",6004,12360,0
"740","강철비","2017-12-13","28",3752,16112,0
"741","강철비","2017-12-14","1,259",236952,253064,1
"742","강철비","2017-12-15","1,276",288951,542015,2
"743","강철비","2017-12-16","1,419",539301,1081316,3
"744","강철비","2017-12-17","1,426",563824,1645140,4
"745","강철비","2017-12-18","1,332",235668,1880808,5
"746","강철비","2017-12-19","1,390",230227,2111035,6
"747","강철비","2017-12-20","988",142017,2253052,7
"748","강철비","2017-12-21","944",122170,2375222,8
"749","강철비","2017-12-22","1,005",146049,2521271,9
"750","강철비","2017-12-23","970",273400,2794671,10
"751","강철비","2017-12-24","925",362188,3156859,11
"752","강철비","2017-12-25","901",329396,3486255,12
"753","강철비","2017-12-26","909",103605,3589860,13
"754","강철비","2017-12-27","610",76078,3665938,14
"755","강철비","2017-12-28","579",56930,3722868,15
"756","강철비","2017-12-29","599",70645,3793513,16
"757","강철비","2017-12-30","569",99934,3893447,17
"758","강철비","2017-12-31","585",120846,4014293,18
"759","강철비","2018-01-01","602",114298,4128591,19
"760","강철비","2018-01-02","580",48122,4176713,20
"761","강철비","2018-01-03","518",28596,4205309,21
"762","강철비","2018-01-04","502",25610,4230919,22
"763","강철비","2018-01-05","495",27292,4258211,23
"764","강철비","2018-01-06","457",49258,4307469,24
"765","강철비","2018-01-07","449",43259,4350728,25
"766","강철비","2018-01-08","454",17562,4368290,26
"767","강철비","2018-01-09","450",16294,4384584,27
"768","강철비","2018-01-10","451",15391,4399975,28
"769","강철비","2018-01-11","186",5400,4405375,29
"770","강철비","2018-01-12","198",7118,4412493,30
"771","강철비","2018-01-13","174",12962,4425455,31
"772","강철비","2018-01-14","170",10776,4436231,32
"773","강철비","2018-01-15","181",4808,4441039,33
"774","강철비","2018-01-16","180",4348,4445387,34
"775","강철비","2018-01-17","39",706,4446093,35
"776","강철비","2018-01-18","32",625,4446718,36
"777","강철비","2018-01-19","33",558,4447276,37
"778","강철비","2018-01-20","34",1353,4448629,38
"779","강철비","2018-01-21","37",1225,4449854,39
"780","강철비","2018-01-22","29",485,4450339,40
"781","강철비","2018-01-23","28",371,4450710,41
"782","강철비","2018-01-24","4",34,4450744,42
"783","강철비","2018-01-25","1",14,4450758,43
"784","강철비","2018-01-26","1",13,4450771,44
"785","강철비","2018-01-27","3",29,4450800,45
"786","강철비","2018-01-28","2",66,4450866,46
"787","강철비","2018-01-29","1",23,4450889,47
"788","강철비","2018-01-30","2",94,4450983,48
"789","강철비","2018-01-31","1",11,4450994,49
"790","강철비","2018-02-01","2",3,4450997,50
"791","강철비","2018-02-02","1",5,4451002,51
"792","강철비","2018-02-03","2",55,4451057,52
"793","강철비","2018-02-04","2",34,4451091,53
"794","강철비","2018-02-05","1",11,4451102,54
"795","강철비","2018-02-06","2",12,4451114,55
"796","강철비","2018-02-07","1",4,4451118,56
"797","강철비","2018-02-09","1",6,4451124,57
"798","강철비","2018-02-10","1",10,4451134,58
"799","강철비","2018-02-11","1",3,4451137,59
"800","강철비","2018-02-12","1",2,4451139,60
"801","강철비","2018-02-13","1",3,4451142,61
"802","강철비","2018-02-19","40",296,4451438,62
"803","강철비","2018-02-20","40",205,4451643,63
"804","강철비","2018-02-21","37",159,4451802,64
"805","강철비","2018-02-22","34",224,4452026,65
"806","강철비","2018-02-23","31",206,4452232,66
"807","강철비","2018-02-24","26",159,4452391,67
"808","강철비","2018-02-25","26",109,4452500,68
"809","강철비","2018-02-26","31",109,4452609,69
"810","강철비","2018-02-27","27",115,4452724,70
"811","강철비","2018-02-28","5",16,4452740,71
"812","강철비","2018-03-23","1",0,4452740,72
"813","강철비","2018-03-28","1",0,4452740,73
"814","강철비","2018-07-05","1",0,4452740,74
"815","남한산성","2017-09-18","1",247,247,0
"816","남한산성","2017-09-25","12",3680,3927,0
"817","남한산성","2017-09-26","23",2888,6815,0
"818","남한산성","2017-09-27","15",2889,9704,0
"819","남한산성","2017-09-28","12",2658,12362,0
"820","남한산성","2017-09-29","23",4310,16672,0
"821","남한산성","2017-09-30","20",2524,19196,0
"822","남한산성","2017-10-02","40",9722,28918,0
"823","남한산성","2017-10-03","1,125",444585,473503,1
"824","남한산성","2017-10-04","1,165",552722,1026225,2
"825","남한산성","2017-10-05","1,205",599797,1626022,3
"826","남한산성","2017-10-06","1,221",582294,2208316,4
"827","남한산성","2017-10-07","1,229",424767,2633083,5
"828","남한산성","2017-10-08","1,203",365976,2999059,6
"829","남한산성","2017-10-09","1,152",256815,3255874,7
"830","남한산성","2017-10-10","1,011",56673,3312547,8
"831","남한산성","2017-10-11","1,005",57962,3370509,9
"832","남한산성","2017-10-12","702",41895,3412404,10
"833","남한산성","2017-10-13","692",47562,3459966,11
"834","남한산성","2017-10-14","668",80501,3540467,12
"835","남한산성","2017-10-15","646",77188,3617655,13
"836","남한산성","2017-10-16","643",26676,3644331,14
"837","남한산성","2017-10-17","674",26446,3670777,15
"838","남한산성","2017-10-18","653",26315,3697092,16
"839","남한산성","2017-10-19","436",13110,3710202,17
"840","남한산성","2017-10-20","451",15706,3725908,18
"841","남한산성","2017-10-21","476",24432,3750340,19
"842","남한산성","2017-10-22","450",24339,3774679,20
"843","남한산성","2017-10-23","429",9246,3783925,21
"844","남한산성","2017-10-24","446",10521,3794446,22
"845","남한산성","2017-10-25","221",5196,3799642,23
"846","남한산성","2017-10-26","230",5335,3804977,24
"847","남한산성","2017-10-27","229",6635,3811612,25
"848","남한산성","2017-10-28","182",6754,3818366,26
"849","남한산성","2017-10-29","182",7857,3826223,27
"850","남한산성","2017-10-30","225",3883,3830106,28
"851","남한산성","2017-10-31","232",4765,3834871,29
"852","남한산성","2017-11-01","215",3296,3838167,30
"853","남한산성","2017-11-02","41",656,3838823,31
"854","남한산성","2017-11-03","42",823,3839646,32
"855","남한산성","2017-11-04","25",571,3840217,33
"856","남한산성","2017-11-05","22",545,3840762,34
"857","남한산성","2017-11-06","35",336,3841098,35
"858","남한산성","2017-11-07","38",344,3841442,36
"859","남한산성","2017-11-08","42",493,3841935,37
"860","남한산성","2017-11-09","36",896,3842831,38
"861","남한산성","2017-11-10","35",518,3843349,39
"862","남한산성","2017-11-11","26",648,3843997,40
"863","남한산성","2017-11-12","24",375,3844372,41
"864","남한산성","2017-11-13","32",621,3844993,42
"865","남한산성","2017-11-14","35",603,3845596,43
"866","남한산성","2017-11-15","22",333,3845929,44
"867","남한산성","2017-11-16","14",162,3846091,45
"868","남한산성","2017-11-17","20",233,3846324,46
"869","남한산성","2017-11-18","18",195,3846519,47
"870","남한산성","2017-11-19","18",250,3846769,48
"871","남한산성","2017-11-20","22",189,3846958,49
"872","남한산성","2017-11-21","20",487,3847445,50
"873","남한산성","2017-11-22","15",64,3847509,51
"874","남한산성","2017-11-23","8",34,3847543,52
"875","남한산성","2017-11-24","9",356,3847899,53
"876","남한산성","2017-11-25","7",35,3847934,54
"877","남한산성","2017-11-26","7",24,3847958,55
"878","남한산성","2017-11-27","8",20,3847978,56
"879","남한산성","2017-11-28","11",33,3848011,57
"880","남한산성","2017-11-29","1",2,3848013,58
"881","남한산성","2017-12-01","1",95,3848108,59
"882","남한산성","2017-12-04","1",60,3848168,60
"883","남한산성","2017-12-05","1",30,3848198,61
"884","남한산성","2017-12-07","1",92,3848290,62
"885","남한산성","2017-12-08","1",156,3848446,63
"886","남한산성","2017-12-12","1",32,3848478,64
"887","남한산성","2017-12-14","2",300,3848778,65
"888","남한산성","2017-12-19","2",64,3848842,66
"889","남한산성","2017-12-26","1",165,3849007,67
"890","남한산성","2017-12-27","1",80,3849087,68
"891","남한산성","2018-04-22","1",42,3849129,69
"892","아이 캔 스피크","2017-09-06","28",7414,7414,0
"893","아이 캔 스피크","2017-09-09","10",2525,9939,0
"894","아이 캔 스피크","2017-09-11","13",2350,12289,0
"895","아이 캔 스피크","2017-09-12","6",1056,13345,0
"896","아이 캔 스피크","2017-09-13","9",1811,15156,0
"897","아이 캔 스피크","2017-09-14","12",2325,17481,0
"898","아이 캔 스피크","2017-09-15","1",71,17552,0
"899","아이 캔 스피크","2017-09-16","10",1896,19448,0
"900","아이 캔 스피크","2017-09-17","10",1770,21218,0
"901","아이 캔 스피크","2017-09-18","17",3413,24631,0
"902","아이 캔 스피크","2017-09-19","37",6378,31009,0
"903","아이 캔 스피크","2017-09-20","4",503,31512,0
"904","아이 캔 스피크","2017-09-21","1,004",87136,118648,1
"905","아이 캔 스피크","2017-09-22","1,026",121355,240003,2
"906","아이 캔 스피크","2017-09-23","1,140",242986,482989,3
"907","아이 캔 스피크","2017-09-24","1,122",243340,726329,4
"908","아이 캔 스피크","2017-09-25","1,039",87182,813511,5
"909","아이 캔 스피크","2017-09-26","1,075",87456,900967,6
"910","아이 캔 스피크","2017-09-27","934",126570,1027537,7
"911","아이 캔 스피크","2017-09-28","887",72396,1099933,8
"912","아이 캔 스피크","2017-09-29","937",119762,1219695,9
"913","아이 캔 스피크","2017-09-30","901",202900,1422595,10
"914","아이 캔 스피크","2017-10-01","897",226757,1649352,11
"915","아이 캔 스피크","2017-10-02","921",219081,1868433,12
"916","아이 캔 스피크","2017-10-03","717",139816,2008249,13
"917","아이 캔 스피크","2017-10-04","774",194624,2202873,14
"918","아이 캔 스피크","2017-10-05","806",203407,2406280,15
"919","아이 캔 스피크","2017-10-06","790",193628,2599908,16
"920","아이 캔 스피크","2017-10-07","783",142788,2742696,17
"921","아이 캔 스피크","2017-10-08","756",126906,2869602,18
"922","아이 캔 스피크","2017-10-09","717",111997,2981599,19
"923","아이 캔 스피크","2017-10-10","614",20777,3002376,20
"924","아이 캔 스피크","2017-10-11","593",25723,3028099,21
"925","아이 캔 스피크","2017-10-12","475",16737,3044836,22
"926","아이 캔 스피크","2017-10-13","517",23524,3068360,23
"927","아이 캔 스피크","2017-10-14","489",38123,3106483,24
"928","아이 캔 스피크","2017-10-15","482",34703,3141186,25
"929","아이 캔 스피크","2017-10-16","475",12953,3154139,26
"930","아이 캔 스피크","2017-10-17","492",14416,3168555,27
"931","아이 캔 스피크","2017-10-18","498",16538,3185093,28
"932","아이 캔 스피크","2017-10-19","242",7925,3193018,29
"933","아이 캔 스피크","2017-10-20","238",8040,3201058,30
"934","아이 캔 스피크","2017-10-21","248",11360,3212418,31
"935","아이 캔 스피크","2017-10-22","258",10882,3223300,32
"936","아이 캔 스피크","2017-10-23","249",5215,3228515,33
"937","아이 캔 스피크","2017-10-24","247",4623,3233138,34
"938","아이 캔 스피크","2017-10-25","140",14017,3247155,35
"939","아이 캔 스피크","2017-10-26","98",4406,3251561,36
"940","아이 캔 스피크","2017-10-27","82",2336,3253897,37
"941","아이 캔 스피크","2017-10-28","66",2157,3256054,38
"942","아이 캔 스피크","2017-10-29","63",2206,3258260,39
"943","아이 캔 스피크","2017-10-30","89",2335,3260595,40
"944","아이 캔 스피크","2017-10-31","87",1876,3262471,41
"945","아이 캔 스피크","2017-11-01","80",2365,3264836,42
"946","아이 캔 스피크","2017-11-02","21",1326,3266162,43
"947","아이 캔 스피크","2017-11-03","18",507,3266669,44
"948","아이 캔 스피크","2017-11-04","12",206,3266875,45
"949","아이 캔 스피크","2017-11-05","12",195,3267070,46
"950","아이 캔 스피크","2017-11-06","19",1116,3268186,47
"951","아이 캔 스피크","2017-11-07","17",813,3268999,48
"952","아이 캔 스피크","2017-11-08","15",636,3269635,49
"953","아이 캔 스피크","2017-11-09","9",606,3270241,50
"954","아이 캔 스피크","2017-11-10","6",361,3270602,51
"955","아이 캔 스피크","2017-11-11","5",142,3270744,52
"956","아이 캔 스피크","2017-11-12","2",35,3270779,53
"957","아이 캔 스피크","2017-11-13","6",95,3270874,54
"958","아이 캔 스피크","2017-11-14","7",103,3270977,55
"959","아이 캔 스피크","2017-11-15","4",260,3271237,56
"960","아이 캔 스피크","2017-11-16","1",5,3271242,57
"961","아이 캔 스피크","2017-11-17","5",281,3271523,58
"962","아이 캔 스피크","2017-11-18","3",307,3271830,59
"963","아이 캔 스피크","2017-11-20","1",7,3271837,60
"964","아이 캔 스피크","2017-11-21","2",121,3271958,61
"965","아이 캔 스피크","2017-11-23","2",268,3272226,62
"966","아이 캔 스피크","2017-11-24","1",135,3272361,63
"967","아이 캔 스피크","2017-11-27","1",5,3272366,64
"968","아이 캔 스피크","2017-11-28","4",186,3272552,65
"969","아이 캔 스피크","2017-11-29","7",700,3273252,66
"970","아이 캔 스피크","2017-11-30","2",307,3273559,67
"971","아이 캔 스피크","2017-12-01","2",193,3273752,68
"972","아이 캔 스피크","2017-12-02","2",599,3274351,69
"973","아이 캔 스피크","2017-12-03","2",94,3274445,70
"974","아이 캔 스피크","2017-12-04","1",22,3274467,71
"975","아이 캔 스피크","2017-12-05","4",274,3274741,72
"976","아이 캔 스피크","2017-12-06","9",741,3275482,73
"977","아이 캔 스피크","2017-12-07","1",200,3275682,74
"978","아이 캔 스피크","2017-12-08","3",254,3275936,75
"979","아이 캔 스피크","2017-12-09","1",31,3275967,76
"980","아이 캔 스피크","2017-12-11","5",415,3276382,77
"981","아이 캔 스피크","2017-12-12","12",1605,3277987,78
"982","아이 캔 스피크","2017-12-13","6",230,3278217,79
"983","아이 캔 스피크","2017-12-14","3",294,3278511,80
"984","아이 캔 스피크","2017-12-15","5",237,3278748,81
"985","아이 캔 스피크","2017-12-18","1",6,3278754,82
"986","아이 캔 스피크","2017-12-20","2",31,3278785,83
"987","아이 캔 스피크","2017-12-21","2",183,3278968,84
"988","아이 캔 스피크","2017-12-22","1",126,3279094,85
"989","아이 캔 스피크","2017-12-26","1",97,3279191,86
"990","아이 캔 스피크","2017-12-28","1",105,3279296,87
"991","아이 캔 스피크","2018-01-19","6",110,3279406,88
"992","아이 캔 스피크","2018-01-20","3",152,3279558,89
"993","아이 캔 스피크","2018-01-21","5",136,3279694,90
"994","아이 캔 스피크","2018-01-26","4",58,3279752,91
"995","아이 캔 스피크","2018-01-27","4",75,3279827,92
"996","아이 캔 스피크","2018-01-28","1",20,3279847,93
"997","아이 캔 스피크","2018-02-01","3",252,3280099,94
"998","아이 캔 스피크","2018-02-07","1",144,3280243,95
"999","아이 캔 스피크","2018-03-13","1",55,3280298,96
"1000","아이 캔 스피크","2018-04-24","3",333,3280631,97
"1001","아이 캔 스피크","2018-05-16","1",0,3280631,98
"1002","아이 캔 스피크","2018-05-18","1",70,3280701,99
"1003","아이 캔 스피크","2018-05-24","1",70,3280771,100
"1004","아이 캔 스피크","2018-05-25","1",70,3280841,101
"1005","아이 캔 스피크","2018-05-31","1",48,3280889,102
"1006","아이 캔 스피크","2018-06-12","1",104,3280993,103
"1007","아이 캔 스피크","2018-07-03","2",338,3281331,104
"1008","아이 캔 스피크","2018-07-20","1",45,3281376,105
"1009","아이 캔 스피크","2018-07-25","1",57,3281433,106
"1010","아이 캔 스피크","2018-09-12","1",250,3281683,107
"1011","아이 캔 스피크","2018-10-01","1",81,3281764,108
"1012","아이 캔 스피크","2018-10-23","1",114,3281878,109
"1013","아이 캔 스피크","2018-10-26","1",72,3281950,110
"1014","아이 캔 스피크","2018-10-27","1",141,3282091,111
"1015","아이 캔 스피크","2018-11-07","1",0,3282091,112
"1016","아이 캔 스피크","2018-11-20","1",100,3282191,113
"1017","아이 캔 스피크","2018-11-21","1",80,3282271,114
"1018","프리즌","2017-03-06","9",1129,1129,0
"1019","프리즌","2017-03-07","16",2243,3372,0
"1020","프리즌","2017-03-08","3",474,3846,0
"1021","프리즌","2017-03-14","14",3788,7634,0
"1022","프리즌","2017-03-15","5",906,8540,0
"1023","프리즌","2017-03-16","1",0,8540,0
"1024","프리즌","2017-03-17","42",8314,16854,0
"1025","프리즌","2017-03-18","1",134,16988,0
"1026","프리즌","2017-03-19","12",828,17816,0
"1027","프리즌","2017-03-20","17",1731,19547,0
"1028","프리즌","2017-03-21","13",3551,23098,0
"1029","프리즌","2017-03-22","871",85056,108154,0
"1030","프리즌","2017-03-23","909",168336,276490,1
"1031","프리즌","2017-03-24","942",194224,470714,2
"1032","프리즌","2017-03-25","1,047",403084,873798,3
"1033","프리즌","2017-03-26","1,036",369870,1243668,4
"1034","프리즌","2017-03-27","962",131499,1375167,5
"1035","프리즌","2017-03-28","977",108066,1483233,6
"1036","프리즌","2017-03-29","785",136337,1619570,7
"1037","프리즌","2017-03-30","771",81339,1700909,8
"1038","프리즌","2017-03-31","820",111341,1812250,9
"1039","프리즌","2017-04-01","908",224529,2036779,10
"1040","프리즌","2017-04-02","881",178045,2214824,11
"1041","프리즌","2017-04-03","787",60719,2275543,12
"1042","프리즌","2017-04-04","791",51701,2327244,13
"1043","프리즌","2017-04-05","661",51173,2378417,14
"1044","프리즌","2017-04-06","583",47467,2425884,15
"1045","프리즌","2017-04-07","627",52309,2478193,16
"1046","프리즌","2017-04-08","743",102167,2580360,17
"1047","프리즌","2017-04-09","725",95374,2675734,18
"1048","프리즌","2017-04-10","638",32013,2707747,19
"1049","프리즌","2017-04-11","646",31082,2738829,20
"1050","프리즌","2017-04-12","451",17603,2756432,21
"1051","프리즌","2017-04-13","445",14899,2771331,22
"1052","프리즌","2017-04-14","472",20584,2791915,23
"1053","프리즌","2017-04-15","494",32038,2823953,24
"1054","프리즌","2017-04-16","494",26181,2850134,25
"1055","프리즌","2017-04-17","449",14531,2864665,26
"1056","프리즌","2017-04-18","447",10861,2875526,27
"1057","프리즌","2017-04-19","447",10127,2885653,28
"1058","프리즌","2017-04-20","332",5497,2891150,29
"1059","프리즌","2017-04-21","348",6488,2897638,30
"1060","프리즌","2017-04-22","349",12262,2909900,31
"1061","프리즌","2017-04-23","347",10630,2920530,32
"1062","프리즌","2017-04-24","334",4888,2925418,33
"1063","프리즌","2017-04-25","334",4167,2929585,34
"1064","프리즌","2017-04-26","40",367,2929952,35
"1065","프리즌","2017-04-27","19",128,2930080,36
"1066","프리즌","2017-04-28","17",179,2930259,37
"1067","프리즌","2017-04-29","14",202,2930461,38
"1068","프리즌","2017-04-30","12",155,2930616,39
"1069","프리즌","2017-05-01","10",212,2930828,40
"1070","프리즌","2017-05-02","8",69,2930897,41
"1071","프리즌","2017-05-03","5",100,2930997,42
"1072","프리즌","2017-05-04","5",100,2931097,43
"1073","프리즌","2017-05-05","5",100,2931197,44
"1074","프리즌","2017-05-06","5",100,2931297,45
"1075","프리즌","2017-05-07","5",100,2931397,46
"1076","프리즌","2017-05-08","5",100,2931497,47
"1077","프리즌","2017-05-09","5",100,2931597,48
"1078","프리즌","2017-05-10","5",100,2931697,49
"1079","프리즌","2017-05-11","5",100,2931797,50
"1080","프리즌","2017-05-12","5",100,2931897,51
"1081","프리즌","2017-06-29","1",0,2931897,52
"1082","프리즌","2017-11-20","1",0,2931897,53
"1083","살인자의 기억법","2017-07-13","1",205,205,0
"1084","살인자의 기억법","2017-08-28","3",722,927,0
"1085","살인자의 기억법","2017-08-30","2",469,1396,0
"1086","살인자의 기억법","2017-08-31","2",499,1895,0
"1087","살인자의 기억법","2017-09-04","7",2336,4231,0
"1088","살인자의 기억법","2017-09-05","1",489,4720,0
"1089","살인자의 기억법","2017-09-06","884",143580,148300,1
"1090","살인자의 기억법","2017-09-07","942",143225,291525,2
"1091","살인자의 기억법","2017-09-08","989",187986,479511,3
"1092","살인자의 기억법","2017-09-09","1,064",369025,848536,4
"1093","살인자의 기억법","2017-09-10","1,060",342871,1191407,5
"1094","살인자의 기억법","2017-09-11","972",126124,1317531,6
"1095","살인자의 기억법","2017-09-12","983",99727,1417258,7
"1096","살인자의 기억법","2017-09-13","1,011",91473,1508731,8
"1097","살인자의 기억법","2017-09-14","757",71206,1579937,9
"1098","살인자의 기억법","2017-09-15","813",98154,1678091,10
"1099","살인자의 기억법","2017-09-16","884",202507,1880598,11
"1100","살인자의 기억법","2017-09-17","882",183280,2063878,12
"1101","살인자의 기억법","2017-09-18","812",57917,2121795,13
"1102","살인자의 기억법","2017-09-19","803",51148,2172943,14
"1103","살인자의 기억법","2017-09-20","829",50023,2222966,15
"1104","살인자의 기억법","2017-09-21","599",36073,2259039,16
"1105","살인자의 기억법","2017-09-22","622",46236,2305275,17
"1106","살인자의 기억법","2017-09-23","678",89242,2394517,18
"1107","살인자의 기억법","2017-09-24","663",79082,2473599,19
"1108","살인자의 기억법","2017-09-25","626",24330,2497929,20
"1109","살인자의 기억법","2017-09-26","629",23327,2521256,21
"1110","살인자의 기억법","2017-09-27","503",17697,2538953,22
"1111","살인자의 기억법","2017-09-28","461",11108,2550061,23
"1112","살인자의 기억법","2017-09-29","458",18603,2568664,24
"1113","살인자의 기억법","2017-09-30","453",25586,2594250,25
"1114","살인자의 기억법","2017-10-01","460",28608,2622858,26
"1115","살인자의 기억법","2017-10-02","451",26070,2648928,27
"1116","살인자의 기억법","2017-10-03","43",1493,2650421,28
"1117","살인자의 기억법","2017-10-04","47",1720,2652141,29
"1118","살인자의 기억법","2017-10-05","40",1248,2653389,30
"1119","살인자의 기억법","2017-10-06","29",962,2654351,31
"1120","살인자의 기억법","2017-10-07","30",670,2655021,32
"1121","살인자의 기억법","2017-10-08","25",567,2655588,33
"1122","살인자의 기억법","2017-10-09","24",303,2655891,34
"1123","살인자의 기억법","2017-10-10","38",287,2656178,35
"1124","살인자의 기억법","2017-10-11","36",238,2656416,36
"1125","살인자의 기억법","2017-10-12","2",51,2656467,37
"1126","살인자의 기억법","2017-10-13","1",68,2656535,38
"1127","살인자의 기억법","2017-10-14","1",6,2656541,39
"1128","살인자의 기억법","2017-10-15","1",14,2656555,40
"1129","살인자의 기억법","2017-10-17","1",1,2656556,41
"1130","살인자의 기억법","2017-10-18","1",1,2656557,42
"1131","살인자의 기억법","2017-10-19","20",400,2656957,43
"1132","살인자의 기억법","2017-10-20","20",400,2657357,44
"1133","살인자의 기억법","2017-10-21","5",100,2657457,45
"1134","살인자의 기억법","2017-10-22","5",100,2657557,46
"1135","살인자의 기억법","2017-10-23","5",100,2657657,47
"1136","살인자의 기억법","2017-10-24","5",100,2657757,48
"1137","살인자의 기억법","2017-10-25","5",100,2657857,49
"1138","살인자의 기억법","2017-10-26","5",100,2657957,50
"1139","살인자의 기억법","2017-10-27","5",100,2658057,51
"1140","살인자의 기억법","2017-10-28","5",100,2658157,52
"1141","살인자의 기억법","2017-10-29","5",100,2658257,53
"1142","살인자의 기억법","2017-10-30","5",100,2658357,54
"1143","살인자의 기억법","2017-10-31","5",100,2658457,55
"1144","살인자의 기억법","2017-11-01","5",100,2658557,56
"1145","살인자의 기억법","2017-11-09","1",30,2658587,57
"1146","살인자의 기억법","2017-12-02","1",2,2658589,58
"1147","보안관","2017-04-10","1",401,401,0
"1148","보안관","2017-04-18","7",1263,1664,0
"1149","보안관","2017-04-19","13",1323,2987,0
"1150","보안관","2017-04-20","13",1615,4602,0
"1151","보안관","2017-04-24","2",675,5277,0
"1152","보안관","2017-04-25","11",1553,6830,0
"1153","보안관","2017-04-26","12",2436,9266,0
"1154","보안관","2017-04-27","2",166,9432,0
"1155","보안관","2017-04-28","31",6240,15672,0
"1156","보안관","2017-04-29","7",1454,17126,0
"1157","보안관","2017-05-02","24",5028,22154,0
"1158","보안관","2017-05-03","669",206706,228860,1
"1159","보안관","2017-05-04","758",193863,422723,2
"1160","보안관","2017-05-05","878",281401,704124,3
"1161","보안관","2017-05-06","1,069",294102,998226,4
"1162","보안관","2017-05-07","1,091",261919,1260145,5
"1163","보안관","2017-05-08","947",149813,1409958,6
"1164","보안관","2017-05-09","806",241627,1651585,7
"1165","보안관","2017-05-10","696",65039,1716624,8
"1166","보안관","2017-05-11","699",64302,1780926,9
"1167","보안관","2017-05-12","748",86702,1867628,10
"1168","보안관","2017-05-13","758",174313,2041941,11
"1169","보안관","2017-05-14","751",164624,2206565,12
"1170","보안관","2017-05-15","714",64447,2271012,13
"1171","보안관","2017-05-16","732",52173,2323185,14
"1172","보안관","2017-05-17","603",28064,2351249,15
"1173","보안관","2017-05-18","589",24608,2375857,16
"1174","보안관","2017-05-19","605",29514,2405371,17
"1175","보안관","2017-05-20","530",54356,2459727,18
"1176","보안관","2017-05-21","532",49740,2509467,19
"1177","보안관","2017-05-22","511",16135,2525602,20
"1178","보안관","2017-05-23","512",15334,2540936,21
"1179","보안관","2017-05-24","334",8478,2549414,22
"1180","보안관","2017-05-25","250",5386,2554800,23
"1181","보안관","2017-05-26","239",5611,2560411,24
"1182","보안관","2017-05-27","222",8253,2568664,25
"1183","보안관","2017-05-28","212",6906,2575570,26
"1184","보안관","2017-05-29","230",3030,2578600,27
"1185","보안관","2017-05-30","223",3407,2582007,28
"1186","보안관","2017-05-31","31",669,2582676,29
"1187","보안관","2017-06-01","18",260,2582936,30
"1188","보안관","2017-06-02","18",136,2583072,31
"1189","보안관","2017-06-03","18",233,2583305,32
"1190","보안관","2017-06-04","19",253,2583558,33
"1191","보안관","2017-06-05","22",236,2583794,34
"1192","보안관","2017-06-06","3",24,2583818,35
"1193","보안관","2017-06-07","4",15,2583833,36
"1194","보안관","2017-06-08","2",76,2583909,37
"1195","보안관","2017-06-09","4",11,2583920,38
"1196","보안관","2017-06-10","4",28,2583948,39
"1197","보안관","2017-06-11","4",26,2583974,40
"1198","보안관","2017-06-12","4",6,2583980,41
"1199","보안관","2017-06-13","6",20,2584000,42
"1200","보안관","2017-06-14","3",13,2584013,43
"1201","보안관","2017-06-15","5",180,2584193,44
"1202","보안관","2017-06-16","10",716,2584909,45
"1203","보안관","2017-06-17","5",101,2585010,46
"1204","보안관","2017-06-18","5",172,2585182,47
"1205","보안관","2017-06-19","5",115,2585297,48
"1206","보안관","2017-06-20","7",589,2585886,49
"1207","보안관","2017-06-21","8",547,2586433,50
"1208","보안관","2017-06-22","3",765,2587198,51
"1209","보안관","2017-06-23","2",450,2587648,52
"1210","보안관","2017-06-27","2",267,2587915,53
"1211","보안관","2017-06-29","2",85,2588000,54
"1212","보안관","2017-07-18","1",250,2588250,55
"1213","보안관","2017-07-20","1",194,2588444,56
"1214","보안관","2017-08-02","1",173,2588617,57
"1215","보안관","2017-09-01","1",0,2588617,58
"1216","보안관","2017-10-14","1",9,2588626,59
"1217","보안관","2017-10-26","1",0,2588626,60
"1218","보안관","2017-10-31","1",2,2588628,61
"1219","보안관","2017-11-04","1",0,2588628,62
"1220","보안관","2017-12-21","1",0,2588628,63
"1221","조작된 도시","2017-01-31","4",2371,2371,0
"1222","조작된 도시","2017-02-01","4",900,3271,0
"1223","조작된 도시","2017-02-02","10",3000,6271,0
"1224","조작된 도시","2017-02-03","3",750,7021,0
"1225","조작된 도시","2017-02-06","9",1816,8837,0
"1226","조작된 도시","2017-02-07","34",5457,14294,0
"1227","조작된 도시","2017-02-08","20",3909,18203,0
"1228","조작된 도시","2017-02-09","771",157669,175872,1
"1229","조작된 도시","2017-02-10","825",186738,362610,2
"1230","조작된 도시","2017-02-11","1,006",353192,715802,3
"1231","조작된 도시","2017-02-12","1,019",356648,1072450,4
"1232","조작된 도시","2017-02-13","886",130484,1202934,5
"1233","조작된 도시","2017-02-14","900",144305,1347239,6
"1234","조작된 도시","2017-02-15","686",88129,1435368,7
"1235","조작된 도시","2017-02-16","729",75708,1511076,8
"1236","조작된 도시","2017-02-17","773",91801,1602877,9
"1237","조작된 도시","2017-02-18","829",192248,1795125,10
"1238","조작된 도시","2017-02-19","821",179139,1974264,11
"1239","조작된 도시","2017-02-20","738",63134,2037398,12
"1240","조작된 도시","2017-02-21","747",59236,2096634,13
"1241","조작된 도시","2017-02-22","520",58961,2155595,14
"1242","조작된 도시","2017-02-23","500",33918,2189513,15
"1243","조작된 도시","2017-02-24","515",37363,2226876,16
"1244","조작된 도시","2017-02-25","545",76656,2303532,17
"1245","조작된 도시","2017-02-26","538",76007,2379539,18
"1246","조작된 도시","2017-02-27","498",28848,2408387,19
"1247","조작된 도시","2017-02-28","516",31737,2440124,20
"1248","조작된 도시","2017-03-01","258",18446,2458570,21
"1249","조작된 도시","2017-03-02","263",3996,2462566,22
"1250","조작된 도시","2017-03-03","264",5293,2467859,23
"1251","조작된 도시","2017-03-04","259",12629,2480488,24
"1252","조작된 도시","2017-03-05","251",11901,2492389,25
"1253","조작된 도시","2017-03-06","236",3820,2496209,26
"1254","조작된 도시","2017-03-07","245",3377,2499586,27
"1255","조작된 도시","2017-03-08","112",1329,2500915,28
"1256","조작된 도시","2017-03-09","66",876,2501791,29
"1257","조작된 도시","2017-03-10","73",995,2502786,30
"1258","조작된 도시","2017-03-11","70",2523,2505309,31
"1259","조작된 도시","2017-03-12","78",2177,2507486,32
"1260","조작된 도시","2017-03-13","76",688,2508174,33
"1261","조작된 도시","2017-03-14","87",1503,2509677,34
"1262","조작된 도시","2017-03-15","82",1060,2510737,35
"1263","조작된 도시","2017-03-16","27",1251,2511988,36
"1264","조작된 도시","2017-03-17","2",153,2512141,37
"1265","조작된 도시","2017-03-18","11",419,2512560,38
"1266","조작된 도시","2017-03-19","2",83,2512643,39
"1267","조작된 도시","2017-03-20","6",63,2512706,40
"1268","조작된 도시","2017-03-21","4",93,2512799,41
"1269","조작된 도시","2017-03-22","6",181,2512980,42
"1270","조작된 도시","2017-03-23","5",183,2513163,43
"1271","조작된 도시","2017-03-24","5",158,2513321,44
"1272","조작된 도시","2017-03-25","5",187,2513508,45
"1273","조작된 도시","2017-03-26","5",165,2513673,46
"1274","조작된 도시","2017-03-27","5",136,2513809,47
"1275","조작된 도시","2017-03-28","5",174,2513983,48
"1276","조작된 도시","2017-03-29","2",364,2514347,49
"1277","조작된 도시","2017-03-30","3",421,2514768,50
"1278","조작된 도시","2017-04-03","1",30,2514798,51
"1279","조작된 도시","2017-04-06","1",35,2514833,52
"1280","조작된 도시","2017-04-18","1",110,2514943,53
"1281","조작된 도시","2017-09-02","1",186,2515129,54
"1282","조작된 도시","2017-10-15","1",186,2515315,55
"1283","조작된 도시","2017-11-25","1",186,2515501,56
"1284","재심","2017-01-23","1",282,282,0
"1285","재심","2017-02-02","6",1832,2114,0
"1286","재심","2017-02-06","3",422,2536,0
"1287","재심","2017-02-07","9",1816,4352,0
"1288","재심","2017-02-08","13",3154,7506,0
"1289","재심","2017-02-09","11",2252,9758,0
"1290","재심","2017-02-13","2",366,10124,0
"1291","재심","2017-02-14","15",3009,13133,0
"1292","재심","2017-02-15","727",121122,134255,1
"1293","재심","2017-02-16","789",133292,267547,2
"1294","재심","2017-02-17","831",158861,426408,3
"1295","재심","2017-02-18","935",309045,735453,4
"1296","재심","2017-02-19","924",287337,1022790,5
"1297","재심","2017-02-20","847",113754,1136544,6
"1298","재심","2017-02-21","865",106084,1242628,7
"1299","재심","2017-02-22","715",128189,1370817,8
"1300","재심","2017-02-23","683",76857,1447674,9
"1301","재심","2017-02-24","704",87870,1535544,10
"1302","재심","2017-02-25","767",179354,1714898,11
"1303","재심","2017-02-26","755",172320,1887218,12
"1304","재심","2017-02-27","707",65625,1952843,13
"1305","재심","2017-02-28","723",77863,2030706,14
"1306","재심","2017-03-01","545",80454,2111160,15
"1307","재심","2017-03-02","497",22108,2133268,16
"1308","재심","2017-03-03","506",24979,2158247,17
"1309","재심","2017-03-04","535",57437,2215684,18
"1310","재심","2017-03-05","534",51240,2266924,19
"1311","재심","2017-03-06","492",15650,2282574,20
"1312","재심","2017-03-07","500",15439,2298013,21
"1313","재심","2017-03-08","435",11769,2309782,22
"1314","재심","2017-03-09","386",9738,2319520,23
"1315","재심","2017-03-10","392",11066,2330586,24
"1316","재심","2017-03-11","420",25431,2356017,25
"1317","재심","2017-03-12","414",25144,2381161,26
"1318","재심","2017-03-13","396",7709,2388870,27
"1319","재심","2017-03-14","403",8009,2396879,28
"1320","재심","2017-03-15","383",6939,2403818,29
"1321","재심","2017-03-16","152",2575,2406393,30
"1322","재심","2017-03-17","142",2316,2408709,31
"1323","재심","2017-03-18","124",3601,2412310,32
"1324","재심","2017-03-19","120",2943,2415253,33
"1325","재심","2017-03-20","138",1422,2416675,34
"1326","재심","2017-03-21","147",1952,2418627,35
"1327","재심","2017-03-22","98",674,2419301,36
"1328","재심","2017-03-23","5",233,2419534,37
"1329","재심","2017-03-24","1",4,2419538,38
"1330","재심","2017-03-25","1",2,2419540,39
"1331","재심","2017-03-27","1",76,2419616,40
"1332","재심","2017-03-28","1",19,2419635,41
"1333","재심","2017-03-29","18",467,2420102,42
"1334","재심","2017-03-30","2",7,2420109,43
"1335","재심","2017-03-31","2",6,2420115,44
"1336","재심","2017-04-01","3",151,2420266,45
"1337","재심","2017-04-02","2",2,2420268,46
"1338","재심","2017-04-03","1",3,2420271,47
"1339","재심","2017-04-04","4",15,2420286,48
"1340","재심","2017-04-05","5",5,2420291,49
"1341","재심","2017-04-06","7",109,2420400,50
"1342","재심","2017-04-07","5",5,2420405,51
"1343","재심","2017-04-08","6",149,2420554,52
"1344","재심","2017-04-09","5",5,2420559,53
"1345","재심","2017-04-10","1",170,2420729,54
"1346","재심","2017-04-14","2",248,2420977,55
"1347","재심","2017-04-25","1",0,2420977,56
"1348","재심","2017-04-26","2",34,2421011,57
"1349","재심","2017-04-30","1",0,2421011,58
"1350","재심","2017-08-01","1",0,2421011,59
"1351","재심","2017-09-21","1",186,2421197,60
"1352","재심","2017-11-17","1",0,2421197,61
"1353","재심","2017-11-21","1",0,2421197,62
"1354","박열","2017-06-09","4",618,618,0
"1355","박열","2017-06-10","1",284,902,0
"1356","박열","2017-06-13","6",1226,2128,0
"1357","박열","2017-06-15","1",319,2447,0
"1358","박열","2017-06-16","9",812,3259,0
"1359","박열","2017-06-17","14",3112,6371,0
"1360","박열","2017-06-18","17",2737,9108,0
"1361","박열","2017-06-19","5",1323,10431,0
"1362","박열","2017-06-20","29",4842,15273,0
"1363","박열","2017-06-22","1",82,15355,0
"1364","박열","2017-06-23","3",582,15937,0
"1365","박열","2017-06-26","1",180,16117,0
"1366","박열","2017-06-27","25",3058,19175,0
"1367","박열","2017-06-28","917",201987,221162,1
"1368","박열","2017-06-29","995",141299,362461,2
"1369","박열","2017-06-30","1,066",174136,536597,3
"1370","박열","2017-07-01","1,176",330776,867373,4
"1371","박열","2017-07-02","1,172",313188,1180561,5
"1372","박열","2017-07-03","1,089",113352,1293913,6
"1373","박열","2017-07-04","1,102",104154,1398067,7
"1374","박열","2017-07-05","743",59576,1457643,8
"1375","박열","2017-07-06","756",56290,1513933,9
"1376","박열","2017-07-07","747",73706,1587639,10
"1377","박열","2017-07-08","708",136469,1724108,11
"1378","박열","2017-07-09","686",118132,1842240,12
"1379","박열","2017-07-10","691",43647,1885887,13
"1380","박열","2017-07-11","710",45160,1931047,14
"1381","박열","2017-07-12","653",39140,1970187,15
"1382","박열","2017-07-13","594",35493,2005680,16
"1383","박열","2017-07-14","630",45994,2051674,17
"1384","박열","2017-07-15","638",85482,2137156,18
"1385","박열","2017-07-16","620",75059,2212215,19
"1386","박열","2017-07-17","577",27965,2240180,20
"1387","박열","2017-07-18","602",26207,2266387,21
"1388","박열","2017-07-19","557",23249,2289636,22
"1389","박열","2017-07-20","389",11184,2300820,23
"1390","박열","2017-07-21","385",11516,2312336,24
"1391","박열","2017-07-22","334",14396,2326732,25
"1392","박열","2017-07-23","325",12139,2338871,26
"1393","박열","2017-07-24","351",6788,2345659,27
"1394","박열","2017-07-25","341",6838,2352497,28
"1395","박열","2017-07-26","17",989,2353486,29
"1396","박열","2017-07-27","12",358,2353844,30
"1397","박열","2017-07-28","7",181,2354025,31
"1398","박열","2017-07-29","8",175,2354200,32
"1399","박열","2017-07-30","6",131,2354331,33
"1400","박열","2017-07-31","7",137,2354468,34
"1401","박열","2017-08-01","6",157,2354625,35
"1402","박열","2017-08-02","20",1000,2355625,36
"1403","박열","2017-08-03","22",1093,2356718,37
"1404","박열","2017-08-04","5",100,2356818,38
"1405","박열","2017-08-05","5",100,2356918,39
"1406","박열","2017-08-06","5",100,2357018,40
"1407","박열","2017-08-07","5",100,2357118,41
"1408","박열","2017-08-08","5",100,2357218,42
"1409","박열","2017-08-09","5",100,2357318,43
"1410","박열","2017-08-10","6",175,2357493,44
"1411","박열","2017-08-11","5",100,2357593,45
"1412","박열","2017-08-12","5",100,2357693,46
"1413","박열","2017-08-13","5",100,2357793,47
"1414","박열","2017-08-14","5",100,2357893,48
"1415","박열","2017-08-15","5",100,2357993,49
"1416","박열","2017-08-16","5",100,2358093,50
"1417","박열","2017-08-17","7",221,2358314,51
"1418","박열","2017-08-18","6",260,2358574,52
"1419","박열","2017-08-19","5",100,2358674,53
"1420","박열","2017-08-20","5",100,2358774,54
"1421","박열","2017-08-21","5",100,2358874,55
"1422","박열","2017-08-22","5",100,2358974,56
"1423","박열","2017-08-23","5",100,2359074,57
"1424","박열","2017-08-24","5",100,2359174,58
"1425","박열","2017-09-01","1",0,2359174,59
"1426","박열","2017-11-04","1",0,2359174,60
"1427","박열","2017-11-15","1",0,2359174,61
"1428","박열","2017-11-20","1",0,2359174,62
"1429","박열","2017-11-21","1",0,2359174,63
"1430","박열","2017-12-07","1",15,2359189,64
"1431","박열","2017-12-08","1",17,2359206,65
"1432","박열","2017-12-20","1",0,2359206,66
"1433","박열","2018-04-20","1",67,2359273,67
"1434","박열","2018-12-06","1",224,2359497,68
"1435","박열","2019-02-09","1",50,2359547,69
"1436","마스터","2016-12-12","6",2498,2498,0
"1437","마스터","2016-12-15","16",3180,5678,0
"1438","마스터","2016-12-16","35",7069,12747,0
"1439","마스터","2016-12-17","2",326,13073,0
"1440","마스터","2016-12-18","3",808,13881,0
"1441","마스터","2016-12-19","22",4685,18566,0
"1442","마스터","2016-12-20","26",4878,23444,0
"1443","마스터","2016-12-21","1,448",392856,416300,1
"1444","마스터","2016-12-22","1,441",347324,763624,2
"1445","마스터","2016-12-23","1,450",417071,1180695,3
"1446","마스터","2016-12-24","1,501",918759,2099454,4
"1447","마스터","2016-12-25","1,495",902734,3002188,5
"1448","마스터","2016-12-26","1,390",273151,3275339,6
"1449","마스터","2016-12-27","1,425",250253,3525592,7
"1450","마스터","2016-12-28","1,263",310391,3835983,8
"1451","마스터","2016-12-29","1,224",233247,4069230,9
"1452","마스터","2016-12-30","1,206",328306,4397536,10
"1453","마스터","2016-12-31","1,262",537784,4935320,11
"1454","마스터","2017-01-01","1,245",506299,5441619,12
"1455","마스터","2017-01-02","1,161",183423,5625042,13
"1456","마스터","2017-01-03","1,173",135859,5760901,14
"1457","마스터","2017-01-04","871",102362,5863263,15
"1458","마스터","2017-01-05","855",92234,5955497,16
"1459","마스터","2017-01-06","871",105235,6060732,17
"1460","마스터","2017-01-07","884",236394,6297126,18
"1461","마스터","2017-01-08","866",220974,6518100,19
"1462","마스터","2017-01-09","782",65323,6583423,20
"1463","마스터","2017-01-10","814",62635,6646058,21
"1464","마스터","2017-01-11","654",54670,6700728,22
"1465","마스터","2017-01-12","567",46151,6746879,23
"1466","마스터","2017-01-13","577",52777,6799656,24
"1467","마스터","2017-01-14","648",120563,6920219,25
"1468","마스터","2017-01-15","635",111003,7031222,26
"1469","마스터","2017-01-16","565",37009,7068231,27
"1470","마스터","2017-01-17","575",35981,7104212,28
"1471","마스터","2017-01-18","287",5939,7110151,29
"1472","마스터","2017-01-19","289",4799,7114950,30
"1473","마스터","2017-01-20","263",4783,7119733,31
"1474","마스터","2017-01-21","243",7865,7127598,32
"1475","마스터","2017-01-22","229",5997,7133595,33
"1476","마스터","2017-01-23","236",2564,7136159,34
"1477","마스터","2017-01-24","241",2824,7138983,35
"1478","마스터","2017-01-25","35",436,7139419,36
"1479","마스터","2017-01-26","37",689,7140108,37
"1480","마스터","2017-01-27","46",1386,7141494,38
"1481","마스터","2017-01-28","40",1430,7142924,39
"1482","마스터","2017-01-29","37",1375,7144299,40
"1483","마스터","2017-01-30","37",1102,7145401,41
"1484","마스터","2017-01-31","34",369,7145770,42
"1485","마스터","2017-02-01","15",185,7145955,43
"1486","마스터","2017-02-02","33",1463,7147418,44
"1487","마스터","2017-02-03","12",209,7147627,45
"1488","마스터","2017-02-04","12",269,7147896,46
"1489","마스터","2017-02-05","12",281,7148177,47
"1490","마스터","2017-02-06","13",172,7148349,48
"1491","마스터","2017-02-07","10",184,7148533,49
"1492","마스터","2017-02-08","7",139,7148672,50
"1493","마스터","2017-02-09","4",124,7148796,51
"1494","마스터","2017-02-10","5",128,7148924,52
"1495","마스터","2017-02-11","5",145,7149069,53
"1496","마스터","2017-02-12","5",140,7149209,54
"1497","마스터","2017-02-13","4",129,7149338,55
"1498","마스터","2017-02-14","4",123,7149461,56
"1499","마스터","2017-02-15","5",124,7149585,57
"1500","마스터","2017-02-16","5",135,7149720,58
"1501","마스터","2017-02-17","5",138,7149858,59
"1502","마스터","2017-02-18","5",131,7149989,60
"1503","마스터","2017-02-19","5",153,7150142,61
"1504","마스터","2017-02-20","5",137,7150279,62
"1505","마스터","2017-02-21","5",132,7150411,63
"1506","마스터","2017-02-22","4",130,7150541,64
"1507","마스터","2017-07-11","1",21,7150562,65
"1508","마스터","2017-07-17","1",24,7150586,66
"1509","1987","2017-12-13","14",3415,3415,0
"1510","1987","2017-12-14","2",928,4343,0
"1511","1987","2017-12-15","2",571,4914,0
"1512","1987","2017-12-18","2",571,5485,0
"1513","1987","2017-12-19","45",9755,15240,0
"1514","1987","2017-12-20","2",787,16027,0
"1515","1987","2017-12-21","27",6007,22034,0
"1516","1987","2017-12-22","20",4259,26293,0
"1517","1987","2017-12-23","10",1870,28163,0
"1518","1987","2017-12-26","41",7168,35331,0
"1519","1987","2017-12-27","1,299",331736,367067,1
"1520","1987","2017-12-28","1,233",221304,588371,2
"1521","1987","2017-12-29","1,170",306562,894933,3
"1522","1987","2017-12-30","1,079",487098,1382031,4
"1523","1987","2017-12-31","1,082",560046,1942077,5
"1524","1987","2018-01-01","1,097",531469,2473546,6
"1525","1987","2018-01-02","1,063",217247,2690793,7
"1526","1987","2018-01-03","964",174979,2865772,8
"1527","1987","2018-01-04","986",163429,3029201,9
"1528","1987","2018-01-05","1,012",202189,3231390,10
"1529","1987","2018-01-06","1,094",436755,3668145,11
"1530","1987","2018-01-07","1,067",421153,4089298,12
"1531","1987","2018-01-08","1,012",179970,4269268,13
"1532","1987","2018-01-09","1,052",175793,4445061,14
"1533","1987","2018-01-10","1,080",166737,4611798,15
"1534","1987","2018-01-11","957",143893,4755691,16
"1535","1987","2018-01-12","995",186217,4941908,17
"1536","1987","2018-01-13","1,103",434056,5375964,18
"1537","1987","2018-01-14","1,122",410882,5786846,19
"1538","1987","2018-01-15","1,015",128995,5915841,20
"1539","1987","2018-01-16","1,042",116339,6032180,21
"1540","1987","2018-01-17","755",90628,6122808,22
"1541","1987","2018-01-18","745",80288,6203096,23
"1542","1987","2018-01-19","745",91393,6294489,24
"1543","1987","2018-01-20","714",198195,6492684,25
"1544","1987","2018-01-21","708",175482,6668166,26
"1545","1987","2018-01-22","689",52331,6720497,27
"1546","1987","2018-01-23","688",49510,6770007,28
"1547","1987","2018-01-24","547",35857,6805864,29
"1548","1987","2018-01-25","562",33264,6839128,30
"1549","1987","2018-01-26","578",36987,6876115,31
"1550","1987","2018-01-27","604",77436,6953551,32
"1551","1987","2018-01-28","610",72382,7025933,33
"1552","1987","2018-01-29","577",26748,7052681,34
"1553","1987","2018-01-30","586",25848,7078529,35
"1554","1987","2018-01-31","404",22463,7100992,36
"1555","1987","2018-02-01","384",11916,7112908,37
"1556","1987","2018-02-02","401",13966,7126874,38
"1557","1987","2018-02-03","387",24901,7151775,39
"1558","1987","2018-02-04","397",23629,7175404,40
"1559","1987","2018-02-05","413",8412,7183816,41
"1560","1987","2018-02-06","417",7861,7191677,42
"1561","1987","2018-02-07","405",9410,7201087,43
"1562","1987","2018-02-08","173",3245,7204332,44
"1563","1987","2018-02-09","188",3820,7208152,45
"1564","1987","2018-02-10","177",5124,7213276,46
"1565","1987","2018-02-11","168",4955,7218231,47
"1566","1987","2018-02-12","183",1951,7220182,48
"1567","1987","2018-02-13","179",2171,7222353,49
"1568","1987","2018-02-14","14",225,7222578,50
"1569","1987","2018-02-15","11",456,7223034,51
"1570","1987","2018-02-16","12",409,7223443,52
"1571","1987","2018-02-17","11",584,7224027,53
"1572","1987","2018-02-18","11",388,7224415,54
"1573","1987","2018-02-19","69",832,7225247,55
"1574","1987","2018-02-20","70",681,7225928,56
"1575","1987","2018-02-21","64",831,7226759,57
"1576","1987","2018-02-22","56",574,7227333,58
"1577","1987","2018-02-23","55",504,7227837,59
"1578","1987","2018-02-24","62",745,7228582,60
"1579","1987","2018-02-25","60",699,7229281,61
"1580","1987","2018-02-26","56",402,7229683,62
"1581","1987","2018-02-27","61",543,7230226,63
"1582","1987","2018-02-28","16",819,7231045,64
"1583","1987","2018-03-01","1",9,7231054,65
"1584","1987","2018-03-02","1",3,7231057,66
"1585","1987","2018-03-05","1",5,7231062,67
"1586","1987","2018-03-06","1",1,7231063,68
"1587","1987","2018-03-08","2",94,7231157,69
"1588","1987","2018-03-09","1",3,7231160,70
"1589","1987","2018-03-20","1",55,7231215,71
"1590","1987","2018-03-23","1",139,7231354,72
"1591","1987","2018-03-26","1",129,7231483,73
"1592","1987","2018-04-09","1",34,7231517,74
"1593","1987","2018-04-19","1",60,7231577,75
"1594","1987","2018-04-21","1",61,7231638,76
"1595","1987","2018-08-03","1",60,7231698,77
"1596","1987","2018-08-31","1",16,7231714,78
"1597","1987","2018-09-04","1",10,7231724,79
"1598","1987","2018-09-27","1",170,7231894,80
"1599","1987","2018-11-12","1",0,7231894,81
"1600","1987","2018-11-16","1",0,7231894,82
"1601","1987","2018-12-13","1",8,7231902,83
"1602","1987","2018-12-15","1",4,7231906,84
"1603","1987","2018-12-17","2",250,7232156,85
"1604","1987","2018-12-18","2",231,7232387,86
"1605","노무현입니다","2017-05-16","4",761,761,0
"1606","노무현입니다","2017-05-17","2",254,1015,0
"1607","노무현입니다","2017-05-18","1",136,1151,0
"1608","노무현입니다","2017-05-19","2",277,1428,0
"1609","노무현입니다","2017-05-20","3",474,1902,0
"1610","노무현입니다","2017-05-22","5",655,2557,0
"1611","노무현입니다","2017-05-23","25",4086,6643,0
"1612","노무현입니다","2017-05-24","5",685,7328,0
"1613","노무현입니다","2017-05-25","580",78816,86144,1
"1614","노무현입니다","2017-05-26","659",94985,181129,2
"1615","노무현입니다","2017-05-27","775",205704,386833,3
"1616","노무현입니다","2017-05-28","763",209858,596691,4
"1617","노무현입니다","2017-05-29","685",77835,674526,5
"1618","노무현입니다","2017-05-30","710",70693,745219,6
"1619","노무현입니다","2017-05-31","578",78580,823799,7
"1620","노무현입니다","2017-06-01","593",50155,873954,8
"1621","노무현입니다","2017-06-02","598",59584,933538,9
"1622","노무현입니다","2017-06-03","627",119639,1053177,10
"1623","노무현입니다","2017-06-04","614",123572,1176749,11
"1624","노무현입니다","2017-06-05","593",78344,1255093,12
"1625","노무현입니다","2017-06-06","557",117280,1372373,13
"1626","노무현입니다","2017-06-07","533",33176,1405549,14
"1627","노무현입니다","2017-06-08","494",24994,1430543,15
"1628","노무현입니다","2017-06-09","513",28285,1458828,16
"1629","노무현입니다","2017-06-10","509",55330,1514158,17
"1630","노무현입니다","2017-06-11","530",53664,1567822,18
"1631","노무현입니다","2017-06-12","513",17701,1585523,19
"1632","노무현입니다","2017-06-13","518",16682,1602205,20
"1633","노무현입니다","2017-06-14","518",20977,1623182,21
"1634","노무현입니다","2017-06-15","455",15626,1638808,22
"1635","노무현입니다","2017-06-16","445",18206,1657014,23
"1636","노무현입니다","2017-06-17","492",34301,1691315,24
"1637","노무현입니다","2017-06-18","488",31675,1722990,25
"1638","노무현입니다","2017-06-19","435",11656,1734646,26
"1639","노무현입니다","2017-06-20","463",12627,1747273,27
"1640","노무현입니다","2017-06-21","330",8000,1755273,28
"1641","노무현입니다","2017-06-22","287",6427,1761700,29
"1642","노무현입니다","2017-06-23","300",7145,1768845,30
"1643","노무현입니다","2017-06-24","299",14121,1782966,31
"1644","노무현입니다","2017-06-25","294",15089,1798055,32
"1645","노무현입니다","2017-06-26","305",6350,1804405,33
"1646","노무현입니다","2017-06-27","315",7238,1811643,34
"1647","노무현입니다","2017-06-28","151",3376,1815019,35
"1648","노무현입니다","2017-06-29","143",2713,1817732,36
"1649","노무현입니다","2017-06-30","152",3268,1821000,37
"1650","노무현입니다","2017-07-01","146",4895,1825895,38
"1651","노무현입니다","2017-07-02","150",5298,1831193,39
"1652","노무현입니다","2017-07-03","163",2034,1833227,40
"1653","노무현입니다","2017-07-04","163",2409,1835636,41
"1654","노무현입니다","2017-07-05","69",1098,1836734,42
"1655","노무현입니다","2017-07-06","61",974,1837708,43
"1656","노무현입니다","2017-07-07","54",1063,1838771,44
"1657","노무현입니다","2017-07-08","55",1864,1840635,45
"1658","노무현입니다","2017-07-09","47",1688,1842323,46
"1659","노무현입니다","2017-07-10","60",856,1843179,47
"1660","노무현입니다","2017-07-11","67",845,1844024,48
"1661","노무현입니다","2017-07-12","51",672,1844696,49
"1662","노무현입니다","2017-07-13","29",411,1845107,50
"1663","노무현입니다","2017-07-14","30",866,1845973,51
"1664","노무현입니다","2017-07-15","32",1273,1847246,52
"1665","노무현입니다","2017-07-16","24",690,1847936,53
"1666","노무현입니다","2017-07-17","24",275,1848211,54
"1667","노무현입니다","2017-07-18","30",382,1848593,55
"1668","노무현입니다","2017-07-19","20",193,1848786,56
"1669","노무현입니다","2017-07-20","11",185,1848971,57
"1670","노무현입니다","2017-07-21","12",460,1849431,58
"1671","노무현입니다","2017-07-22","14",616,1850047,59
"1672","노무현입니다","2017-07-23","13",561,1850608,60
"1673","노무현입니다","2017-07-24","12",442,1851050,61
"1674","노무현입니다","2017-07-25","12",598,1851648,62
"1675","노무현입니다","2017-07-26","7",468,1852116,63
"1676","노무현입니다","2017-07-27","5",129,1852245,64
"1677","노무현입니다","2017-07-28","5",139,1852384,65
"1678","노무현입니다","2017-07-29","5",147,1852531,66
"1679","노무현입니다","2017-07-30","4",114,1852645,67
"1680","노무현입니다","2017-07-31","4",112,1852757,68
"1681","노무현입니다","2017-08-01","5",115,1852872,69
"1682","노무현입니다","2017-08-02","5",189,1853061,70
"1683","노무현입니다","2017-08-03","5",197,1853258,71
"1684","노무현입니다","2017-08-04","5",118,1853376,72
"1685","노무현입니다","2017-08-05","5",208,1853584,73
"1686","노무현입니다","2017-08-06","4",175,1853759,74
"1687","노무현입니다","2017-08-07","4",178,1853937,75
"1688","노무현입니다","2017-08-08","6",447,1854384,76
"1689","노무현입니다","2017-08-09","7",365,1854749,77
"1690","노무현입니다","2017-08-10","1",2,1854751,78
"1691","노무현입니다","2017-08-11","3",9,1854760,79
"1692","노무현입니다","2017-08-13","1",8,1854768,80
"1693","노무현입니다","2017-08-14","1",14,1854782,81
"1694","노무현입니다","2017-08-15","1",5,1854787,82
"1695","노무현입니다","2017-08-16","1",19,1854806,83
"1696","노무현입니다","2017-08-20","1",4,1854810,84
"1697","노무현입니다","2017-08-22","2",9,1854819,85
"1698","노무현입니다","2017-08-23","1",3,1854822,86
"1699","노무현입니다","2017-08-26","1",45,1854867,87
"1700","노무현입니다","2017-09-28","1",1,1854868,88
"1701","노무현입니다","2017-10-20","1",52,1854920,89
"1702","노무현입니다","2017-11-11","1",4,1854924,90
"1703","노무현입니다","2017-12-13","1",75,1854999,91
"1704","노무현입니다","2017-12-14","1",75,1855074,92
"1705","노무현입니다","2017-12-15","1",75,1855149,93
"1706","노무현입니다","2018-03-17","1",100,1855249,94
"1707","노무현입니다","2018-03-30","1",100,1855349,95
"1708","노무현입니다","2018-05-20","1",140,1855489,96
"1709","임금님의 사건수첩","2017-04-06","1",326,326,0
"1710","임금님의 사건수첩","2017-04-12","1",357,683,0
"1711","임금님의 사건수첩","2017-04-17","8",4118,4801,0
"1712","임금님의 사건수첩","2017-04-18","5",863,5664,0
"1713","임금님의 사건수첩","2017-04-19","6",1449,7113,0
"1714","임금님의 사건수첩","2017-04-21","6",786,7899,0
"1715","임금님의 사건수첩","2017-04-22","6",1626,9525,0
"1716","임금님의 사건수첩","2017-04-23","9",1483,11008,0
"1717","임금님의 사건수첩","2017-04-24","25",2429,13437,0
"1718","임금님의 사건수첩","2017-04-25","14",2943,16380,0
"1719","임금님의 사건수첩","2017-04-26","934",108463,124843,1
"1720","임금님의 사건수첩","2017-04-27","966",79824,204667,2
"1721","임금님의 사건수첩","2017-04-28","979",99361,304028,3
"1722","임금님의 사건수첩","2017-04-29","1,054",202606,506634,4
"1723","임금님의 사건수첩","2017-04-30","1,029",215703,722337,5
"1724","임금님의 사건수첩","2017-05-01","989",158053,880390,6
"1725","임금님의 사건수첩","2017-05-02","1,038",102367,982757,7
"1726","임금님의 사건수첩","2017-05-03","640",128812,1111569,8
"1727","임금님의 사건수첩","2017-05-04","646",86504,1198073,9
"1728","임금님의 사건수첩","2017-05-05","663",130495,1328568,10
"1729","임금님의 사건수첩","2017-05-06","668",95953,1424521,11
"1730","임금님의 사건수첩","2017-05-07","678",68526,1493047,12
"1731","임금님의 사건수첩","2017-05-08","601",32564,1525611,13
"1732","임금님의 사건수첩","2017-05-09","433",35102,1560713,14
"1733","임금님의 사건수첩","2017-05-10","410",8766,1569479,15
"1734","임금님의 사건수첩","2017-05-11","418",8178,1577657,16
"1735","임금님의 사건수첩","2017-05-12","429",10334,1587991,17
"1736","임금님의 사건수첩","2017-05-13","335",12979,1600970,18
"1737","임금님의 사건수첩","2017-05-14","341",11748,1612718,19
"1738","임금님의 사건수첩","2017-05-15","368",6602,1619320,20
"1739","임금님의 사건수첩","2017-05-16","371",5704,1625024,21
"1740","임금님의 사건수첩","2017-05-17","58",1833,1626857,22
"1741","임금님의 사건수첩","2017-05-18","64",2285,1629142,23
"1742","임금님의 사건수첩","2017-05-19","30",519,1629661,24
"1743","임금님의 사건수첩","2017-05-20","31",1165,1630826,25
"1744","임금님의 사건수첩","2017-05-21","19",394,1631220,26
"1745","임금님의 사건수첩","2017-05-22","20",170,1631390,27
"1746","임금님의 사건수첩","2017-05-23","22",256,1631646,28
"1747","임금님의 사건수첩","2017-05-24","27",718,1632364,29
"1748","임금님의 사건수첩","2017-05-25","7",221,1632585,30
"1749","임금님의 사건수첩","2017-05-26","5",100,1632685,31
"1750","임금님의 사건수첩","2017-05-27","5",100,1632785,32
"1751","임금님의 사건수첩","2017-05-28","5",100,1632885,33
"1752","임금님의 사건수첩","2017-05-29","7",222,1633107,34
"1753","임금님의 사건수첩","2017-05-30","8",283,1633390,35
"1754","임금님의 사건수첩","2017-05-31","7",162,1633552,36
"1755","임금님의 사건수첩","2017-06-01","6",186,1633738,37
"1756","임금님의 사건수첩","2017-06-02","5",100,1633838,38
"1757","임금님의 사건수첩","2017-06-03","5",100,1633938,39
"1758","임금님의 사건수첩","2017-06-04","5",100,1634038,40
"1759","임금님의 사건수첩","2017-06-05","5",100,1634138,41
"1760","임금님의 사건수첩","2017-06-06","5",100,1634238,42
"1761","임금님의 사건수첩","2017-06-07","1",165,1634403,43
"1762","임금님의 사건수첩","2017-06-09","1",0,1634403,44
"1763","임금님의 사건수첩","2017-09-05","5",600,1635003,45
"1764","부라더","2017-09-25","2",928,928,0
"1765","부라더","2017-10-12","8",2351,3279,0
"1766","부라더","2017-10-17","21",4942,8221,0
"1767","부라더","2017-10-18","28",6066,14287,0
"1768","부라더","2017-10-20","1",166,14453,0
"1769","부라더","2017-10-23","4",1036,15489,0
"1770","부라더","2017-10-25","1",258,15747,0
"1771","부라더","2017-10-28","13",1709,17456,0
"1772","부라더","2017-10-29","10",1812,19268,0
"1773","부라더","2017-10-30","6",1951,21219,0
"1774","부라더","2017-10-31","30",3383,24602,0
"1775","부라더","2017-11-01","2",340,24942,0
"1776","부라더","2017-11-02","712",100941,125883,1
"1777","부라더","2017-11-03","759",130102,255985,2
"1778","부라더","2017-11-04","884",249687,505672,3
"1779","부라더","2017-11-05","889",225890,731562,4
"1780","부라더","2017-11-06","824",69429,800991,5
"1781","부라더","2017-11-07","831",62262,863253,6
"1782","부라더","2017-11-08","803",64328,927581,7
"1783","부라더","2017-11-09","670",47573,975154,8
"1784","부라더","2017-11-10","713",60262,1035416,9
"1785","부라더","2017-11-11","728",133987,1169403,10
"1786","부라더","2017-11-12","725",112963,1282366,11
"1787","부라더","2017-11-13","645",31606,1313972,12
"1788","부라더","2017-11-14","657",28570,1342542,13
"1789","부라더","2017-11-15","645",20431,1362973,14
"1790","부라더","2017-11-16","475",18401,1381374,15
"1791","부라더","2017-11-17","491",16518,1397892,16
"1792","부라더","2017-11-18","479",28393,1426285,17
"1793","부라더","2017-11-19","482",26082,1452367,18
"1794","부라더","2017-11-20","475",9816,1462183,19
"1795","부라더","2017-11-21","487",9856,1472039,20
"1796","부라더","2017-11-22","240",3050,1475089,21
"1797","부라더","2017-11-23","168",2751,1477840,22
"1798","부라더","2017-11-24","158",1963,1479803,23
"1799","부라더","2017-11-25","156",3129,1482932,24
"1800","부라더","2017-11-26","138",2902,1485834,25
"1801","부라더","2017-11-27","154",1600,1487434,26
"1802","부라더","2017-11-28","145",1607,1489041,27
"1803","부라더","2017-11-29","24",640,1489681,28
"1804","부라더","2017-11-30","14",369,1490050,29
"1805","부라더","2017-12-01","12",300,1490350,30
"1806","부라더","2017-12-02","9",89,1490439,31
"1807","부라더","2017-12-03","7",104,1490543,32
"1808","부라더","2017-12-04","28",248,1490791,33
"1809","부라더","2017-12-05","32",369,1491160,34
"1810","부라더","2017-12-06","12",273,1491433,35
"1811","부라더","2017-12-07","8",202,1491635,36
"1812","부라더","2017-12-08","8",318,1491953,37
"1813","부라더","2017-12-09","5",46,1491999,38
"1814","부라더","2017-12-10","5",50,1492049,39
"1815","부라더","2017-12-11","5",50,1492099,40
"1816","부라더","2017-12-12","6",150,1492249,41
"1817","부라더","2017-12-13","7",327,1492576,42
"1818","부라더","2017-12-14","5",50,1492626,43
"1819","부라더","2017-12-15","5",50,1492676,44
"1820","부라더","2017-12-16","5",50,1492726,45
"1821","부라더","2017-12-17","6",127,1492853,46
"1822","부라더","2017-12-18","5",50,1492903,47
"1823","부라더","2018-04-30","1",0,1492903,48
"1824","기억의 밤","2017-11-10","1",900,900,0
"1825","기억의 밤","2017-11-16","1",214,1114,0
"1826","기억의 밤","2017-11-22","4",1401,2515,0
"1827","기억의 밤","2017-11-23","2",470,2985,0
"1828","기억의 밤","2017-11-24","1",166,3151,0
"1829","기억의 밤","2017-11-27","6",1752,4903,0
"1830","기억의 밤","2017-11-28","23",2233,7136,0
"1831","기억의 밤","2017-11-29","704",97245,104381,1
"1832","기억의 밤","2017-11-30","714",69328,173709,2
"1833","기억의 밤","2017-12-01","728",89649,263358,3
"1834","기억의 밤","2017-12-02","747",157883,421241,4
"1835","기억의 밤","2017-12-03","751",148507,569748,5
"1836","기억의 밤","2017-12-04","720",57770,627518,6
"1837","기억의 밤","2017-12-05","749",57348,684866,7
"1838","기억의 밤","2017-12-06","759",58373,743239,8
"1839","기억의 밤","2017-12-07","648",51614,794853,9
"1840","기억의 밤","2017-12-08","653",70332,865185,10
"1841","기억의 밤","2017-12-09","740",123009,988194,11
"1842","기억의 밤","2017-12-10","739",117407,1105601,12
"1843","기억의 밤","2017-12-11","707",47965,1153566,13
"1844","기억의 밤","2017-12-12","691",45538,1199104,14
"1845","기억의 밤","2017-12-13","718",50388,1249492,15
"1846","기억의 밤","2017-12-14","469",19228,1268720,16
"1847","기억의 밤","2017-12-15","478",26185,1294905,17
"1848","기억의 밤","2017-12-16","465",32385,1327290,18
"1849","기억의 밤","2017-12-17","454",26269,1353559,19
"1850","기억의 밤","2017-12-18","463",12469,1366028,20
"1851","기억의 밤","2017-12-19","474",14309,1380337,21
"1852","기억의 밤","2017-12-20","97",2062,1382399,22
"1853","기억의 밤","2017-12-21","38",586,1382985,23
"1854","기억의 밤","2017-12-22","36",746,1383731,24
"1855","기억의 밤","2017-12-23","18",670,1384401,25
"1856","기억의 밤","2017-12-24","17",794,1385195,26
"1857","기억의 밤","2017-12-25","17",567,1385762,27
"1858","기억의 밤","2017-12-26","37",398,1386160,28
"1859","기억의 밤","2017-12-27","25",251,1386411,29
"1860","기억의 밤","2017-12-28","5",50,1386461,30
"1861","기억의 밤","2017-12-29","5",50,1386511,31
"1862","기억의 밤","2017-12-30","5",50,1386561,32
"1863","기억의 밤","2017-12-31","5",50,1386611,33
"1864","기억의 밤","2018-01-01","5",50,1386661,34
"1865","기억의 밤","2018-01-02","5",50,1386711,35
"1866","기억의 밤","2018-01-03","5",50,1386761,36
"1867","기억의 밤","2018-01-04","5",50,1386811,37
"1868","기억의 밤","2018-01-05","5",50,1386861,38
"1869","기억의 밤","2018-01-06","5",50,1386911,39
"1870","기억의 밤","2018-01-07","5",50,1386961,40
"1871","기억의 밤","2018-01-08","5",50,1387011,41
"1872","기억의 밤","2018-01-09","5",50,1387061,42
"1873","기억의 밤","2018-01-10","5",50,1387111,43
"1874","기억의 밤","2018-01-11","5",50,1387161,44
"1875","기억의 밤","2018-01-12","5",50,1387211,45
"1876","기억의 밤","2018-01-13","6",238,1387449,46
"1877","기억의 밤","2018-01-14","5",50,1387499,47
"1878","기억의 밤","2018-01-15","5",50,1387549,48
"1879","기억의 밤","2018-01-16","5",50,1387599,49
"1880","기억의 밤","2018-03-19","15",48,1387647,50
"1881","기억의 밤","2018-03-20","17",40,1387687,51
"1882","기억의 밤","2018-03-21","11",47,1387734,52
"1883","기억의 밤","2018-03-22","11",30,1387764,53
"1884","기억의 밤","2018-03-23","8",15,1387779,54
"1885","브이아이피","2017-08-16","4",1634,1634,0
"1886","브이아이피","2017-08-21","5",1005,2639,0
"1887","브이아이피","2017-08-22","28",4841,7480,0
"1888","브이아이피","2017-08-23","851",174011,181491,1
"1889","브이아이피","2017-08-24","897",160139,341630,2
"1890","브이아이피","2017-08-25","958",146348,487978,3
"1891","브이아이피","2017-08-26","996",244541,732519,4
"1892","브이아이피","2017-08-27","951",207804,940323,5
"1893","브이아이피","2017-08-28","890",77647,1017970,6
"1894","브이아이피","2017-08-29","896",68261,1086231,7
"1895","브이아이피","2017-08-30","601",63110,1149341,8
"1896","브이아이피","2017-08-31","576",30612,1179953,9
"1897","브이아이피","2017-09-01","582",33664,1213617,10
"1898","브이아이피","2017-09-02","581",55358,1268975,11
"1899","브이아이피","2017-09-03","558",46508,1315483,12
"1900","브이아이피","2017-09-04","545",16969,1332452,13
"1901","브이아이피","2017-09-05","542",14494,1346946,14
"1902","브이아이피","2017-09-06","289",3849,1350795,15
"1903","브이아이피","2017-09-07","251",2537,1353332,16
"1904","브이아이피","2017-09-08","235",2275,1355607,17
"1905","브이아이피","2017-09-09","225",4289,1359896,18
"1906","브이아이피","2017-09-10","207",5057,1364953,19
"1907","브이아이피","2017-09-11","223",1689,1366642,20
"1908","브이아이피","2017-09-12","212",1934,1368576,21
"1909","브이아이피","2017-09-13","168",1112,1369688,22
"1910","브이아이피","2017-09-14","49",807,1370495,23
"1911","브이아이피","2017-09-15","34",185,1370680,24
"1912","브이아이피","2017-09-16","33",303,1370983,25
"1913","브이아이피","2017-09-17","26",138,1371121,26
"1914","브이아이피","2017-09-18","43",1656,1372777,27
"1915","브이아이피","2017-09-19","32",199,1372976,28
"1916","브이아이피","2017-09-20","27",221,1373197,29
"1917","브이아이피","2017-09-21","4",68,1373265,30
"1918","브이아이피","2017-09-22","2",2,1373267,31
"1919","브이아이피","2017-09-23","2",2,1373269,32
"1920","브이아이피","2017-09-24","2",2,1373271,33
"1921","브이아이피","2017-09-25","2",2,1373273,34
"1922","브이아이피","2017-09-26","1",1,1373274,35
"1923","브이아이피","2017-09-27","2",2,1373276,36
"1924","브이아이피","2017-09-28","2",2,1373278,37
"1925","브이아이피","2017-09-29","2",2,1373280,38
"1926","브이아이피","2017-09-30","2",2,1373282,39
"1927","브이아이피","2017-10-01","2",2,1373284,40
"1928","브이아이피","2017-10-02","2",2,1373286,41
"1929","브이아이피","2017-10-03","2",2,1373288,42
"1930","브이아이피","2017-10-04","2",2,1373290,43
"1931","브이아이피","2017-10-05","2",2,1373292,44
"1932","브이아이피","2017-10-06","2",2,1373294,45
"1933","브이아이피","2017-10-07","2",2,1373296,46
"1934","브이아이피","2017-10-08","2",2,1373298,47
"1935","브이아이피","2017-10-09","3",18,1373316,48
"1936","특별시민","2017-04-18","21",2274,2274,0
"1937","특별시민","2017-04-21","11",1976,4250,0
"1938","특별시민","2017-04-22","1",124,4374,0
"1939","특별시민","2017-04-24","15",3181,7555,0
"1940","특별시민","2017-04-25","5",1076,8631,0
"1941","특별시민","2017-04-26","1,154",186007,194638,1
"1942","특별시민","2017-04-27","1,132",110872,305510,2
"1943","특별시민","2017-04-28","1,150",134485,439995,3
"1944","특별시민","2017-04-29","1,148",240988,680983,4
"1945","특별시민","2017-04-30","1,113",223261,904244,5
"1946","특별시민","2017-05-01","1,087",149835,1054079,6
"1947","특별시민","2017-05-02","1,134",82119,1136198,7
"1948","특별시민","2017-05-03","597",72290,1208488,8
"1949","특별시민","2017-05-04","549",35640,1244128,9
"1950","특별시민","2017-05-05","510",44484,1288612,10
"1951","특별시민","2017-05-06","479",27522,1316134,11
"1952","특별시민","2017-05-07","476",17950,1334084,12
"1953","특별시민","2017-05-08","478",11613,1345697,13
"1954","특별시민","2017-05-09","165",4256,1349953,14
"1955","특별시민","2017-05-10","142",1741,1351694,15
"1956","특별시민","2017-05-11","124",1418,1353112,16
"1957","특별시민","2017-05-12","137",1591,1354703,17
"1958","특별시민","2017-05-13","93",1636,1356339,18
"1959","특별시민","2017-05-14","87",1049,1357388,19
"1960","특별시민","2017-05-15","105",672,1358060,20
"1961","특별시민","2017-05-16","104",913,1358973,21
"1962","특별시민","2017-05-17","14",748,1359721,22
"1963","특별시민","2017-05-18","3",113,1359834,23
"1964","특별시민","2017-05-19","3",77,1359911,24
"1965","특별시민","2017-05-20","2",32,1359943,25
"1966","특별시민","2017-05-21","2",13,1359956,26
"1967","특별시민","2017-05-22","3",31,1359987,27
"1968","특별시민","2017-05-23","9",302,1360289,28
"1969","특별시민","2017-05-24","2",46,1360335,29
"1970","특별시민","2017-05-25","5",195,1360530,30
"1971","특별시민","2017-05-26","1",18,1360548,31
"1972","특별시민","2017-05-27","1",43,1360591,32
"1973","특별시민","2017-05-29","1",55,1360646,33
"1974","특별시민","2017-05-31","21",600,1361246,34
"1975","특별시민","2017-06-01","7",188,1361434,35
"1976","특별시민","2017-06-02","5",100,1361534,36
"1977","특별시민","2017-06-03","5",100,1361634,37
"1978","특별시민","2017-06-04","5",100,1361734,38
"1979","특별시민","2017-06-05","5",100,1361834,39
"1980","특별시민","2017-06-06","5",100,1361934,40
"1981","특별시민","2017-06-07","5",100,1362034,41
"1982","특별시민","2017-06-08","5",100,1362134,42
"1983","특별시민","2017-06-09","6",100,1362234,43
"1984","특별시민","2017-06-10","5",100,1362334,44
"1985","특별시민","2017-06-11","5",100,1362434,45
"1986","특별시민","2017-06-12","5",100,1362534,46
"1987","특별시민","2017-06-13","5",100,1362634,47
"1988","특별시민","2017-12-21","1",0,1362634,48
"1989","장산범","2017-06-22","1",282,282,0
"1990","장산범","2017-07-18","3",943,1225,0
"1991","장산범","2017-07-21","1",68,1293,0
"1992","장산범","2017-08-04","1",406,1699,0
"1993","장산범","2017-08-08","4",1929,3628,0
"1994","장산범","2017-08-09","1",315,3943,0
"1995","장산범","2017-08-10","19",4262,8205,0
"1996","장산범","2017-08-14","1",279,8484,0
"1997","장산범","2017-08-15","7",881,9365,0
"1998","장산범","2017-08-16","6",942,10307,0
"1999","장산범","2017-08-17","621",121834,132141,1
"2000","장산범","2017-08-18","655",125554,257695,2
"2001","장산범","2017-08-19","711",202956,460651,3
"2002","장산범","2017-08-20","703",183311,643962,4
"2003","장산범","2017-08-21","626",79511,723473,5
"2004","장산범","2017-08-22","648",69637,793110,6
"2005","장산범","2017-08-23","607",48838,841948,7
"2006","장산범","2017-08-24","534",38798,880746,8
"2007","장산범","2017-08-25","555",53457,934203,9
"2008","장산범","2017-08-26","592",102702,1036905,10
"2009","장산범","2017-08-27","617",84980,1121885,11
"2010","장산범","2017-08-28","548",27765,1149650,12
"2011","장산범","2017-08-29","559",24918,1174568,13
"2012","장산범","2017-08-30","337",25062,1199630,14
"2013","장산범","2017-08-31","323",11552,1211182,15
"2014","장산범","2017-09-01","341",15711,1226893,16
"2015","장산범","2017-09-02","379",33804,1260697,17
"2016","장산범","2017-09-03","368",26107,1286804,18
"2017","장산범","2017-09-04","311",6922,1293726,19
"2018","장산범","2017-09-05","314",6121,1299847,20
"2019","장산범","2017-09-06","99",1419,1301266,21
"2020","장산범","2017-09-07","68",542,1301808,22
"2021","장산범","2017-09-08","67",649,1302457,23
"2022","장산범","2017-09-09","74",1318,1303775,24
"2023","장산범","2017-09-10","70",964,1304739,25
"2024","장산범","2017-09-11","61",345,1305084,26
"2025","장산범","2017-09-12","60",280,1305364,27
"2026","장산범","2017-09-13","40",217,1305581,28
"2027","장산범","2017-09-14","2",6,1305587,29
"2028","장산범","2017-09-15","1",2,1305589,30
"2029","장산범","2017-09-16","3",23,1305612,31
"2030","장산범","2017-09-17","1",2,1305614,32
"2031","장산범","2017-09-18","1",10,1305624,33
"2032","장산범","2017-09-19","7",39,1305663,34
"2033","장산범","2017-09-20","8",40,1305703,35
"2034","장산범","2017-09-21","6",35,1305738,36
"2035","장산범","2017-09-22","6",35,1305773,37
"2036","장산범","2017-09-23","5",41,1305814,38
"2037","장산범","2017-09-24","4",32,1305846,39
"2038","장산범","2017-09-25","5",31,1305877,40
"2039","장산범","2017-09-26","5",35,1305912,41
"2040","장산범","2017-09-27","5",44,1305956,42
"2041","장산범","2017-09-28","5",46,1306002,43
"2042","장산범","2017-09-29","5",43,1306045,44
"2043","장산범","2017-09-30","5",52,1306097,45
"2044","장산범","2017-10-01","5",39,1306136,46
"2045","장산범","2017-10-02","5",32,1306168,47
"2046","장산범","2017-10-03","5",35,1306203,48
"2047","장산범","2017-10-04","5",36,1306239,49
"2048","장산범","2017-10-05","5",36,1306275,50
"2049","장산범","2017-10-06","5",35,1306310,51
"2050","장산범","2017-10-07","5",39,1306349,52
"2051","장산범","2017-10-08","5",38,1306387,53
"2052","장산범","2017-10-09","5",31,1306418,54
"2053","장산범","2017-10-31","1",3,1306421,55
"2054","장산범","2017-11-15","1",0,1306421,56
"2055","장산범","2017-11-16","1",2,1306423,57
"2056","장산범","2017-11-17","1",5,1306428,58
"2057","장산범","2017-11-19","1",2,1306430,59
"2058","장산범","2017-11-20","1",2,1306432,60
"2059","장산범","2017-11-21","1",6,1306438,61
"2060","장산범","2017-11-22","1",0,1306438,62
"2061","장산범","2017-12-20","1",0,1306438,63
"2062","장산범","2018-05-02","1",0,1306438,64
"2063","악녀","2017-05-28","1",274,274,0
"2064","악녀","2017-05-30","4",890,1164,0
"2065","악녀","2017-06-03","2",348,1512,0
"2066","악녀","2017-06-05","9",2575,4087,0
"2067","악녀","2017-06-07","1",326,4413,0
"2068","악녀","2017-06-08","563",73305,77718,1
"2069","악녀","2017-06-09","590",80452,158170,2
"2070","악녀","2017-06-10","671",149219,307389,3
"2071","악녀","2017-06-11","679",151449,458838,4
"2072","악녀","2017-06-12","660",62732,521570,5
"2073","악녀","2017-06-13","678",57342,578912,6
"2074","악녀","2017-06-14","685",58452,637364,7
"2075","악녀","2017-06-15","581",42513,679877,8
"2076","악녀","2017-06-16","606",52939,732816,9
"2077","악녀","2017-06-17","629",102101,834917,10
"2078","악녀","2017-06-18","629",92143,927060,11
"2079","악녀","2017-06-19","599",34993,962053,12
"2080","악녀","2017-06-20","617",32972,995025,13
"2081","악녀","2017-06-21","442",19882,1014907,14
"2082","악녀","2017-06-22","416",17130,1032037,15
"2083","악녀","2017-06-23","451",20652,1052689,16
"2084","악녀","2017-06-24","463",37035,1089724,17
"2085","악녀","2017-06-25","465",37775,1127499,18
"2086","악녀","2017-06-26","458",19001,1146500,19
"2087","악녀","2017-06-27","470",17302,1163802,20
"2088","악녀","2017-06-28","234",5254,1169056,21
"2089","악녀","2017-06-29","221",3997,1173053,22
"2090","악녀","2017-06-30","234",4822,1177875,23
"2091","악녀","2017-07-01","233",7910,1185785,24
"2092","악녀","2017-07-02","220",7103,1192888,25
"2093","악녀","2017-07-03","241",4046,1196934,26
"2094","악녀","2017-07-04","240",3656,1200590,27
"2095","악녀","2017-07-05","62",665,1201255,28
"2096","악녀","2017-07-06","47",418,1201673,29
"2097","악녀","2017-07-07","50",515,1202188,30
"2098","악녀","2017-07-08","42",755,1202943,31
"2099","악녀","2017-07-09","47",585,1203528,32
"2100","악녀","2017-07-10","46",361,1203889,33
"2101","악녀","2017-07-11","51",429,1204318,34
"2102","악녀","2017-07-12","56",475,1204793,35
"2103","악녀","2017-07-13","33",401,1205194,36
"2104","악녀","2017-07-14","40",543,1205737,37
"2105","악녀","2017-07-15","38",698,1206435,38
"2106","악녀","2017-07-16","36",684,1207119,39
"2107","악녀","2017-07-17","36",341,1207460,40
"2108","악녀","2017-07-18","40",354,1207814,41
"2109","악녀","2017-07-19","30",267,1208081,42
"2110","악녀","2017-11-16","1",0,1208081,43
"2111","악녀","2017-11-21","1",0,1208081,44
"2112","악녀","2017-12-09","1",0,1208081,45
"2113","해빙","2017-02-17","1",401,401,0
"2114","해빙","2017-02-24","3",863,1264,0
"2115","해빙","2017-02-28","5",1760,3024,0
"2116","해빙","2017-03-01","828",386128,389152,1
"2117","해빙","2017-03-02","802",87354,476506,2
"2118","해빙","2017-03-03","850",91277,567783,3
"2119","해빙","2017-03-04","915",191841,759624,4
"2120","해빙","2017-03-05","896",150264,909888,5
"2121","해빙","2017-03-06","766",39765,949653,6
"2122","해빙","2017-03-07","770",34330,983983,7
"2123","해빙","2017-03-08","570",22936,1006919,8
"2124","해빙","2017-03-09","542",20217,1027136,9
"2125","해빙","2017-03-10","536",22843,1049979,10
"2126","해빙","2017-03-11","544",50276,1100255,11
"2127","해빙","2017-03-12","532",41939,1142194,12
"2128","해빙","2017-03-13","496",11382,1153576,13
"2129","해빙","2017-03-14","502",11630,1165206,14
"2130","해빙","2017-03-15","498",10218,1175424,15
"2131","해빙","2017-03-16","243",3571,1178995,16
"2132","해빙","2017-03-17","251",4267,1183262,17
"2133","해빙","2017-03-18","253",8190,1191452,18
"2134","해빙","2017-03-19","250",6417,1197869,19
"2135","해빙","2017-03-20","226",2104,1199973,20
"2136","해빙","2017-03-21","232",2223,1202196,21
"2137","해빙","2017-03-22","156",984,1203180,22
"2138","해빙","2017-03-23","5",38,1203218,23
"2139","해빙","2017-03-24","6",66,1203284,24
"2140","해빙","2017-03-25","6",211,1203495,25
"2141","해빙","2017-03-26","3",36,1203531,26
"2142","해빙","2017-03-27","3",28,1203559,27
"2143","해빙","2017-03-28","3",33,1203592,28
"2144","해빙","2017-03-29","2",3,1203595,29
"2145","해빙","2017-03-30","4",8,1203603,30
"2146","해빙","2017-03-31","2",14,1203617,31
"2147","해빙","2017-04-01","2",6,1203623,32
"2148","해빙","2017-04-02","4",16,1203639,33
"2149","해빙","2017-04-03","1",2,1203641,34
"2150","해빙","2017-04-04","16",151,1203792,35
"2151","해빙","2017-04-05","3",4,1203796,36
"2152","해빙","2017-04-06","4",55,1203851,37
"2153","해빙","2017-04-07","5",49,1203900,38
"2154","해빙","2017-04-08","6",82,1203982,39
"2155","해빙","2017-04-09","5",70,1204052,40
"2156","해빙","2017-04-10","7",59,1204111,41
"2157","해빙","2017-04-11","5",47,1204158,42
"2158","해빙","2017-04-12","4",42,1204200,43
"2159","해빙","2017-04-13","4",43,1204243,44
"2160","해빙","2017-04-14","4",51,1204294,45
"2161","해빙","2017-04-15","4",36,1204330,46
"2162","해빙","2017-04-16","4",54,1204384,47
"2163","해빙","2017-04-17","3",31,1204415,48
"2164","해빙","2017-04-18","3",30,1204445,49
"2165","해빙","2017-04-19","4",125,1204570,50
"2166","해빙","2017-04-21","1",30,1204600,51
"2167","해빙","2017-04-29","1",0,1204600,52
"2168","해빙","2017-06-19","1",0,1204600,53
"2169","해빙","2017-06-29","1",0,1204600,54
"2170","해빙","2017-11-17","1",0,1204600,55
"2171","해빙","2017-11-20","1",0,1204600,56
"2172","하루","2017-04-19","1",238,238,0
"2173","하루","2017-05-30","1",119,357,0
"2174","하루","2017-05-31","2",234,591,0
"2175","하루","2017-06-03","1",107,698,0
"2176","하루","2017-06-07","8",1799,2497,0
"2177","하루","2017-06-08","2",407,2904,0
"2178","하루","2017-06-09","3",426,3330,0
"2179","하루","2017-06-10","5",1112,4442,0
"2180","하루","2017-06-13","7",810,5252,0
"2181","하루","2017-06-14","5",1872,7124,0
"2182","하루","2017-06-15","672",77978,85102,1
"2183","하루","2017-06-16","707",101803,186905,2
"2184","하루","2017-06-17","769",199548,386453,3
"2185","하루","2017-06-18","781",179441,565894,4
"2186","하루","2017-06-19","700",58150,624044,5
"2187","하루","2017-06-20","733",56833,680877,6
"2188","하루","2017-06-21","597",43196,724073,7
"2189","하루","2017-06-22","562",38578,762651,8
"2190","하루","2017-06-23","594",44572,807223,9
"2191","하루","2017-06-24","663",90935,898158,10
"2192","하루","2017-06-25","666",90994,989152,11
"2193","하루","2017-06-26","630",33944,1023096,12
"2194","하루","2017-06-27","625",32025,1055121,13
"2195","하루","2017-06-28","442",14217,1069338,14
"2196","하루","2017-06-29","397",7134,1076472,15
"2197","하루","2017-06-30","425",9206,1085678,16
"2198","하루","2017-07-01","420",13441,1099119,17
"2199","하루","2017-07-02","409",12739,1111858,18
"2200","하루","2017-07-03","376",5406,1117264,19
"2201","하루","2017-07-04","379",5809,1123073,20
"2202","하루","2017-07-05","120",1124,1124197,21
"2203","하루","2017-07-06","103",872,1125069,22
"2204","하루","2017-07-07","101",895,1125964,23
"2205","하루","2017-07-08","74",1006,1126970,24
"2206","하루","2017-07-09","73",794,1127764,25
"2207","하루","2017-07-10","76",567,1128331,26
"2208","하루","2017-07-11","75",516,1128847,27
"2209","하루","2017-07-12","50",246,1129093,28
"2210","하루","2017-07-13","4",34,1129127,29
"2211","하루","2017-07-14","4",48,1129175,30
"2212","하루","2017-07-15","2",28,1129203,31
"2213","하루","2017-07-16","4",30,1129233,32
"2214","하루","2017-07-17","4",247,1129480,33
"2215","하루","2017-07-18","5",87,1129567,34
"2216","하루","2017-07-19","5",23,1129590,35
"2217","하루","2017-07-20","3",6,1129596,36
"2218","하루","2017-07-21","2",2,1129598,37
"2219","하루","2017-07-23","1",2,1129600,38
"2220","하루","2017-07-24","1",2,1129602,39
"2221","하루","2017-07-25","1",7,1129609,40
"2222","하루","2017-08-01","2",0,1129609,41
"2223","불한당: 나쁜 놈들의 세상","2017-05-02","4",1549,1549,0
"2224","불한당: 나쁜 놈들의 세상","2017-05-11","22",5321,6870,0
"2225","불한당: 나쁜 놈들의 세상","2017-05-12","7",2983,9853,0
"2226","불한당: 나쁜 놈들의 세상","2017-05-13","37",4336,14189,0
"2227","불한당: 나쁜 놈들의 세상","2017-05-14","41",4713,18902,0
"2228","불한당: 나쁜 놈들의 세상","2017-05-15","13",2542,21444,0
"2229","불한당: 나쁜 놈들의 세상","2017-05-16","34",4819,26263,0
"2230","불한당: 나쁜 놈들의 세상","2017-05-17","800",95271,121534,1
"2231","불한당: 나쁜 놈들의 세상","2017-05-18","813",91667,213201,2
"2232","불한당: 나쁜 놈들의 세상","2017-05-19","828",87670,300871,3
"2233","불한당: 나쁜 놈들의 세상","2017-05-20","860",150449,451320,4
"2234","불한당: 나쁜 놈들의 세상","2017-05-21","826",138594,589914,5
"2235","불한당: 나쁜 놈들의 세상","2017-05-22","752",50096,640010,6
"2236","불한당: 나쁜 놈들의 세상","2017-05-23","767",43303,683313,7
"2237","불한당: 나쁜 놈들의 세상","2017-05-24","497",29212,712525,8
"2238","불한당: 나쁜 놈들의 세상","2017-05-25","461",22610,735135,9
"2239","불한당: 나쁜 놈들의 세상","2017-05-26","471",26798,761933,10
"2240","불한당: 나쁜 놈들의 세상","2017-05-27","485",42571,804504,11
"2241","불한당: 나쁜 놈들의 세상","2017-05-28","462",41762,846266,12
"2242","불한당: 나쁜 놈들의 세상","2017-05-29","474",19379,865645,13
"2243","불한당: 나쁜 놈들의 세상","2017-05-30","486",19233,884878,14
"2244","불한당: 나쁜 놈들의 세상","2017-05-31","188",5899,890777,15
"2245","불한당: 나쁜 놈들의 세상","2017-06-01","179",3779,894556,16
"2246","불한당: 나쁜 놈들의 세상","2017-06-02","168",3923,898479,17
"2247","불한당: 나쁜 놈들의 세상","2017-06-03","136",5171,903650,18
"2248","불한당: 나쁜 놈들의 세상","2017-06-04","136",4621,908271,19
"2249","불한당: 나쁜 놈들의 세상","2017-06-05","161",4476,912747,20
"2250","불한당: 나쁜 놈들의 세상","2017-06-06","28",951,913698,21
"2251","불한당: 나쁜 놈들의 세상","2017-06-07","54",1292,914990,22
"2252","불한당: 나쁜 놈들의 세상","2017-06-08","45",894,915884,23
"2253","불한당: 나쁜 놈들의 세상","2017-06-09","30",1350,917234,24
"2254","불한당: 나쁜 놈들의 세상","2017-06-10","27",859,918093,25
"2255","불한당: 나쁜 놈들의 세상","2017-06-11","27",730,918823,26
"2256","불한당: 나쁜 놈들의 세상","2017-06-12","29",463,919286,27
"2257","불한당: 나쁜 놈들의 세상","2017-06-13","47",1147,920433,28
"2258","불한당: 나쁜 놈들의 세상","2017-06-14","37",792,921225,29
"2259","불한당: 나쁜 놈들의 세상","2017-06-15","30",943,922168,30
"2260","불한당: 나쁜 놈들의 세상","2017-06-16","13",999,923167,31
"2261","불한당: 나쁜 놈들의 세상","2017-06-17","20",1018,924185,32
"2262","불한당: 나쁜 놈들의 세상","2017-06-18","11",428,924613,33
"2263","불한당: 나쁜 놈들의 세상","2017-06-19","11",350,924963,34
"2264","불한당: 나쁜 놈들의 세상","2017-06-20","14",1112,926075,35
"2265","불한당: 나쁜 놈들의 세상","2017-06-21","8",460,926535,36
"2266","불한당: 나쁜 놈들의 세상","2017-06-22","8",781,927316,37
"2267","불한당: 나쁜 놈들의 세상","2017-06-23","6",471,927787,38
"2268","불한당: 나쁜 놈들의 세상","2017-06-24","5",737,928524,39
"2269","불한당: 나쁜 놈들의 세상","2017-06-25","4",369,928893,40
"2270","불한당: 나쁜 놈들의 세상","2017-06-26","4",190,929083,41
"2271","불한당: 나쁜 놈들의 세상","2017-06-27","5",238,929321,42
"2272","불한당: 나쁜 놈들의 세상","2017-06-28","3",221,929542,43
"2273","불한당: 나쁜 놈들의 세상","2017-06-29","3",98,929640,44
"2274","불한당: 나쁜 놈들의 세상","2017-06-30","6",1226,930866,45
"2275","불한당: 나쁜 놈들의 세상","2017-07-01","5",141,931007,46
"2276","불한당: 나쁜 놈들의 세상","2017-07-02","6",639,931646,47
"2277","불한당: 나쁜 놈들의 세상","2017-07-03","6",101,931747,48
"2278","불한당: 나쁜 놈들의 세상","2017-07-04","6",570,932317,49
"2279","불한당: 나쁜 놈들의 세상","2017-07-05","3",104,932421,50
"2280","불한당: 나쁜 놈들의 세상","2017-07-06","2",42,932463,51
"2281","불한당: 나쁜 놈들의 세상","2017-07-07","3",739,933202,52
"2282","불한당: 나쁜 놈들의 세상","2017-07-08","2",246,933448,53
"2283","불한당: 나쁜 놈들의 세상","2017-07-09","2",84,933532,54
"2284","불한당: 나쁜 놈들의 세상","2017-07-10","1",34,933566,55
"2285","불한당: 나쁜 놈들의 세상","2017-07-11","1",88,933654,56
"2286","불한당: 나쁜 놈들의 세상","2017-07-12","1",68,933722,57
"2287","불한당: 나쁜 놈들의 세상","2017-07-13","2",106,933828,58
"2288","불한당: 나쁜 놈들의 세상","2017-07-14","3",295,934123,59
"2289","불한당: 나쁜 놈들의 세상","2017-07-15","4",220,934343,60
"2290","불한당: 나쁜 놈들의 세상","2017-07-16","2",102,934445,61
"2291","불한당: 나쁜 놈들의 세상","2017-07-17","5",118,934563,62
"2292","불한당: 나쁜 놈들의 세상","2017-07-18","5",129,934692,63
"2293","불한당: 나쁜 놈들의 세상","2017-07-19","6",114,934806,64
"2294","불한당: 나쁜 놈들의 세상","2017-07-20","2",68,934874,65
"2295","불한당: 나쁜 놈들의 세상","2017-07-21","3",371,935245,66
"2296","불한당: 나쁜 놈들의 세상","2017-07-22","3",191,935436,67
"2297","불한당: 나쁜 놈들의 세상","2017-07-23","3",95,935531,68
"2298","불한당: 나쁜 놈들의 세상","2017-07-24","2",41,935572,69
"2299","불한당: 나쁜 놈들의 세상","2017-07-25","2",123,935695,70
"2300","불한당: 나쁜 놈들의 세상","2017-07-26","1",132,935827,71
"2301","불한당: 나쁜 놈들의 세상","2017-07-29","3",435,936262,72
"2302","불한당: 나쁜 놈들의 세상","2017-08-04","1",114,936376,73
"2303","불한당: 나쁜 놈들의 세상","2017-08-24","1",35,936411,74
"2304","불한당: 나쁜 놈들의 세상","2017-09-02","1",174,936585,75
"2305","불한당: 나쁜 놈들의 세상","2017-09-16","2",482,937067,76
"2306","불한당: 나쁜 놈들의 세상","2017-09-23","1",35,937102,77
"2307","불한당: 나쁜 놈들의 세상","2017-10-14","2",150,937252,78
"2308","불한당: 나쁜 놈들의 세상","2017-10-28","1",400,937652,79
"2309","불한당: 나쁜 놈들의 세상","2017-10-29","1",110,937762,80
"2310","불한당: 나쁜 놈들의 세상","2017-11-04","1",150,937912,81
"2311","불한당: 나쁜 놈들의 세상","2017-11-18","1",0,937912,82
"2312","불한당: 나쁜 놈들의 세상","2017-11-21","1",0,937912,83
"2313","불한당: 나쁜 놈들의 세상","2017-11-28","4",572,938484,84
"2314","불한당: 나쁜 놈들의 세상","2017-12-01","1",92,938576,85
"2315","불한당: 나쁜 놈들의 세상","2017-12-09","1",87,938663,86
"2316","불한당: 나쁜 놈들의 세상","2017-12-10","1",61,938724,87
"2317","불한당: 나쁜 놈들의 세상","2017-12-15","1",63,938787,88
"2318","불한당: 나쁜 놈들의 세상","2017-12-16","1",92,938879,89
"2319","불한당: 나쁜 놈들의 세상","2017-12-17","1",69,938948,90
"2320","불한당: 나쁜 놈들의 세상","2017-12-19","2",270,939218,91
"2321","불한당: 나쁜 놈들의 세상","2017-12-21","1",46,939264,92
"2322","불한당: 나쁜 놈들의 세상","2017-12-23","1",53,939317,93
"2323","불한당: 나쁜 놈들의 세상","2017-12-30","1",218,939535,94
"2324","불한당: 나쁜 놈들의 세상","2018-01-13","1",42,939577,95
"2325","불한당: 나쁜 놈들의 세상","2018-01-20","1",120,939697,96
"2326","불한당: 나쁜 놈들의 세상","2018-01-27","1",190,939887,97
"2327","불한당: 나쁜 놈들의 세상","2018-02-11","1",169,940056,98
"2328","불한당: 나쁜 놈들의 세상","2018-02-19","58",1865,941921,99
"2329","불한당: 나쁜 놈들의 세상","2018-02-20","59",1466,943387,100
"2330","불한당: 나쁜 놈들의 세상","2018-02-21","66",1324,944711,101
"2331","불한당: 나쁜 놈들의 세상","2018-02-22","57",1086,945797,102
"2332","불한당: 나쁜 놈들의 세상","2018-02-23","63",1143,946940,103
"2333","불한당: 나쁜 놈들의 세상","2018-02-24","64",1330,948270,104
"2334","불한당: 나쁜 놈들의 세상","2018-02-25","63",1326,949596,105
"2335","불한당: 나쁜 놈들의 세상","2018-02-26","59",665,950261,106
"2336","불한당: 나쁜 놈들의 세상","2018-02-27","62",868,951129,107
"2337","불한당: 나쁜 놈들의 세상","2018-02-28","24",558,951687,108
"2338","불한당: 나쁜 놈들의 세상","2018-03-11","1",110,951797,109
"2339","불한당: 나쁜 놈들의 세상","2018-04-14","1",24,951821,110
"2340","불한당: 나쁜 놈들의 세상","2018-05-17","1",598,952419,111
"2341","불한당: 나쁜 놈들의 세상","2018-05-19","1",598,953017,112
"2342","불한당: 나쁜 놈들의 세상","2018-05-20","1",82,953099,113
"2343","불한당: 나쁜 놈들의 세상","2018-05-26","1",11,953110,114
"2344","불한당: 나쁜 놈들의 세상","2018-05-27","1",11,953121,115
"2345","불한당: 나쁜 놈들의 세상","2018-05-28","1",6,953127,116
"2346","불한당: 나쁜 놈들의 세상","2018-05-30","1",5,953132,117
"2347","불한당: 나쁜 놈들의 세상","2018-05-31","1",3,953135,118
"2348","불한당: 나쁜 놈들의 세상","2018-06-01","1",11,953146,119
"2349","불한당: 나쁜 놈들의 세상","2018-06-02","1",8,953154,120
"2350","불한당: 나쁜 놈들의 세상","2018-06-03","1",6,953160,121
"2351","불한당: 나쁜 놈들의 세상","2018-06-04","1",2,953162,122
"2352","불한당: 나쁜 놈들의 세상","2018-06-05","1",4,953166,123
"2353","불한당: 나쁜 놈들의 세상","2018-06-06","1",3,953169,124
"2354","불한당: 나쁜 놈들의 세상","2018-06-07","1",2,953171,125
"2355","불한당: 나쁜 놈들의 세상","2018-06-08","1",14,953185,126
"2356","불한당: 나쁜 놈들의 세상","2018-06-09","1",5,953190,127
"2357","불한당: 나쁜 놈들의 세상","2018-06-10","1",3,953193,128
"2358","불한당: 나쁜 놈들의 세상","2018-06-11","1",3,953196,129
"2359","불한당: 나쁜 놈들의 세상","2018-06-12","1",3,953199,130
"2360","불한당: 나쁜 놈들의 세상","2018-06-13","1",5,953204,131
"2361","불한당: 나쁜 놈들의 세상","2018-06-14","1",2,953206,132
"2362","불한당: 나쁜 놈들의 세상","2018-06-15","1",4,953210,133
"2363","불한당: 나쁜 놈들의 세상","2018-06-17","1",1,953211,134
"2364","불한당: 나쁜 놈들의 세상","2018-06-18","1",1,953212,135
"2365","불한당: 나쁜 놈들의 세상","2018-06-20","1",8,953220,136
"2366","불한당: 나쁜 놈들의 세상","2018-06-21","1",3,953223,137
"2367","불한당: 나쁜 놈들의 세상","2018-06-22","1",4,953227,138
"2368","불한당: 나쁜 놈들의 세상","2018-06-23","1",59,953286,139
"2369","불한당: 나쁜 놈들의 세상","2018-06-25","1",6,953292,140
"2370","불한당: 나쁜 놈들의 세상","2018-06-27","1",2,953294,141
"2371","불한당: 나쁜 놈들의 세상","2018-06-30","1",11,953305,142
"2372","불한당: 나쁜 놈들의 세상","2018-07-21","1",380,953685,143
"2373","불한당: 나쁜 놈들의 세상","2018-08-18","1",300,953985,144
"2374","불한당: 나쁜 놈들의 세상","2018-09-08","1",75,954060,145
"2375","불한당: 나쁜 놈들의 세상","2018-09-29","1",55,954115,146
"2376","불한당: 나쁜 놈들의 세상","2018-10-28","1",75,954190,147
"2377","불한당: 나쁜 놈들의 세상","2018-11-17","1",55,954245,148
"2378","불한당: 나쁜 놈들의 세상","2018-12-01","2",199,954444,149
"2379","불한당: 나쁜 놈들의 세상","2019-01-26","1",129,954573,150
"2380","불한당: 나쁜 놈들의 세상","2019-02-16","1",75,954648,151
"2381","불한당: 나쁜 놈들의 세상","2019-02-24","1",75,954723,152
"2382","대립군","2017-05-19","1",197,197,0
"2383","대립군","2017-05-22","4",1009,1206,0
"2384","대립군","2017-05-25","11",3549,4755,0
"2385","대립군","2017-05-26","3",485,5240,0
"2386","대립군","2017-05-27","1",151,5391,0
"2387","대립군","2017-05-29","28",3339,8730,0
"2388","대립군","2017-05-30","14",2014,10744,0
"2389","대립군","2017-05-31","809",136240,146984,1
"2390","대립군","2017-06-01","776",73171,220155,2
"2391","대립군","2017-06-02","786",85851,306006,3
"2392","대립군","2017-06-03","725",153756,459762,4
"2393","대립군","2017-06-04","714",134745,594507,5
"2394","대립군","2017-06-05","687",73276,667783,6
"2395","대립군","2017-06-06","534",61573,729356,7
"2396","대립군","2017-06-07","513",17446,746802,8
"2397","대립군","2017-06-08","436",10589,757391,9
"2398","대립군","2017-06-09","442",10115,767506,10
"2399","대립군","2017-06-10","388",13284,780790,11
"2400","대립군","2017-06-11","364",11850,792640,12
"2401","대립군","2017-06-12","390",5785,798425,13
"2402","대립군","2017-06-13","379",5550,803975,14
"2403","대립군","2017-06-14","351",5244,809219,15
"2404","대립군","2017-06-15","101",1733,810952,16
"2405","대립군","2017-06-16","100",2076,813028,17
"2406","대립군","2017-06-17","76",1476,814504,18
"2407","대립군","2017-06-18","71",1253,815757,19
"2408","대립군","2017-06-19","75",1410,817167,20
"2409","대립군","2017-06-20","80",1194,818361,21
"2410","대립군","2017-06-21","91",13750,832111,22
"2411","대립군","2017-06-22","19",899,833010,23
"2412","대립군","2017-06-23","17",216,833226,24
"2413","대립군","2017-06-24","11",261,833487,25
"2414","대립군","2017-06-25","12",239,833726,26
"2415","대립군","2017-06-26","18",802,834528,27
"2416","대립군","2017-06-27","14",314,834842,28
"2417","대립군","2017-06-28","8",722,835564,29
"2418","대립군","2017-06-29","6",526,836090,30
"2419","대립군","2017-06-30","3",50,836140,31
"2420","대립군","2017-07-01","4",195,836335,32
"2421","대립군","2017-07-02","3",65,836400,33
"2422","대립군","2017-07-03","3",50,836450,34
"2423","대립군","2017-07-04","3",50,836500,35
"2424","대립군","2017-07-05","5",409,836909,36
"2425","대립군","2017-07-06","2",30,836939,37
"2426","대립군","2017-07-07","3",281,837220,38
"2427","대립군","2017-07-08","2",45,837265,39
"2428","대립군","2017-07-09","2",45,837310,40
"2429","대립군","2017-07-10","2",30,837340,41
"2430","대립군","2017-07-11","2",30,837370,42
"2431","대립군","2017-07-12","2",30,837400,43
"2432","대립군","2017-07-13","1",10,837410,44
"2433","대립군","2017-07-14","1",10,837420,45
"2434","대립군","2017-07-15","1",25,837445,46
"2435","대립군","2017-07-16","1",25,837470,47
"2436","대립군","2017-07-17","1",10,837480,48
"2437","대립군","2017-07-18","1",10,837490,49
"2438","대립군","2017-07-19","1",10,837500,50
"2439","대립군","2018-11-29","1",0,837500,51
"2440","뽀로로 극장판 공룡섬 대모험","2017-11-01","1",326,326,0
"2441","뽀로로 극장판 공룡섬 대모험","2017-11-06","1",214,540,0
"2442","뽀로로 극장판 공룡섬 대모험","2017-11-15","1",170,710,0
"2443","뽀로로 극장판 공룡섬 대모험","2017-11-24","1",332,1042,0
"2444","뽀로로 극장판 공룡섬 대모험","2017-11-30","9",1900,2942,0
"2445","뽀로로 극장판 공룡섬 대모험","2017-12-02","6",993,3935,0
"2446","뽀로로 극장판 공룡섬 대모험","2017-12-04","3",516,4451,0
"2447","뽀로로 극장판 공룡섬 대모험","2017-12-07","468",20700,25151,1
"2448","뽀로로 극장판 공룡섬 대모험","2017-12-08","513",19255,44406,2
"2449","뽀로로 극장판 공룡섬 대모험","2017-12-09","739",137492,181898,3
"2450","뽀로로 극장판 공룡섬 대모험","2017-12-10","803",142336,324234,4
"2451","뽀로로 극장판 공룡섬 대모험","2017-12-11","496",14062,338296,5
"2452","뽀로로 극장판 공룡섬 대모험","2017-12-12","500",14869,353165,6
"2453","뽀로로 극장판 공룡섬 대모험","2017-12-13","513",14287,367452,7
"2454","뽀로로 극장판 공룡섬 대모험","2017-12-14","444",12644,380096,8
"2455","뽀로로 극장판 공룡섬 대모험","2017-12-15","466",13997,394093,9
"2456","뽀로로 극장판 공룡섬 대모험","2017-12-16","661",82557,476650,10
"2457","뽀로로 극장판 공룡섬 대모험","2017-12-17","655",81501,558151,11
"2458","뽀로로 극장판 공룡섬 대모험","2017-12-18","420",7393,565544,12
"2459","뽀로로 극장판 공룡섬 대모험","2017-12-19","466",10070,575614,13
"2460","뽀로로 극장판 공룡섬 대모험","2017-12-20","316",7618,583232,14
"2461","뽀로로 극장판 공룡섬 대모험","2017-12-21","181",5002,588234,15
"2462","뽀로로 극장판 공룡섬 대모험","2017-12-22","190",5215,593449,16
"2463","뽀로로 극장판 공룡섬 대모험","2017-12-23","338",27816,621265,17
"2464","뽀로로 극장판 공룡섬 대모험","2017-12-24","379",38929,660194,18
"2465","뽀로로 극장판 공룡섬 대모험","2017-12-25","389",47552,707746,19
"2466","뽀로로 극장판 공룡섬 대모험","2017-12-26","234",11994,719740,20
"2467","뽀로로 극장판 공룡섬 대모험","2017-12-27","142",8384,728124,21
"2468","뽀로로 극장판 공룡섬 대모험","2017-12-28","119",8886,737010,22
"2469","뽀로로 극장판 공룡섬 대모험","2017-12-29","145",9891,746901,23
"2470","뽀로로 극장판 공룡섬 대모험","2017-12-30","197",13089,759990,24
"2471","뽀로로 극장판 공룡섬 대모험","2017-12-31","208",13753,773743,25
"2472","뽀로로 극장판 공룡섬 대모험","2018-01-01","195",13750,787493,26
"2473","뽀로로 극장판 공룡섬 대모험","2018-01-02","156",7200,794693,27
"2474","뽀로로 극장판 공룡섬 대모험","2018-01-03","87",4024,798717,28
"2475","뽀로로 극장판 공룡섬 대모험","2018-01-04","87",3558,802275,29
"2476","뽀로로 극장판 공룡섬 대모험","2018-01-05","93",3202,805477,30
"2477","뽀로로 극장판 공룡섬 대모험","2018-01-06","93",3725,809202,31
"2478","뽀로로 극장판 공룡섬 대모험","2018-01-07","89",3472,812674,32
"2479","뽀로로 극장판 공룡섬 대모험","2018-01-08","74",1115,813789,33
"2480","뽀로로 극장판 공룡섬 대모험","2018-01-09","81",1261,815050,34
"2481","뽀로로 극장판 공룡섬 대모험","2018-01-10","81",1483,816533,35
"2482","뽀로로 극장판 공룡섬 대모험","2018-01-11","25",805,817338,36
"2483","뽀로로 극장판 공룡섬 대모험","2018-01-12","36",1493,818831,37
"2484","뽀로로 극장판 공룡섬 대모험","2018-01-13","13",320,819151,38
"2485","뽀로로 극장판 공룡섬 대모험","2018-01-14","17",459,819610,39
"2486","뽀로로 극장판 공룡섬 대모험","2018-01-15","14",210,819820,40
"2487","뽀로로 극장판 공룡섬 대모험","2018-01-16","17",426,820246,41
"2488","뽀로로 극장판 공룡섬 대모험","2018-01-17","16",739,820985,42
"2489","뽀로로 극장판 공룡섬 대모험","2018-01-18","14",977,821962,43
"2490","뽀로로 극장판 공룡섬 대모험","2018-01-19","15",881,822843,44
"2491","뽀로로 극장판 공룡섬 대모험","2018-01-20","4",109,822952,45
"2492","뽀로로 극장판 공룡섬 대모험","2018-01-21","5",113,823065,46
"2493","뽀로로 극장판 공룡섬 대모험","2018-01-22","5",49,823114,47
"2494","뽀로로 극장판 공룡섬 대모험","2018-01-23","12",395,823509,48
"2495","뽀로로 극장판 공룡섬 대모험","2018-01-24","5",170,823679,49
"2496","뽀로로 극장판 공룡섬 대모험","2018-01-25","5",298,823977,50
"2497","뽀로로 극장판 공룡섬 대모험","2018-01-26","9",477,824454,51
"2498","뽀로로 극장판 공룡섬 대모험","2018-01-27","2",60,824514,52
"2499","뽀로로 극장판 공룡섬 대모험","2018-01-28","4",69,824583,53
"2500","뽀로로 극장판 공룡섬 대모험","2018-01-29","2",26,824609,54
"2501","뽀로로 극장판 공룡섬 대모험","2018-01-30","3",172,824781,55
"2502","뽀로로 극장판 공룡섬 대모험","2018-01-31","7",339,825120,56
"2503","뽀로로 극장판 공룡섬 대모험","2018-02-01","1",20,825140,57
"2504","뽀로로 극장판 공룡섬 대모험","2018-02-02","7",212,825352,58
"2505","뽀로로 극장판 공룡섬 대모험","2018-02-03","3",62,825414,59
"2506","뽀로로 극장판 공룡섬 대모험","2018-02-04","2",78,825492,60
"2507","뽀로로 극장판 공룡섬 대모험","2018-02-06","2",78,825570,61
"2508","뽀로로 극장판 공룡섬 대모험","2018-02-07","1",19,825589,62
"2509","뽀로로 극장판 공룡섬 대모험","2018-02-08","4",158,825747,63
"2510","뽀로로 극장판 공룡섬 대모험","2018-02-09","3",46,825793,64
"2511","뽀로로 극장판 공룡섬 대모험","2018-02-10","2",31,825824,65
"2512","뽀로로 극장판 공룡섬 대모험","2018-02-11","2",35,825859,66
"2513","뽀로로 극장판 공룡섬 대모험","2018-02-13","1",40,825899,67
"2514","뽀로로 극장판 공룡섬 대모험","2018-02-15","2",28,825927,68
"2515","뽀로로 극장판 공룡섬 대모험","2018-02-16","1",18,825945,69
"2516","뽀로로 극장판 공룡섬 대모험","2018-02-17","2",31,825976,70
"2517","뽀로로 극장판 공룡섬 대모험","2018-02-18","1",27,826003,71
"2518","뽀로로 극장판 공룡섬 대모험","2018-02-20","1",20,826023,72
"2519","뽀로로 극장판 공룡섬 대모험","2018-02-21","5",153,826176,73
"2520","뽀로로 극장판 공룡섬 대모험","2018-02-22","1",7,826183,74
"2521","뽀로로 극장판 공룡섬 대모험","2018-02-23","1",12,826195,75
"2522","뽀로로 극장판 공룡섬 대모험","2018-02-24","1",16,826211,76
"2523","뽀로로 극장판 공룡섬 대모험","2018-02-25","1",7,826218,77
"2524","뽀로로 극장판 공룡섬 대모험","2018-03-08","1",7,826225,78
"2525","뽀로로 극장판 공룡섬 대모험","2018-03-09","1",14,826239,79
"2526","뽀로로 극장판 공룡섬 대모험","2018-03-10","1",71,826310,80
"2527","뽀로로 극장판 공룡섬 대모험","2018-03-11","1",42,826352,81
"2528","뽀로로 극장판 공룡섬 대모험","2018-03-12","1",5,826357,82
"2529","뽀로로 극장판 공룡섬 대모험","2018-03-13","1",7,826364,83
"2530","뽀로로 극장판 공룡섬 대모험","2018-03-14","1",5,826369,84
"2531","뽀로로 극장판 공룡섬 대모험","2018-03-15","1",10,826379,85
"2532","뽀로로 극장판 공룡섬 대모험","2018-03-16","1",5,826384,86
"2533","뽀로로 극장판 공룡섬 대모험","2018-03-17","1",27,826411,87
"2534","뽀로로 극장판 공룡섬 대모험","2018-03-18","1",56,826467,88
"2535","뽀로로 극장판 공룡섬 대모험","2018-03-19","1",4,826471,89
"2536","뽀로로 극장판 공룡섬 대모험","2018-03-20","1",7,826478,90
"2537","뽀로로 극장판 공룡섬 대모험","2018-03-21","1",30,826508,91
"2538","뽀로로 극장판 공룡섬 대모험","2018-03-22","1",6,826514,92
"2539","뽀로로 극장판 공룡섬 대모험","2018-03-23","2",13,826527,93
"2540","뽀로로 극장판 공룡섬 대모험","2018-03-24","2",180,826707,94
"2541","뽀로로 극장판 공룡섬 대모험","2018-03-25","1",51,826758,95
"2542","뽀로로 극장판 공룡섬 대모험","2018-03-26","2",3,826761,96
"2543","뽀로로 극장판 공룡섬 대모험","2018-03-27","1",18,826779,97
"2544","뽀로로 극장판 공룡섬 대모험","2018-03-28","2",8,826787,98
"2545","뽀로로 극장판 공룡섬 대모험","2018-03-29","2",33,826820,99
"2546","뽀로로 극장판 공룡섬 대모험","2018-03-30","3",61,826881,100
"2547","뽀로로 극장판 공룡섬 대모험","2018-03-31","1",30,826911,101
"2548","뽀로로 극장판 공룡섬 대모험","2018-04-01","1",28,826939,102
"2549","뽀로로 극장판 공룡섬 대모험","2018-04-14","1",20,826959,103
"2550","뽀로로 극장판 공룡섬 대모험","2018-04-15","1",8,826967,104
"2551","뽀로로 극장판 공룡섬 대모험","2018-04-16","1",1,826968,105
"2552","뽀로로 극장판 공룡섬 대모험","2018-04-17","1",2,826970,106
"2553","뽀로로 극장판 공룡섬 대모험","2018-04-21","1",4,826974,107
"2554","뽀로로 극장판 공룡섬 대모험","2018-04-22","1",6,826980,108
"2555","뽀로로 극장판 공룡섬 대모험","2018-05-04","1",41,827021,109
"2556","뽀로로 극장판 공룡섬 대모험","2018-06-12","1",19,827040,110
"2557","뽀로로 극장판 공룡섬 대모험","2018-11-15","1",10,827050,111
"2558","뽀로로 극장판 공룡섬 대모험","2018-11-17","1",22,827072,112
"2559","뽀로로 극장판 공룡섬 대모험","2018-11-18","1",25,827097,113
"2560","뽀로로 극장판 공룡섬 대모험","2018-11-19","1",5,827102,114
"2561","뽀로로 극장판 공룡섬 대모험","2018-11-20","1",2,827104,115
"2562","뽀로로 극장판 공룡섬 대모험","2018-11-21","1",1,827105,116
"2563","뽀로로 극장판 공룡섬 대모험","2018-11-22","1",2,827107,117
"2564","뽀로로 극장판 공룡섬 대모험","2018-11-24","1",6,827113,118
"2565","뽀로로 극장판 공룡섬 대모험","2018-11-25","1",19,827132,119
"2566","뽀로로 극장판 공룡섬 대모험","2018-11-27","1",2,827134,120
"2567","뽀로로 극장판 공룡섬 대모험","2018-11-30","1",18,827152,121
"2568","뽀로로 극장판 공룡섬 대모험","2018-12-01","1",23,827175,122
"2569","뽀로로 극장판 공룡섬 대모험","2018-12-02","1",18,827193,123
"2570","뽀로로 극장판 공룡섬 대모험","2018-12-03","1",2,827195,124
"2571","뽀로로 극장판 공룡섬 대모험","2018-12-05","1",9,827204,125
"2572","뽀로로 극장판 공룡섬 대모험","2018-12-06","1",7,827211,126
"2573","뽀로로 극장판 공룡섬 대모험","2018-12-07","1",5,827216,127
"2574","뽀로로 극장판 공룡섬 대모험","2018-12-08","1",14,827230,128
"2575","뽀로로 극장판 공룡섬 대모험","2018-12-10","1",60,827290,129
"2576","뽀로로 극장판 공룡섬 대모험","2018-12-11","1",21,827311,130
"2577","뽀로로 극장판 공룡섬 대모험","2018-12-12","1",2,827313,131
"2578","뽀로로 극장판 공룡섬 대모험","2018-12-16","1",22,827335,132
"2579","아빠는 딸","2017-03-08","1",180,180,0
"2580","아빠는 딸","2017-03-30","2",332,512,0
"2581","아빠는 딸","2017-04-04","2",0,512,0
"2582","아빠는 딸","2017-04-05","6",1512,2024,0
"2583","아빠는 딸","2017-04-07","10",2169,4193,0
"2584","아빠는 딸","2017-04-10","5",1335,5528,0
"2585","아빠는 딸","2017-04-11","7",1900,7428,0
"2586","아빠는 딸","2017-04-12","460",33396,40824,1
"2587","아빠는 딸","2017-04-13","464",31745,72569,2
"2588","아빠는 딸","2017-04-14","478",44942,117511,3
"2589","아빠는 딸","2017-04-15","501",83474,200985,4
"2590","아빠는 딸","2017-04-16","520",77429,278414,5
"2591","아빠는 딸","2017-04-17","476",29353,307767,6
"2592","아빠는 딸","2017-04-18","500",25263,333030,7
"2593","아빠는 딸","2017-04-19","494",24595,357625,8
"2594","아빠는 딸","2017-04-20","474",23368,380993,9
"2595","아빠는 딸","2017-04-21","516",31140,412133,10
"2596","아빠는 딸","2017-04-22","581",67260,479393,11
"2597","아빠는 딸","2017-04-23","586",62244,541637,12
"2598","아빠는 딸","2017-04-24","510",18406,560043,13
"2599","아빠는 딸","2017-04-25","534",19326,579369,14
"2600","아빠는 딸","2017-04-26","360",10101,589470,15
"2601","아빠는 딸","2017-04-27","346",6448,595918,16
"2602","아빠는 딸","2017-04-28","331",9920,605838,17
"2603","아빠는 딸","2017-04-29","301",12238,618076,18
"2604","아빠는 딸","2017-04-30","301",11576,629652,19
"2605","아빠는 딸","2017-05-01","300",7570,637222,20
"2606","아빠는 딸","2017-05-02","278",5963,643185,21
"2607","아빠는 딸","2017-05-03","19",690,643875,22
"2608","아빠는 딸","2017-05-04","22",577,644452,23
"2609","아빠는 딸","2017-05-05","17",490,644942,24
"2610","아빠는 딸","2017-05-06","17",362,645304,25
"2611","아빠는 딸","2017-05-07","17",249,645553,26
"2612","아빠는 딸","2017-05-08","20",508,646061,27
"2613","아빠는 딸","2017-05-09","3",34,646095,28
"2614","아빠는 딸","2017-05-10","1",2,646097,29
"2615","아빠는 딸","2017-05-12","3",111,646208,30
"2616","아빠는 딸","2017-05-13","1",3,646211,31
"2617","아빠는 딸","2017-05-14","1",4,646215,32
"2618","아빠는 딸","2017-05-15","1",2,646217,33
"2619","아빠는 딸","2017-06-14","1",28,646245,34
"2620","아빠는 딸","2017-06-15","8",340,646585,35
"2621","아빠는 딸","2017-06-19","1",8,646593,36
"2622","아빠는 딸","2017-06-21","1",97,646690,37
"2623","아빠는 딸","2017-06-26","1",17,646707,38
"2624","아빠는 딸","2017-07-03","1",72,646779,39
"2625","아빠는 딸","2017-07-24","1",145,646924,40
"2626","아빠는 딸","2017-10-15","2",381,647305,41
"2627","침묵","2017-10-24","5",2254,2254,0
"2628","침묵","2017-10-30","18",1737,3991,0
"2629","침묵","2017-10-31","13",2209,6200,0
"2630","침묵","2017-11-01","3",132,6332,0
"2631","침묵","2017-11-02","612",57510,63842,1
"2632","침묵","2017-11-03","630",60910,124752,2
"2633","침묵","2017-11-04","634",93390,218142,3
"2634","침묵","2017-11-05","629",84505,302647,4
"2635","침묵","2017-11-06","589",33631,336278,5
"2636","침묵","2017-11-07","601",31370,367648,6
"2637","침묵","2017-11-08","543",29056,396704,7
"2638","침묵","2017-11-09","410",11184,407888,8
"2639","침묵","2017-11-10","427",13489,421377,9
"2640","침묵","2017-11-11","414",25071,446448,10
"2641","침묵","2017-11-12","412",22486,468934,11
"2642","침묵","2017-11-13","391",8025,476959,12
"2643","침묵","2017-11-14","384",7026,483985,13
"2644","침묵","2017-11-15","184",2628,486613,14
"2645","침묵","2017-11-16","67",1512,488125,15
"2646","침묵","2017-11-17","68",965,489090,16
"2647","침묵","2017-11-18","61",1134,490224,17
"2648","침묵","2017-11-19","56",1112,491336,18
"2649","침묵","2017-11-20","62",759,492095,19
"2650","침묵","2017-11-21","64",741,492836,20
"2651","침묵","2017-11-22","14",251,493087,21
"2652","침묵","2017-11-23","10",104,493191,22
"2653","침묵","2017-11-24","8",181,493372,23
"2654","침묵","2017-11-25","6",189,493561,24
"2655","침묵","2017-11-26","3",112,493673,25
"2656","침묵","2017-11-27","6",80,493753,26
"2657","침묵","2017-11-28","9",120,493873,27
"2658","침묵","2017-11-29","4",168,494041,28
"2659","침묵","2017-11-30","1",16,494057,29
"2660","침묵","2017-12-01","1",8,494065,30
"2661","침묵","2017-12-02","1",14,494079,31
"2662","침묵","2017-12-03","1",5,494084,32
"2663","침묵","2017-12-04","1",6,494090,33
"2664","침묵","2017-12-05","1",4,494094,34
"2665","침묵","2017-12-06","1",3,494097,35
"2666","리얼","2017-06-21","3",426,426,0
"2667","리얼","2017-06-26","4",2064,2490,0
"2668","리얼","2017-06-27","7",1401,3891,0
"2669","리얼","2017-06-28","970",146965,150856,1
"2670","리얼","2017-06-29","918",57733,208589,2
"2671","리얼","2017-06-30","859",46591,255180,3
"2672","리얼","2017-07-01","735",67807,322987,4
"2673","리얼","2017-07-02","679",50734,373721,5
"2674","리얼","2017-07-03","634",21996,395717,6
"2675","리얼","2017-07-04","635",20030,415747,7
"2676","리얼","2017-07-05","353",10820,426567,8
"2677","리얼","2017-07-06","313",5955,432522,9
"2678","리얼","2017-07-07","313",5625,438147,10
"2679","리얼","2017-07-08","240",5774,443921,11
"2680","리얼","2017-07-09","228",4509,448430,12
"2681","리얼","2017-07-10","271",2562,450992,13
"2682","리얼","2017-07-11","260",2693,453685,14
"2683","리얼","2017-07-12","182",6373,460058,15
"2684","리얼","2017-07-13","23",437,460495,16
"2685","리얼","2017-07-14","23",656,461151,17
"2686","리얼","2017-07-15","15",372,461523,18
"2687","리얼","2017-07-16","18",438,461961,19
"2688","리얼","2017-07-17","33",2879,464840,20
"2689","리얼","2017-07-18","58",1578,466418,21
"2690","리얼","2017-07-19","21",635,467053,22
"2691","리얼","2017-07-20","26",858,467911,23
"2692","리얼","2017-07-21","5",141,468052,24
"2693","리얼","2017-07-22","15",374,468426,25
"2694","리얼","2017-07-23","6",209,468635,26
"2695","리얼","2017-07-24","7",276,468911,27
"2696","리얼","2017-07-25","6",289,469200,28
"2697","리얼","2017-07-26","5",150,469350,29
"2698","리얼","2017-07-27","5",150,469500,30
"2699","리얼","2017-07-28","5",150,469650,31
"2700","리얼","2017-07-29","5",150,469800,32
"2701","리얼","2017-07-30","5",150,469950,33
"2702","리얼","2017-07-31","5",125,470075,34
"2703","리얼","2017-08-01","1",30,470105,35
"2704","리얼","2018-07-07","1",30,470135,36
"2705","리얼","2018-08-31","1",30,470165,37
"2706","반드시 잡는다","2017-10-27","1",401,401,0
"2707","반드시 잡는다","2017-11-21","3",707,1108,0
"2708","반드시 잡는다","2017-11-23","8",2668,3776,0
"2709","반드시 잡는다","2017-11-24","14",2422,6198,0
"2710","반드시 잡는다","2017-11-27","2",506,6704,0
"2711","반드시 잡는다","2017-11-28","3",563,7267,0
"2712","반드시 잡는다","2017-11-29","557",59907,67174,1
"2713","반드시 잡는다","2017-11-30","554",37426,104600,2
"2714","반드시 잡는다","2017-12-01","565",38542,143142,3
"2715","반드시 잡는다","2017-12-02","518",66161,209303,4
"2716","반드시 잡는다","2017-12-03","537",67170,276473,5
"2717","반드시 잡는다","2017-12-04","512",25360,301833,6
"2718","반드시 잡는다","2017-12-05","535",26474,328307,7
"2719","반드시 잡는다","2017-12-06","551",22731,351038,8
"2720","반드시 잡는다","2017-12-07","405",13530,364568,9
"2721","반드시 잡는다","2017-12-08","397",14679,379247,10
"2722","반드시 잡는다","2017-12-09","387",17306,396553,11
"2723","반드시 잡는다","2017-12-10","392",16981,413534,12
"2724","반드시 잡는다","2017-12-11","386",9313,422847,13
"2725","반드시 잡는다","2017-12-12","383",8809,431656,14
"2726","반드시 잡는다","2017-12-13","393",9949,441605,15
"2727","반드시 잡는다","2017-12-14","46",1802,443407,16
"2728","반드시 잡는다","2017-12-15","47",1389,444796,17
"2729","반드시 잡는다","2017-12-16","30",392,445188,18
"2730","반드시 잡는다","2017-12-17","32",421,445609,19
"2731","반드시 잡는다","2017-12-18","32",168,445777,20
"2732","반드시 잡는다","2017-12-19","36",470,446247,21
"2733","반드시 잡는다","2017-12-20","5",87,446334,22
"2734","반드시 잡는다","2017-12-21","4",186,446520,23
"2735","반드시 잡는다","2017-12-22","2",197,446717,24
"2736","반드시 잡는다","2017-12-23","3",47,446764,25
"2737","반드시 잡는다","2017-12-26","2",12,446776,26
"2738","반드시 잡는다","2017-12-27","1",4,446780,27
"2739","원라인","2017-02-06","1",282,282,0
"2740","원라인","2017-02-27","1",670,952,0
"2741","원라인","2017-03-20","4",973,1925,0
"2742","원라인","2017-03-23","9",2923,4848,0
"2743","원라인","2017-03-24","23",4477,9325,0
"2744","원라인","2017-03-27","2",563,9888,0
"2745","원라인","2017-03-29","613",53333,63221,1
"2746","원라인","2017-03-30","594",30533,93754,2
"2747","원라인","2017-03-31","589",41698,135452,3
"2748","원라인","2017-04-01","584",86002,221454,4
"2749","원라인","2017-04-02","558",69577,291031,5
"2750","원라인","2017-04-03","554",24601,315632,6
"2751","원라인","2017-04-04","551",21754,337386,7
"2752","원라인","2017-04-05","398",14339,351725,8
"2753","원라인","2017-04-06","347",10056,361781,9
"2754","원라인","2017-04-07","350",11864,373645,10
"2755","원라인","2017-04-08","349",21191,394836,11
"2756","원라인","2017-04-09","340",17863,412699,12
"2757","원라인","2017-04-10","332",6180,418879,13
"2758","원라인","2017-04-11","346",6140,425019,14
"2759","원라인","2017-04-12","100",1007,426026,15
"2760","원라인","2017-04-13","88",1431,427457,16
"2761","원라인","2017-04-14","80",731,428188,17
"2762","원라인","2017-04-15","69",1019,429207,18
"2763","원라인","2017-04-16","62",909,430116,19
"2764","원라인","2017-04-17","69",465,430581,20
"2765","원라인","2017-04-18","84",1488,432069,21
"2766","원라인","2017-04-19","69",1049,433118,22
"2767","원라인","2017-04-20","20",587,433705,23
"2768","원라인","2017-04-21","3",94,433799,24
"2769","원라인","2017-04-22","13",247,434046,25
"2770","원라인","2017-04-23","4",49,434095,26
"2771","원라인","2017-04-24","5",119,434214,27
"2772","원라인","2017-04-25","3",93,434307,28
"2773","원라인","2017-04-26","4",31,434338,29
"2774","원라인","2017-04-27","4",30,434368,30
"2775","원라인","2017-04-28","4",28,434396,31
"2776","원라인","2017-04-29","5",33,434429,32
"2777","원라인","2017-04-30","4",37,434466,33
"2778","원라인","2017-05-01","6",31,434497,34
"2779","원라인","2017-05-02","5",36,434533,35
"2780","원라인","2017-05-03","5",37,434570,36
"2781","원라인","2017-05-04","5",39,434609,37
"2782","원라인","2017-05-05","5",30,434639,38
"2783","원라인","2017-05-06","4",30,434669,39
"2784","원라인","2017-05-07","4",38,434707,40
"2785","원라인","2017-05-08","4",35,434742,41
"2786","원라인","2017-05-09","4",35,434777,42
"2787","원라인","2017-07-22","1",92,434869,43
"2788","원라인","2017-09-01","1",0,434869,44
"2789","원라인","2017-09-02","1",92,434961,45
"2790","원라인","2017-11-11","1",87,435048,46
"2791","원라인","2017-11-21","1",0,435048,47
"2792","원라인","2017-12-21","1",0,435048,48
"2793","원라인","2018-06-02","1",42,435090,49
"2794","원라인","2018-08-10","1",5,435095,50
"2795","원라인","2018-08-12","1",5,435100,51
"2796","원라인","2018-11-10","1",42,435142,52
"2797","터닝메카드W: 블랙미러의 부활","2017-01-10","1",75,75,0
"2798","터닝메카드W: 블랙미러의 부활","2017-01-11","5",418,493,0
"2799","터닝메카드W: 블랙미러의 부활","2017-01-13","1",50,543,0
"2800","터닝메카드W: 블랙미러의 부활","2017-01-16","2",981,1524,0
"2801","터닝메카드W: 블랙미러의 부활","2017-01-17","1",200,1724,0
"2802","터닝메카드W: 블랙미러의 부활","2017-01-18","500",50159,51883,1
"2803","터닝메카드W: 블랙미러의 부활","2017-01-19","483",27622,79505,2
"2804","터닝메카드W: 블랙미러의 부활","2017-01-20","490",18988,98493,3
"2805","터닝메카드W: 블랙미러의 부활","2017-01-21","570",97501,195994,4
"2806","터닝메카드W: 블랙미러의 부활","2017-01-22","567",80707,276701,5
"2807","터닝메카드W: 블랙미러의 부활","2017-01-23","428",9910,286611,6
"2808","터닝메카드W: 블랙미러의 부활","2017-01-24","438",10875,297486,7
"2809","터닝메카드W: 블랙미러의 부활","2017-01-25","323",6112,303598,8
"2810","터닝메카드W: 블랙미러의 부활","2017-01-26","326",6920,310518,9
"2811","터닝메카드W: 블랙미러의 부활","2017-01-27","412",18976,329494,10
"2812","터닝메카드W: 블랙미러의 부활","2017-01-28","362",10653,340147,11
"2813","터닝메카드W: 블랙미러의 부활","2017-01-29","401",22616,362763,12
"2814","터닝메카드W: 블랙미러의 부활","2017-01-30","392",32217,394980,13
"2815","터닝메카드W: 블랙미러의 부활","2017-01-31","315",6020,401000,14
"2816","터닝메카드W: 블랙미러의 부활","2017-02-01","195",1912,402912,15
"2817","터닝메카드W: 블랙미러의 부활","2017-02-02","134",1212,404124,16
"2818","터닝메카드W: 블랙미러의 부활","2017-02-03","142",1575,405699,17
"2819","터닝메카드W: 블랙미러의 부활","2017-02-04","188",8184,413883,18
"2820","터닝메카드W: 블랙미러의 부활","2017-02-05","196",8972,422855,19
"2821","터닝메카드W: 블랙미러의 부활","2017-02-06","99",598,423453,20
"2822","터닝메카드W: 블랙미러의 부활","2017-02-07","116",962,424415,21
"2823","터닝메카드W: 블랙미러의 부활","2017-02-08","74",693,425108,22
"2824","터닝메카드W: 블랙미러의 부활","2017-02-09","16",150,425258,23
"2825","터닝메카드W: 블랙미러의 부활","2017-02-10","16",177,425435,24
"2826","터닝메카드W: 블랙미러의 부활","2017-02-11","40",1264,426699,25
"2827","터닝메카드W: 블랙미러의 부활","2017-02-12","39",1481,428180,26
"2828","터닝메카드W: 블랙미러의 부활","2017-02-13","16",129,428309,27
"2829","터닝메카드W: 블랙미러의 부활","2017-02-14","18",260,428569,28
"2830","터닝메카드W: 블랙미러의 부활","2017-02-15","9",94,428663,29
"2831","터닝메카드W: 블랙미러의 부활","2017-02-16","1",22,428685,30
"2832","터닝메카드W: 블랙미러의 부활","2017-02-17","4",63,428748,31
"2833","터닝메카드W: 블랙미러의 부활","2017-02-18","1",6,428754,32
"2834","터닝메카드W: 블랙미러의 부활","2017-02-19","4",29,428783,33
"2835","터닝메카드W: 블랙미러의 부활","2017-02-20","1",6,428789,34
"2836","터닝메카드W: 블랙미러의 부활","2017-02-21","2",4,428793,35
"2837","터닝메카드W: 블랙미러의 부활","2017-02-22","1",9,428802,36
"2838","터닝메카드W: 블랙미러의 부활","2017-02-23","1",1,428803,37
"2839","터닝메카드W: 블랙미러의 부활","2017-02-24","1",7,428810,38
"2840","터닝메카드W: 블랙미러의 부활","2017-02-25","1",22,428832,39
"2841","터닝메카드W: 블랙미러의 부활","2017-02-26","1",10,428842,40
"2842","터닝메카드W: 블랙미러의 부활","2017-02-27","1",2,428844,41
"2843","터닝메카드W: 블랙미러의 부활","2017-02-28","2",7,428851,42
"2844","터닝메카드W: 블랙미러의 부활","2017-03-01","1",14,428865,43
"2845","터닝메카드W: 블랙미러의 부활","2017-03-02","1",2,428867,44
"2846","터닝메카드W: 블랙미러의 부활","2017-03-03","1",2,428869,45
"2847","터닝메카드W: 블랙미러의 부활","2017-03-04","1",2,428871,46
"2848","터닝메카드W: 블랙미러의 부활","2017-03-05","1",6,428877,47
"2849","터닝메카드W: 블랙미러의 부활","2017-03-06","1",2,428879,48
"2850","터닝메카드W: 블랙미러의 부활","2017-03-07","1",6,428885,49
"2851","터닝메카드W: 블랙미러의 부활","2017-03-08","1",8,428893,50
"2852","터닝메카드W: 블랙미러의 부활","2017-03-09","1",1,428894,51
"2853","터닝메카드W: 블랙미러의 부활","2017-03-10","1",5,428899,52
"2854","터닝메카드W: 블랙미러의 부활","2017-03-11","1",37,428936,53
"2855","터닝메카드W: 블랙미러의 부활","2017-03-12","2",38,428974,54
"2856","터닝메카드W: 블랙미러의 부활","2017-03-14","1",2,428976,55
"2857","터닝메카드W: 블랙미러의 부활","2017-03-15","1",1,428977,56
"2858","터닝메카드W: 블랙미러의 부활","2017-03-16","2",8,428985,57
"2859","터닝메카드W: 블랙미러의 부활","2017-03-17","1",5,428990,58
"2860","터닝메카드W: 블랙미러의 부활","2017-03-18","2",43,429033,59
"2861","터닝메카드W: 블랙미러의 부활","2017-03-19","2",27,429060,60
"2862","터닝메카드W: 블랙미러의 부활","2017-03-21","1",1,429061,61
"2863","터닝메카드W: 블랙미러의 부활","2017-03-22","1",1,429062,62
"2864","터닝메카드W: 블랙미러의 부활","2017-03-23","1",2,429064,63
"2865","터닝메카드W: 블랙미러의 부활","2017-03-24","1",4,429068,64
"2866","터닝메카드W: 블랙미러의 부활","2017-03-25","1",34,429102,65
"2867","터닝메카드W: 블랙미러의 부활","2017-03-26","1",14,429116,66
"2868","터닝메카드W: 블랙미러의 부활","2017-04-03","1",2,429118,67
"2869","터닝메카드W: 블랙미러의 부활","2017-04-04","1",3,429121,68
"2870","터닝메카드W: 블랙미러의 부활","2017-04-05","2",12,429133,69
"2871","터닝메카드W: 블랙미러의 부활","2017-04-06","2",14,429147,70
"2872","터닝메카드W: 블랙미러의 부활","2017-04-07","1",14,429161,71
"2873","터닝메카드W: 블랙미러의 부활","2017-04-08","2",38,429199,72
"2874","터닝메카드W: 블랙미러의 부활","2017-04-09","2",35,429234,73
"2875","터닝메카드W: 블랙미러의 부활","2017-04-10","2",6,429240,74
"2876","터닝메카드W: 블랙미러의 부활","2017-04-11","2",7,429247,75
"2877","터닝메카드W: 블랙미러의 부활","2017-04-12","2",10,429257,76
"2878","터닝메카드W: 블랙미러의 부활","2017-04-13","2",11,429268,77
"2879","터닝메카드W: 블랙미러의 부활","2017-04-14","2",20,429288,78
"2880","터닝메카드W: 블랙미러의 부활","2017-04-15","2",46,429334,79
"2881","터닝메카드W: 블랙미러의 부활","2017-04-16","1",9,429343,80
"2882","터닝메카드W: 블랙미러의 부활","2017-04-17","2",23,429366,81
"2883","터닝메카드W: 블랙미러의 부활","2017-04-18","2",13,429379,82
"2884","터닝메카드W: 블랙미러의 부활","2017-04-19","2",15,429394,83
"2885","터닝메카드W: 블랙미러의 부활","2017-04-20","1",6,429400,84
"2886","터닝메카드W: 블랙미러의 부활","2017-04-21","3",15,429415,85
"2887","터닝메카드W: 블랙미러의 부활","2017-04-22","3",61,429476,86
"2888","터닝메카드W: 블랙미러의 부활","2017-04-23","3",60,429536,87
"2889","터닝메카드W: 블랙미러의 부활","2017-04-24","3",8,429544,88
"2890","터닝메카드W: 블랙미러의 부활","2017-04-25","1",2,429546,89
"2891","터닝메카드W: 블랙미러의 부활","2017-04-26","2",16,429562,90
"2892","터닝메카드W: 블랙미러의 부활","2017-04-27","1",7,429569,91
"2893","터닝메카드W: 블랙미러의 부활","2017-09-09","2",13,429582,92
"2894","터닝메카드W: 블랙미러의 부활","2017-09-10","2",15,429597,93
"2895","터닝메카드W: 블랙미러의 부활","2017-09-11","2",5,429602,94
"2896","터닝메카드W: 블랙미러의 부활","2017-09-12","2",5,429607,95
"2897","터닝메카드W: 블랙미러의 부활","2017-09-13","2",6,429613,96
"2898","터닝메카드W: 블랙미러의 부활","2017-09-14","1",1,429614,97
"2899","터닝메카드W: 블랙미러의 부활","2017-09-15","1",4,429618,98
"2900","터닝메카드W: 블랙미러의 부활","2017-09-16","2",17,429635,99
"2901","터닝메카드W: 블랙미러의 부활","2017-09-17","3",36,429671,100
"2902","터닝메카드W: 블랙미러의 부활","2017-09-18","2",9,429680,101
"2903","터닝메카드W: 블랙미러의 부활","2017-09-19","2",3,429683,102
"2904","터닝메카드W: 블랙미러의 부활","2017-09-20","1",1,429684,103
"2905","터닝메카드W: 블랙미러의 부활","2017-09-21","1",4,429688,104
"2906","터닝메카드W: 블랙미러의 부활","2017-09-22","1",7,429695,105
"2907","터닝메카드W: 블랙미러의 부활","2017-09-25","1",4,429699,106
"2908","터닝메카드W: 블랙미러의 부활","2017-09-26","2",4,429703,107
"2909","터닝메카드W: 블랙미러의 부활","2017-09-27","1",8,429711,108
"2910","터닝메카드W: 블랙미러의 부활","2017-09-28","1",3,429714,109
"2911","터닝메카드W: 블랙미러의 부활","2017-09-29","1",2,429716,110
"2912","터닝메카드W: 블랙미러의 부활","2017-10-10","1",3,429719,111
"2913","터닝메카드W: 블랙미러의 부활","2017-10-11","1",3,429722,112
"2914","터닝메카드W: 블랙미러의 부활","2017-10-12","1",4,429726,113
"2915","터닝메카드W: 블랙미러의 부활","2017-10-17","1",2,429728,114
"2916","터닝메카드W: 블랙미러의 부활","2017-10-19","1",4,429732,115
"2917","터닝메카드W: 블랙미러의 부활","2017-10-20","1",2,429734,116
"2918","터닝메카드W: 블랙미러의 부활","2017-10-23","1",4,429738,117
"2919","터닝메카드W: 블랙미러의 부활","2017-10-27","1",1,429739,118
"2920","터닝메카드W: 블랙미러의 부활","2017-10-31","1",4,429743,119
"2921","터닝메카드W: 블랙미러의 부활","2017-11-03","1",8,429751,120
"2922","터닝메카드W: 블랙미러의 부활","2017-11-06","1",2,429753,121
"2923","터닝메카드W: 블랙미러의 부활","2017-11-07","1",2,429755,122
"2924","터닝메카드W: 블랙미러의 부활","2017-11-08","3",9,429764,123
"2925","터닝메카드W: 블랙미러의 부활","2017-11-09","3",7,429771,124
"2926","터닝메카드W: 블랙미러의 부활","2017-11-10","1",5,429776,125
"2927","터닝메카드W: 블랙미러의 부활","2017-11-11","1",34,429810,126
"2928","터닝메카드W: 블랙미러의 부활","2017-11-12","1",12,429822,127
"2929","터닝메카드W: 블랙미러의 부활","2017-11-13","1",2,429824,128
"2930","터닝메카드W: 블랙미러의 부활","2017-11-14","1",7,429831,129
"2931","터닝메카드W: 블랙미러의 부활","2017-11-16","2",14,429845,130
"2932","터닝메카드W: 블랙미러의 부활","2017-11-21","1",5,429850,131
"2933","터닝메카드W: 블랙미러의 부활","2017-11-22","2",20,429870,132
"2934","터닝메카드W: 블랙미러의 부활","2017-11-23","1",8,429878,133
"2935","터닝메카드W: 블랙미러의 부활","2017-11-24","1",2,429880,134
"2936","터닝메카드W: 블랙미러의 부활","2017-11-25","1",39,429919,135
"2937","터닝메카드W: 블랙미러의 부활","2017-11-28","1",2,429921,136
"2938","터닝메카드W: 블랙미러의 부활","2017-11-29","1",3,429924,137
"2939","터닝메카드W: 블랙미러의 부활","2017-11-30","1",2,429926,138
"2940","터닝메카드W: 블랙미러의 부활","2017-12-01","1",3,429929,139
"2941","터닝메카드W: 블랙미러의 부활","2017-12-04","1",2,429931,140
"2942","터닝메카드W: 블랙미러의 부활","2017-12-06","1",2,429933,141
"2943","터닝메카드W: 블랙미러의 부활","2018-11-14","1",4,429937,142
"2944","터닝메카드W: 블랙미러의 부활","2018-11-15","1",2,429939,143
"2945","터닝메카드W: 블랙미러의 부활","2018-11-17","1",20,429959,144
"2946","터닝메카드W: 블랙미러의 부활","2018-11-18","1",10,429969,145
"2947","터닝메카드W: 블랙미러의 부활","2018-11-22","1",2,429971,146
"2948","터닝메카드W: 블랙미러의 부활","2018-11-23","1",6,429977,147
"2949","터닝메카드W: 블랙미러의 부활","2018-11-24","1",5,429982,148
"2950","터닝메카드W: 블랙미러의 부활","2018-11-25","1",6,429988,149
"2951","터닝메카드W: 블랙미러의 부활","2018-11-27","1",2,429990,150
"2952","터닝메카드W: 블랙미러의 부활","2018-11-29","1",4,429994,151
"2953","터닝메카드W: 블랙미러의 부활","2018-12-02","1",2,429996,152
"2954","터닝메카드W: 블랙미러의 부활","2018-12-03","1",2,429998,153
"2955","터닝메카드W: 블랙미러의 부활","2018-12-08","1",11,430009,154
"2956","터닝메카드W: 블랙미러의 부활","2018-12-10","1",4,430013,155
"2957","넛잡 2","2017-09-18","1",94,94,0
"2958","넛잡 2","2017-09-21","1",100,194,0
"2959","넛잡 2","2017-09-22","2",200,394,0
"2960","넛잡 2","2017-09-24","1",67,461,0
"2961","넛잡 2","2017-09-25","1",100,561,0
"2962","넛잡 2","2017-09-26","15",2427,2988,0
"2963","넛잡 2","2017-09-27","3",300,3288,0
"2964","넛잡 2","2017-09-28","4",772,4060,0
"2965","넛잡 2","2017-10-03","454",27229,31289,1
"2966","넛잡 2","2017-10-04","449",22722,54011,2
"2967","넛잡 2","2017-10-05","453",41723,95734,3
"2968","넛잡 2","2017-10-06","476",58114,153848,4
"2969","넛잡 2","2017-10-07","485",49030,202878,5
"2970","넛잡 2","2017-10-08","506",47061,249939,6
"2971","넛잡 2","2017-10-09","526",62056,311995,7
"2972","넛잡 2","2017-10-10","236",1454,313449,8
"2973","넛잡 2","2017-10-11","223",2026,315475,9
"2974","넛잡 2","2017-10-12","144",1136,316611,10
"2975","넛잡 2","2017-10-13","150",1957,318568,11
"2976","넛잡 2","2017-10-14","386",17149,335717,12
"2977","넛잡 2","2017-10-15","388",20989,356706,13
"2978","넛잡 2","2017-10-16","135",879,357585,14
"2979","넛잡 2","2017-10-17","126",983,358568,15
"2980","넛잡 2","2017-10-18","131",1205,359773,16
"2981","넛잡 2","2017-10-19","60",1023,360796,17
"2982","넛잡 2","2017-10-20","60",1061,361857,18
"2983","넛잡 2","2017-10-21","260",10074,371931,19
"2984","넛잡 2","2017-10-22","265",12463,384394,20
"2985","넛잡 2","2017-10-23","52",660,385054,21
"2986","넛잡 2","2017-10-24","57",526,385580,22
"2987","넛잡 2","2017-10-25","47",944,386524,23
"2988","넛잡 2","2017-10-26","34",601,387125,24
"2989","넛잡 2","2017-10-27","35",817,387942,25
"2990","넛잡 2","2017-10-28","139",3755,391697,26
"2991","넛잡 2","2017-10-29","140",5261,396958,27
"2992","넛잡 2","2017-10-30","23",221,397179,28
"2993","넛잡 2","2017-10-31","22",264,397443,29
"2994","넛잡 2","2017-11-01","48",610,398053,30
"2995","넛잡 2","2017-11-02","22",253,398306,31
"2996","넛잡 2","2017-11-03","29",650,398956,32
"2997","넛잡 2","2017-11-04","81",2736,401692,33
"2998","넛잡 2","2017-11-05","79",3127,404819,34
"2999","넛잡 2","2017-11-06","27",305,405124,35
"3000","넛잡 2","2017-11-07","23",181,405305,36
"3001","넛잡 2","2017-11-08","21",299,405604,37
"3002","넛잡 2","2017-11-09","12",374,405978,38
"3003","넛잡 2","2017-11-10","10",414,406392,39
"3004","넛잡 2","2017-11-11","22",720,407112,40
"3005","넛잡 2","2017-11-12","22",821,407933,41
"3006","넛잡 2","2017-11-13","9",123,408056,42
"3007","넛잡 2","2017-11-14","10",170,408226,43
"3008","넛잡 2","2017-11-15","6",256,408482,44
"3009","넛잡 2","2017-11-16","3",100,408582,45
"3010","넛잡 2","2017-11-17","5",145,408727,46
"3011","넛잡 2","2017-11-18","11",401,409128,47
"3012","넛잡 2","2017-11-19","10",303,409431,48
"3013","넛잡 2","2017-11-20","3",19,409450,49
"3014","넛잡 2","2017-11-21","7",343,409793,50
"3015","넛잡 2","2017-11-22","3",168,409961,51
"3016","넛잡 2","2017-11-23","3",76,410037,52
"3017","넛잡 2","2017-11-24","4",145,410182,53
"3018","넛잡 2","2017-11-25","4",230,410412,54
"3019","넛잡 2","2017-11-26","5",157,410569,55
"3020","넛잡 2","2017-11-27","3",121,410690,56
"3021","넛잡 2","2017-11-28","2",41,410731,57
"3022","넛잡 2","2017-11-29","5",279,411010,58
"3023","넛잡 2","2017-11-30","2",78,411088,59
"3024","넛잡 2","2017-12-01","2",20,411108,60
"3025","넛잡 2","2017-12-02","2",107,411215,61
"3026","넛잡 2","2017-12-03","3",95,411310,62
"3027","넛잡 2","2017-12-04","2",24,411334,63
"3028","넛잡 2","2017-12-05","2",23,411357,64
"3029","넛잡 2","2017-12-06","2",15,411372,65
"3030","넛잡 2","2017-12-07","3",56,411428,66
"3031","넛잡 2","2017-12-08","2",94,411522,67
"3032","넛잡 2","2017-12-09","1",48,411570,68
"3033","넛잡 2","2017-12-11","1",30,411600,69
"3034","넛잡 2","2017-12-19","1",187,411787,70
"3035","보통사람","2017-03-14","1",214,214,0
"3036","보통사람","2017-03-15","7",2058,2272,0
"3037","보통사람","2017-03-20","12",2583,4855,0
"3038","보통사람","2017-03-21","2",452,5307,0
"3039","보통사람","2017-03-22","16",1089,6396,0
"3040","보통사람","2017-03-23","621",35583,41979,1
"3041","보통사람","2017-03-24","620",43460,85439,2
"3042","보통사람","2017-03-25","619",86992,172431,3
"3043","보통사람","2017-03-26","598",82796,255227,4
"3044","보통사람","2017-03-27","557",26302,281529,5
"3045","보통사람","2017-03-28","567",24083,305612,6
"3046","보통사람","2017-03-29","437",15679,321291,7
"3047","보통사람","2017-03-30","393",8311,329602,8
"3048","보통사람","2017-03-31","391",9908,339510,9
"3049","보통사람","2017-04-01","362",14710,354220,10
"3050","보통사람","2017-04-02","365",12477,366697,11
"3051","보통사람","2017-04-03","366",5215,371912,12
"3052","보통사람","2017-04-04","368",5329,377241,13
"3053","보통사람","2017-04-05","116",1782,379023,14
"3054","보통사람","2017-04-06","51",737,379760,15
"3055","보통사람","2017-04-07","50",895,380655,16
"3056","보통사람","2017-04-08","44",647,381302,17
"3057","보통사람","2017-04-09","43",900,382202,18
"3058","보통사람","2017-04-10","40",258,382460,19
"3059","보통사람","2017-04-11","44",470,382930,20
"3060","보통사람","2017-04-12","5",116,383046,21
"3061","보통사람","2017-04-13","1",2,383048,22
"3062","보통사람","2017-04-14","1",44,383092,23
"3063","보통사람","2017-04-15","2",6,383098,24
"3064","보통사람","2017-04-17","1",22,383120,25
"3065","보통사람","2017-04-18","2",115,383235,26
"3066","보통사람","2017-04-20","1",100,383335,27
"3067","보통사람","2017-04-24","1",1,383336,28
"3068","보통사람","2017-04-28","1",0,383336,29
"3069","보통사람","2017-05-11","1",0,383336,30
"3070","보통사람","2017-05-29","1",0,383336,31
"3071","대장 김창수","2017-09-27","3",902,902,0
"3072","대장 김창수","2017-10-11","1",243,1145,0
"3073","대장 김창수","2017-10-13","12",1803,2948,0
"3074","대장 김창수","2017-10-14","5",874,3822,0
"3075","대장 김창수","2017-10-15","1",222,4044,0
"3076","대장 김창수","2017-10-16","24",4455,8499,0
"3077","대장 김창수","2017-10-17","43",5114,13613,0
"3078","대장 김창수","2017-10-18","4",662,14275,0
"3079","대장 김창수","2017-10-19","734",44469,58744,1
"3080","대장 김창수","2017-10-20","748",51214,109958,2
"3081","대장 김창수","2017-10-21","667",78068,188026,3
"3082","대장 김창수","2017-10-22","638",72199,260225,4
"3083","대장 김창수","2017-10-23","610",23463,283688,5
"3084","대장 김창수","2017-10-24","635",24971,308659,6
"3085","대장 김창수","2017-10-25","423",14229,322888,7
"3086","대장 김창수","2017-10-26","353",7970,330858,8
"3087","대장 김창수","2017-10-27","358",9534,340392,9
"3088","대장 김창수","2017-10-28","315",8764,349156,10
"3089","대장 김창수","2017-10-29","318",9272,358428,11
"3090","대장 김창수","2017-10-30","338",5022,363450,12
"3091","대장 김창수","2017-10-31","335",5493,368943,13
"3092","대장 김창수","2017-11-01","316",5347,374290,14
"3093","대장 김창수","2017-11-02","46",1000,375290,15
"3094","대장 김창수","2017-11-03","51",1226,376516,16
"3095","대장 김창수","2017-11-04","25",336,376852,17
"3096","대장 김창수","2017-11-05","21",219,377071,18
"3097","대장 김창수","2017-11-06","34",474,377545,19
"3098","대장 김창수","2017-11-07","35",254,377799,20
"3099","대장 김창수","2017-11-08","25",647,378446,21
"3100","대장 김창수","2017-11-09","2",88,378534,22
"3101","대장 김창수","2017-11-10","5",322,378856,23
"3102","대장 김창수","2017-11-11","3",50,378906,24
"3103","대장 김창수","2017-11-12","3",92,378998,25
"3104","대장 김창수","2017-11-13","4",150,379148,26
"3105","대장 김창수","2017-11-14","2",78,379226,27
"3106","대장 김창수","2017-11-15","3",318,379544,28
"3107","대장 김창수","2017-11-17","3",133,379677,29
"3108","대장 김창수","2017-11-22","2",215,379892,30
"3109","대장 김창수","2017-11-23","1",301,380193,31
"3110","대장 김창수","2017-11-26","1",200,380393,32
"3111","대장 김창수","2017-11-29","2",186,380579,33
"3112","대장 김창수","2017-12-05","1",332,380911,34
"3113","대장 김창수","2017-12-06","1",128,381039,35
"3114","대장 김창수","2017-12-14","1",144,381183,36
"3115","대장 김창수","2017-12-21","2",300,381483,37
"3116","대장 김창수","2018-05-07","1",0,381483,38
"3117","석조저택 살인사건","2017-04-24","1",126,126,0
"3118","석조저택 살인사건","2017-04-26","2",771,897,0
"3119","석조저택 살인사건","2017-04-27","1",240,1137,0
"3120","석조저택 살인사건","2017-04-28","1",76,1213,0
"3121","석조저택 살인사건","2017-05-02","1",274,1487,0
"3122","석조저택 살인사건","2017-05-04","10",2233,3720,0
"3123","석조저택 살인사건","2017-05-08","9",1820,5540,0
"3124","석조저택 살인사건","2017-05-09","493",84068,89608,1
"3125","석조저택 살인사건","2017-05-10","460",25466,115074,2
"3126","석조저택 살인사건","2017-05-11","460",26492,141566,3
"3127","석조저택 살인사건","2017-05-12","472",35076,176642,4
"3128","석조저택 살인사건","2017-05-13","539",61720,238362,5
"3129","석조저택 살인사건","2017-05-14","538",53527,291889,6
"3130","석조저택 살인사건","2017-05-15","458",21599,313488,7
"3131","석조저택 살인사건","2017-05-16","457",15096,328584,8
"3132","석조저택 살인사건","2017-05-17","274",3994,332578,9
"3133","석조저택 살인사건","2017-05-18","252",2801,335379,10
"3134","석조저택 살인사건","2017-05-19","243",3075,338454,11
"3135","석조저택 살인사건","2017-05-20","217",4050,342504,12
"3136","석조저택 살인사건","2017-05-21","207",3540,346044,13
"3137","석조저택 살인사건","2017-05-22","217",1523,347567,14
"3138","석조저택 살인사건","2017-05-23","212",1505,349072,15
"3139","석조저택 살인사건","2017-05-24","43",591,349663,16
"3140","석조저택 살인사건","2017-05-25","23",214,349877,17
"3141","석조저택 살인사건","2017-05-26","16",276,350153,18
"3142","석조저택 살인사건","2017-05-27","8",63,350216,19
"3143","석조저택 살인사건","2017-05-28","8",93,350309,20
"3144","석조저택 살인사건","2017-05-29","16",149,350458,21
"3145","석조저택 살인사건","2017-05-30","14",141,350599,22
"3146","석조저택 살인사건","2017-05-31","6",26,350625,23
"3147","석조저택 살인사건","2017-06-01","5",5,350630,24
"3148","석조저택 살인사건","2017-06-02","6",89,350719,25
"3149","석조저택 살인사건","2017-06-03","5",6,350725,26
"3150","석조저택 살인사건","2017-06-04","5",6,350731,27
"3151","석조저택 살인사건","2017-06-05","6",51,350782,28
"3152","석조저택 살인사건","2017-06-06","5",5,350787,29
"3153","석조저택 살인사건","2017-06-07","5",5,350792,30
"3154","석조저택 살인사건","2017-06-09","7",450,351242,31
"3155","석조저택 살인사건","2017-06-10","1",100,351342,32
"3156","석조저택 살인사건","2017-07-05","4",600,351942,33
"3157","석조저택 살인사건","2017-07-06","5",900,352842,34
"3158","석조저택 살인사건","2017-07-11","1",201,353043,35
"3159","석조저택 살인사건","2017-08-17","1",192,353235,36
"3160","석조저택 살인사건","2017-09-11","1",282,353517,37
"3161","싱글라이더","2017-02-17","6",1875,1875,0
"3162","싱글라이더","2017-02-20","1",144,2019,0
"3163","싱글라이더","2017-02-21","25",3434,5453,0
"3164","싱글라이더","2017-02-22","554",65584,71037,1
"3165","싱글라이더","2017-02-23","531",35835,106872,2
"3166","싱글라이더","2017-02-24","546",39873,146745,3
"3167","싱글라이더","2017-02-25","570",60277,207022,4
"3168","싱글라이더","2017-02-26","576",55284,262306,5
"3169","싱글라이더","2017-02-27","507",25585,287891,6
"3170","싱글라이더","2017-02-28","541",24027,311918,7
"3171","싱글라이더","2017-03-01","212",8161,320079,8
"3172","싱글라이더","2017-03-02","225",3661,323740,9
"3173","싱글라이더","2017-03-03","227",4312,328052,10
"3174","싱글라이더","2017-03-04","211",5727,333779,11
"3175","싱글라이더","2017-03-05","208",4884,338663,12
"3176","싱글라이더","2017-03-06","217",2937,341600,13
"3177","싱글라이더","2017-03-07","227",2869,344469,14
"3178","싱글라이더","2017-03-08","88",1789,346258,15
"3179","싱글라이더","2017-03-09","37",682,346940,16
"3180","싱글라이더","2017-03-10","44",586,347526,17
"3181","싱글라이더","2017-03-11","46",1093,348619,18
"3182","싱글라이더","2017-03-12","41",861,349480,19
"3183","싱글라이더","2017-03-13","41",459,349939,20
"3184","싱글라이더","2017-03-14","36",367,350306,21
"3185","싱글라이더","2017-03-15","42",409,350715,22
"3186","싱글라이더","2017-03-16","2",17,350732,23
"3187","싱글라이더","2017-03-17","2",23,350755,24
"3188","싱글라이더","2017-03-18","1",17,350772,25
"3189","싱글라이더","2017-03-19","1",36,350808,26
"3190","싱글라이더","2017-03-20","2",43,350851,27
"3191","싱글라이더","2017-03-21","3",142,350993,28
"3192","싱글라이더","2017-03-22","2",23,351016,29
"3193","싱글라이더","2017-04-01","1",260,351276,30
"3194","싱글라이더","2017-11-19","1",0,351276,31
"3195","싱글라이더","2017-11-22","1",0,351276,32
"3196","7호실","2017-11-07","3",707,707,0
"3197","7호실","2017-11-11","1",149,856,0
"3198","7호실","2017-11-12","1",149,1005,0
"3199","7호실","2017-11-13","14",2519,3524,0
"3200","7호실","2017-11-14","29",2855,6379,0
"3201","7호실","2017-11-15","629",55985,62364,1
"3202","7호실","2017-11-16","599",52005,114369,2
"3203","7호실","2017-11-17","562",38467,152836,3
"3204","7호실","2017-11-18","556",65969,218805,4
"3205","7호실","2017-11-19","520",52302,271107,5
"3206","7호실","2017-11-20","477",17328,288435,6
"3207","7호실","2017-11-21","480",17260,305695,7
"3208","7호실","2017-11-22","338",4722,310417,8
"3209","7호실","2017-11-23","295",4871,315288,9
"3210","7호실","2017-11-24","294",5193,320481,10
"3211","7호실","2017-11-25","301",6414,326895,11
"3212","7호실","2017-11-26","291",7325,334220,12
"3213","7호실","2017-11-27","282",4196,338416,13
"3214","7호실","2017-11-28","280",3210,341626,14
"3215","7호실","2017-11-29","35",2013,343639,15
"3216","7호실","2017-11-30","21",351,343990,16
"3217","7호실","2017-12-01","15",300,344290,17
"3218","7호실","2017-12-02","21",670,344960,18
"3219","7호실","2017-12-03","15",379,345339,19
"3220","7호실","2017-12-04","18",195,345534,20
"3221","7호실","2017-12-05","14",541,346075,21
"3222","7호실","2017-12-06","17",311,346386,22
"3223","7호실","2017-12-07","5",150,346536,23
"3224","7호실","2017-12-08","5",150,346686,24
"3225","7호실","2017-12-09","5",150,346836,25
"3226","7호실","2017-12-10","5",150,346986,26
"3227","7호실","2017-12-11","6",350,347336,27
"3228","7호실","2017-12-12","5",150,347486,28
"3229","7호실","2017-12-13","5",150,347636,29
"3230","7호실","2017-12-14","5",100,347736,30
"3231","7호실","2017-12-18","1",54,347790,31
"3232","7호실","2018-10-20","1",11,347801,32
"3233","7호실","2018-10-23","2",6,347807,33
"3234","7호실","2018-10-24","2",6,347813,34
"3235","7호실","2018-10-25","1",5,347818,35
"3236","7호실","2018-10-26","1",5,347823,36
"3237","사랑하기 때문에","2016-10-20","1",238,238,0
"3238","사랑하기 때문에","2016-11-03","8",1511,1749,0
"3239","사랑하기 때문에","2016-11-15","4",862,2611,0
"3240","사랑하기 때문에","2016-11-16","1",175,2786,0
"3241","사랑하기 때문에","2016-11-17","2",430,3216,0
"3242","사랑하기 때문에","2016-12-19","9",2888,6104,0
"3243","사랑하기 때문에","2016-12-20","26",5556,11660,0
"3244","사랑하기 때문에","2016-12-21","1",0,11660,0
"3245","사랑하기 때문에","2016-12-22","1",0,11660,0
"3246","사랑하기 때문에","2016-12-23","5",738,12398,0
"3247","사랑하기 때문에","2016-12-26","11",3510,15908,0
"3248","사랑하기 때문에","2016-12-30","3",502,16410,0
"3249","사랑하기 때문에","2017-01-02","3",337,16747,0
"3250","사랑하기 때문에","2017-01-03","20",1930,18677,0
"3251","사랑하기 때문에","2017-01-04","496",44941,63618,1
"3252","사랑하기 때문에","2017-01-05","495",36355,99973,2
"3253","사랑하기 때문에","2017-01-06","507",34492,134465,3
"3254","사랑하기 때문에","2017-01-07","534",57846,192311,4
"3255","사랑하기 때문에","2017-01-08","542",53856,246167,5
"3256","사랑하기 때문에","2017-01-09","494",20277,266444,6
"3257","사랑하기 때문에","2017-01-10","498",20444,286888,7
"3258","사랑하기 때문에","2017-01-11","324",8989,295877,8
"3259","사랑하기 때문에","2017-01-12","250",6741,302618,9
"3260","사랑하기 때문에","2017-01-13","261",6433,309051,10
"3261","사랑하기 때문에","2017-01-14","248",10814,319865,11
"3262","사랑하기 때문에","2017-01-15","238",9683,329548,12
"3263","사랑하기 때문에","2017-01-16","235",4433,333981,13
"3264","사랑하기 때문에","2017-01-17","248",4607,338588,14
"3265","사랑하기 때문에","2017-01-18","10",209,338797,15
"3266","사랑하기 때문에","2017-01-19","10",169,338966,16
"3267","사랑하기 때문에","2017-01-20","10",416,339382,17
"3268","사랑하기 때문에","2017-01-21","3",14,339396,18
"3269","사랑하기 때문에","2017-01-22","6",86,339482,19
"3270","사랑하기 때문에","2017-01-23","5",67,339549,20
"3271","사랑하기 때문에","2017-01-24","4",30,339579,21
"3272","사랑하기 때문에","2017-01-25","18",290,339869,22
"3273","사랑하기 때문에","2017-01-26","20",307,340176,23
"3274","사랑하기 때문에","2017-01-27","5",45,340221,24
"3275","사랑하기 때문에","2017-01-28","5",69,340290,25
"3276","사랑하기 때문에","2017-01-29","5",83,340373,26
"3277","사랑하기 때문에","2017-01-30","4",36,340409,27
"3278","사랑하기 때문에","2017-01-31","6",84,340493,28
"3279","사랑하기 때문에","2017-02-01","4",35,340528,29
"3280","사랑하기 때문에","2017-02-02","6",134,340662,30
"3281","사랑하기 때문에","2017-02-03","4",30,340692,31
"3282","사랑하기 때문에","2017-02-04","4",37,340729,32
"3283","사랑하기 때문에","2017-02-05","4",37,340766,33
"3284","사랑하기 때문에","2017-02-06","4",32,340798,34
"3285","사랑하기 때문에","2017-02-07","4",32,340830,35
"3286","사랑하기 때문에","2017-05-31","1",0,340830,36
"3287","사랑하기 때문에","2017-06-07","1",106,340936,37
"3288","희생부활자","2017-10-10","9",2895,2895,0
"3289","희생부활자","2017-10-12","781",49100,51995,1
"3290","희생부활자","2017-10-13","770",53819,105814,2
"3291","희생부활자","2017-10-14","676",74141,179955,3
"3292","희생부활자","2017-10-15","638",61674,241629,4
"3293","희생부활자","2017-10-16","613",19362,260991,5
"3294","희생부활자","2017-10-17","630",21692,282683,6
"3295","희생부활자","2017-10-18","606",18054,300737,7
"3296","희생부활자","2017-10-19","349",3515,304252,8
"3297","희생부활자","2017-10-20","372",5624,309876,9
"3298","희생부활자","2017-10-21","307",4071,313947,10
"3299","희생부활자","2017-10-22","298",3798,317745,11
"3300","희생부활자","2017-10-23","272",1396,319141,12
"3301","희생부활자","2017-10-24","273",1944,321085,13
"3302","희생부활자","2017-10-25","30",275,321360,14
"3303","희생부활자","2017-10-26","18",353,321713,15
"3304","희생부활자","2017-10-27","19",265,321978,16
"3305","희생부활자","2017-10-28","13",90,322068,17
"3306","희생부활자","2017-10-29","16",139,322207,18
"3307","희생부활자","2017-10-30","10",155,322362,19
"3308","희생부활자","2017-10-31","12",81,322443,20
"3309","희생부활자","2017-11-01","11",133,322576,21
"3310","희생부활자","2017-11-02","6",152,322728,22
"3311","희생부활자","2017-11-03","5",150,322878,23
"3312","희생부활자","2017-11-04","5",150,323028,24
"3313","희생부활자","2017-11-05","5",150,323178,25
"3314","희생부활자","2017-11-06","5",150,323328,26
"3315","희생부활자","2017-11-07","5",150,323478,27
"3316","희생부활자","2017-11-08","5",150,323628,28
"3317","희생부활자","2017-12-20","1",0,323628,29
"3318","판도라","2016-11-15","1",1203,1203,0
"3319","판도라","2016-11-22","3",766,1969,0
"3320","판도라","2016-11-24","2",449,2418,0
"3321","판도라","2016-11-29","28",6024,8442,0
"3322","판도라","2016-11-30","15",4061,12503,0
"3323","판도라","2016-12-01","2",506,13009,0
"3324","판도라","2016-12-02","20",4392,17401,0
"3325","판도라","2016-12-04","1",134,17535,0
"3326","판도라","2016-12-06","4",837,18372,0
"3327","판도라","2016-12-07","1,029",154652,173024,1
"3328","판도라","2016-12-08","1,074",164931,337955,2
"3329","판도라","2016-12-09","1,086",210438,548393,3
"3330","판도라","2016-12-10","1,166",447707,996100,4
"3331","판도라","2016-12-11","1,160",463151,1459251,5
"3332","판도라","2016-12-12","1,085",160345,1619596,6
"3333","판도라","2016-12-13","1,117",165775,1785371,7
"3334","판도라","2016-12-14","1,080",162153,1947524,8
"3335","판도라","2016-12-15","1,083",159809,2107333,9
"3336","판도라","2016-12-16","1,115",210230,2317563,10
"3337","판도라","2016-12-17","1,184",401518,2719081,11
"3338","판도라","2016-12-18","1,153",394567,3113648,12
"3339","판도라","2016-12-19","1,096",133106,3246754,13
"3340","판도라","2016-12-20","1,134",135019,3381773,14
"3341","판도라","2016-12-21","705",62014,3443787,15
"3342","판도라","2016-12-22","704",62801,3506588,16
"3343","판도라","2016-12-23","701",78269,3584857,17
"3344","판도라","2016-12-24","654",177961,3762818,18
"3345","판도라","2016-12-25","655",173095,3935913,19
"3346","판도라","2016-12-26","663",55796,3991709,20
"3347","판도라","2016-12-27","668",55262,4046971,21
"3348","판도라","2016-12-28","551",59865,4106836,22
"3349","판도라","2016-12-29","519",46957,4153793,23
"3350","판도라","2016-12-30","535",65306,4219099,24
"3351","판도라","2016-12-31","566",94765,4313864,25
"3352","판도라","2017-01-01","576",87966,4401830,26
"3353","판도라","2017-01-02","540",38072,4439902,27
"3354","판도라","2017-01-03","538",27605,4467507,28
"3355","판도라","2017-01-04","335",12620,4480127,29
"3356","판도라","2017-01-05","322",11481,4491608,30
"3357","판도라","2017-01-06","310",11450,4503058,31
"3358","판도라","2017-01-07","304",21657,4524715,32
"3359","판도라","2017-01-08","297",20971,4545686,33
"3360","판도라","2017-01-09","295",6682,4552368,34
"3361","판도라","2017-01-10","294",6870,4559238,35
"3362","판도라","2017-01-11","107",3228,4562466,36
"3363","판도라","2017-01-12","62",1754,4564220,37
"3364","판도라","2017-01-13","58",2191,4566411,38
"3365","판도라","2017-01-14","63",3793,4570204,39
"3366","판도라","2017-01-15","66",3988,4574192,40
"3367","판도라","2017-01-16","59",1382,4575574,41
"3368","판도라","2017-01-17","59",1564,4577138,42
"3369","판도라","2017-01-18","14",504,4577642,43
"3370","판도라","2017-01-19","20",667,4578309,44
"3371","판도라","2017-01-20","19",424,4578733,45
"3372","판도라","2017-01-21","17",380,4579113,46
"3373","판도라","2017-01-22","18",471,4579584,47
"3374","판도라","2017-01-23","14",176,4579760,48
"3375","판도라","2017-01-24","16",1051,4580811,49
"3376","판도라","2017-01-25","7",912,4581723,50
"3377","판도라","2017-01-26","2",104,4581827,51
"3378","판도라","2017-01-27","3",279,4582106,52
"3379","판도라","2017-01-28","4",290,4582396,53
"3380","판도라","2017-01-29","2",238,4582634,54
"3381","판도라","2017-01-30","2",240,4582874,55
"3382","판도라","2017-01-31","1",100,4582974,56
"3383","판도라","2017-02-03","1",175,4583149,57
"3384","판도라","2017-02-21","1",0,4583149,58
"3385","판도라","2017-02-22","1",121,4583270,59
"3386","판도라","2017-03-09","1",115,4583385,60
"3387","판도라","2017-03-11","1",260,4583645,61
"3388","판도라","2017-04-25","1",25,4583670,62
"3389","판도라","2017-05-18","1",0,4583670,63
"3390","판도라","2017-06-20","1",150,4583820,64
"3391","판도라","2017-11-14","1",369,4584189,65
"3392","판도라","2017-11-15","1",217,4584406,66
"3393","판도라","2017-11-16","1",205,4584611,67
"3394","판도라","2017-11-17","1",189,4584800,68
"3395","판도라","2018-11-13","1",93,4584893,69
"3396","공범자들","2017-07-27","1",897,897,0
"3397","공범자들","2017-07-28","1",818,1715,0
"3398","공범자들","2017-07-29","1",319,2034,0
"3399","공범자들","2017-08-02","1",176,2210,0
"3400","공범자들","2017-08-03","1",320,2530,0
"3401","공범자들","2017-08-04","1",666,3196,0
"3402","공범자들","2017-08-07","2",326,3522,0
"3403","공범자들","2017-08-08","1",214,3736,0
"3404","공범자들","2017-08-09","5",1402,5138,0
"3405","공범자들","2017-08-10","1",227,5365,0
"3406","공범자들","2017-08-11","1",337,5702,0
"3407","공범자들","2017-08-14","4",930,6632,0
"3408","공범자들","2017-08-15","1",92,6724,0
"3409","공범자들","2017-08-16","5",1126,7850,0
"3410","공범자들","2017-08-17","186",9721,17571,1
"3411","공범자들","2017-08-18","208",10951,28522,2
"3412","공범자들","2017-08-19","202",18557,47079,3
"3413","공범자들","2017-08-20","203",18891,65970,4
"3414","공범자들","2017-08-21","210",9858,75828,5
"3415","공범자들","2017-08-22","212",9347,85175,6
"3416","공범자들","2017-08-23","228",10973,96148,7
"3417","공범자들","2017-08-24","219",9222,105370,8
"3418","공범자들","2017-08-25","236",9955,115325,9
"3419","공범자들","2017-08-26","243",17546,132871,10
"3420","공범자들","2017-08-27","246",16477,149348,11
"3421","공범자들","2017-08-28","237",7218,156566,12
"3422","공범자들","2017-08-29","245",8090,164656,13
"3423","공범자들","2017-08-30","171",7353,172009,14
"3424","공범자들","2017-08-31","179",5991,178000,15
"3425","공범자들","2017-09-01","176",6108,184108,16
"3426","공범자들","2017-09-02","180",11726,195834,17
"3427","공범자들","2017-09-03","183",10765,206599,18
"3428","공범자들","2017-09-04","185",4490,211089,19
"3429","공범자들","2017-09-05","195",4734,215823,20
"3430","공범자들","2017-09-06","173",3955,219778,21
"3431","공범자들","2017-09-07","155",3356,223134,22
"3432","공범자들","2017-09-08","159",3258,226392,23
"3433","공범자들","2017-09-09","157",5424,231816,24
"3434","공범자들","2017-09-10","163",5514,237330,25
"3435","공범자들","2017-09-11","160",2586,239916,26
"3436","공범자들","2017-09-12","158",2728,242644,27
"3437","공범자들","2017-09-13","158",2586,245230,28
"3438","공범자들","2017-09-14","91",1223,246453,29
"3439","공범자들","2017-09-15","89",1380,247833,30
"3440","공범자들","2017-09-16","85",1780,249613,31
"3441","공범자들","2017-09-17","96",1763,251376,32
"3442","공범자들","2017-09-18","88",925,252301,33
"3443","공범자들","2017-09-19","75",1012,253313,34
"3444","공범자들","2017-09-20","93",2080,255393,35
"3445","공범자들","2017-09-21","45",489,255882,36
"3446","공범자들","2017-09-22","42",361,256243,37
"3447","공범자들","2017-09-23","44",651,256894,38
"3448","공범자들","2017-09-24","41",372,257266,39
"3449","공범자들","2017-09-25","41",299,257565,40
"3450","공범자들","2017-09-26","38",429,257994,41
"3451","공범자들","2017-09-27","21",759,258753,42
"3452","공범자들","2017-09-28","5",14,258767,43
"3453","공범자들","2017-09-29","4",8,258775,44
"3454","공범자들","2017-09-30","8",100,258875,45
"3455","공범자들","2017-10-01","7",114,258989,46
"3456","공범자들","2017-10-02","5",39,259028,47
"3457","공범자들","2017-10-03","8",57,259085,48
"3458","공범자들","2017-10-04","5",37,259122,49
"3459","공범자들","2017-10-05","6",48,259170,50
"3460","공범자들","2017-10-06","3",38,259208,51
"3461","공범자들","2017-10-07","5",46,259254,52
"3462","공범자들","2017-10-08","6",52,259306,53
"3463","공범자들","2017-10-09","5",42,259348,54
"3464","공범자들","2017-10-10","3",9,259357,55
"3465","공범자들","2017-10-11","6",202,259559,56
"3466","공범자들","2017-10-12","3",8,259567,57
"3467","공범자들","2017-10-13","3",7,259574,58
"3468","공범자들","2017-10-14","3",16,259590,59
"3469","공범자들","2017-10-15","3",6,259596,60
"3470","공범자들","2017-10-16","2",4,259600,61
"3471","공범자들","2017-10-17","3",3,259603,62
"3472","공범자들","2017-10-18","3",3,259606,63
"3473","공범자들","2017-10-19","1",5,259611,64
"3474","공범자들","2017-10-20","1",416,260027,65
"3475","공범자들","2017-10-21","1",2,260029,66
"3476","공범자들","2017-10-22","1",1,260030,67
"3477","공범자들","2017-10-23","1",2,260032,68
"3478","공범자들","2017-10-24","1",1,260033,69
"3479","공범자들","2017-10-25","3",24,260057,70
"3480","공범자들","2017-10-31","1",43,260100,71
"3481","공범자들","2017-11-03","2",90,260190,72
"3482","공범자들","2017-11-08","1",2,260192,73
"3483","공범자들","2017-11-16","1",0,260192,74
"3484","공범자들","2017-11-20","1",0,260192,75
"3485","공범자들","2017-11-21","2",317,260509,76
"3486","공범자들","2017-11-22","1",3,260512,77
"3487","공범자들","2017-12-31","1",2,260514,78
"3488","미옥","2017-11-02","1",25,25,0
"3489","미옥","2017-11-06","5",2098,2123,0
"3490","미옥","2017-11-08","5",500,2623,0
"3491","미옥","2017-11-09","625",50553,53176,1
"3492","미옥","2017-11-10","635",40934,94110,2
"3493","미옥","2017-11-11","609",55584,149694,3
"3494","미옥","2017-11-12","583",43168,192862,4
"3495","미옥","2017-11-13","531",16872,209734,5
"3496","미옥","2017-11-14","525",15278,225012,6
"3497","미옥","2017-11-15","390",5479,230491,7
"3498","미옥","2017-11-16","106",1259,231750,8
"3499","미옥","2017-11-17","121",1394,233144,9
"3500","미옥","2017-11-18","111",1439,234583,10
"3501","미옥","2017-11-19","103",1433,236016,11
"3502","미옥","2017-11-20","102",783,236799,12
"3503","미옥","2017-11-21","104",851,237650,13
"3504","미옥","2017-11-22","28",343,237993,14
"3505","미옥","2017-11-23","9",62,238055,15
"3506","미옥","2017-11-24","9",67,238122,16
"3507","미옥","2017-11-25","9",82,238204,17
"3508","미옥","2017-11-26","8",34,238238,18
"3509","미옥","2017-11-27","10",60,238298,19
"3510","미옥","2017-11-28","29",186,238484,20
"3511","미옥","2017-11-29","7",43,238527,21
"3512","미옥","2017-11-30","5",5,238532,22
"3513","미옥","2017-12-01","5",5,238537,23
"3514","미옥","2017-12-02","5",5,238542,24
"3515","미옥","2017-12-03","5",5,238547,25
"3516","미옥","2017-12-04","5",5,238552,26
"3517","미옥","2017-12-05","5",5,238557,27
"3518","미옥","2017-12-06","5",5,238562,28
"3519","미옥","2017-12-07","5",5,238567,29
"3520","미옥","2017-12-08","5",5,238572,30
"3521","미옥","2017-12-09","5",5,238577,31
"3522","미옥","2017-12-10","5",5,238582,32
"3523","미옥","2017-12-11","5",5,238587,33
"3524","미옥","2018-01-25","11",1100,239687,34
"3525","미옥","2018-01-26","3",300,239987,35
"3526","미옥","2018-01-30","2",400,240387,36
"3527","미옥","2018-02-05","1",100,240487,37
"3528","미옥","2018-02-06","1",100,240587,38
"3529","미옥","2018-02-19","4",200,240787,39
"3530","미옥","2018-02-20","2",100,240887,40
"3531","미옥","2018-02-21","1",50,240937,41
"3532","미옥","2018-02-23","2",100,241037,42
"3533","미옥","2018-02-26","8",850,241887,43
"3534","미옥","2018-02-27","9",850,242737,44
"3535","어느날","2017-03-16","1",17,17,0
"3536","어느날","2017-03-30","7",2431,2448,0
"3537","어느날","2017-03-31","1",217,2665,0
"3538","어느날","2017-04-04","12",2543,5208,0
"3539","어느날","2017-04-05","457",24326,29534,1
"3540","어느날","2017-04-06","485",23785,53319,2
"3541","어느날","2017-04-07","480",27619,80938,3
"3542","어느날","2017-04-08","532",42573,123511,4
"3543","어느날","2017-04-09","528",39445,162956,5
"3544","어느날","2017-04-10","468",14789,177745,6
"3545","어느날","2017-04-11","465",14926,192671,7
"3546","어느날","2017-04-12","324",5737,198408,8
"3547","어느날","2017-04-13","290",4092,202500,9
"3548","어느날","2017-04-14","302",5249,207749,10
"3549","어느날","2017-04-15","275",7129,214878,11
"3550","어느날","2017-04-16","280",5829,220707,12
"3551","어느날","2017-04-17","286",3263,223970,13
"3552","어느날","2017-04-18","283",2781,226751,14
"3553","어느날","2017-04-19","278",2662,229413,15
"3554","어느날","2017-04-20","48",550,229963,16
"3555","어느날","2017-04-21","50",644,230607,17
"3556","어느날","2017-04-22","39",804,231411,18
"3557","어느날","2017-04-23","40",622,232033,19
"3558","어느날","2017-04-24","43",384,232417,20
"3559","어느날","2017-04-25","57",1241,233658,21
"3560","어느날","2017-04-26","11",180,233838,22
"3561","어느날","2017-04-27","12",393,234231,23
"3562","어느날","2017-04-28","2",19,234250,24
"3563","어느날","2017-04-29","4",54,234304,25
"3564","어느날","2017-04-30","5",282,234586,26
"3565","어느날","2017-05-01","5",24,234610,27
"3566","어느날","2017-05-02","5",20,234630,28
"3567","어느날","2017-05-03","4",15,234645,29
"3568","어느날","2017-05-25","1",36,234681,30
"3569","어느날","2017-10-27","1",148,234829,31
"3570","스파이더맨: 홈 커밍","2017-06-30","2",705,705,0
"3571","스파이더맨: 홈 커밍","2017-07-01","3",456,1161,0
"3572","스파이더맨: 홈 커밍","2017-07-02","2",932,2093,0
"3573","스파이더맨: 홈 커밍","2017-07-03","2",1006,3099,0
"3574","스파이더맨: 홈 커밍","2017-07-04","8",3098,6197,0
"3575","스파이더맨: 홈 커밍","2017-07-05","1,703",545302,551499,1
"3576","스파이더맨: 홈 커밍","2017-07-06","1,733",405399,956898,2
"3577","스파이더맨: 홈 커밍","2017-07-07","1,796",537526,1494424,3
"3578","스파이더맨: 홈 커밍","2017-07-08","1,965",1098751,2593175,4
"3579","스파이더맨: 홈 커밍","2017-07-09","1,965",970771,3563946,5
"3580","스파이더맨: 홈 커밍","2017-07-10","1,761",254624,3818570,6
"3581","스파이더맨: 홈 커밍","2017-07-11","1,797",267167,4085737,7
"3582","스파이더맨: 홈 커밍","2017-07-12","1,705",215812,4301549,8
"3583","스파이더맨: 홈 커밍","2017-07-13","1,668",183923,4485472,9
"3584","스파이더맨: 홈 커밍","2017-07-14","1,700",256830,4742302,10
"3585","스파이더맨: 홈 커밍","2017-07-15","1,781",632067,5374369,11
"3586","스파이더맨: 홈 커밍","2017-07-16","1,762",528457,5902826,12
"3587","스파이더맨: 홈 커밍","2017-07-17","1,600",124148,6026974,13
"3588","스파이더맨: 홈 커밍","2017-07-18","1,617",111280,6138254,14
"3589","스파이더맨: 홈 커밍","2017-07-19","1,472",103671,6241925,15
"3590","스파이더맨: 홈 커밍","2017-07-20","895",79499,6321424,16
"3591","스파이더맨: 홈 커밍","2017-07-21","897",113462,6434886,17
"3592","스파이더맨: 홈 커밍","2017-07-22","918",225365,6660251,18
"3593","스파이더맨: 홈 커밍","2017-07-23","914",195009,6855260,19
"3594","스파이더맨: 홈 커밍","2017-07-24","876",62945,6918205,20
"3595","스파이더맨: 홈 커밍","2017-07-25","879",62825,6981030,21
"3596","스파이더맨: 홈 커밍","2017-07-26","429",28732,7009762,22
"3597","스파이더맨: 홈 커밍","2017-07-27","410",22024,7031786,23
"3598","스파이더맨: 홈 커밍","2017-07-28","421",25030,7056816,24
"3599","스파이더맨: 홈 커밍","2017-07-29","414",37683,7094499,25
"3600","스파이더맨: 홈 커밍","2017-07-30","425",37500,7131999,26
"3601","스파이더맨: 홈 커밍","2017-07-31","490",35402,7167401,27
"3602","스파이더맨: 홈 커밍","2017-08-01","497",34024,7201425,28
"3603","스파이더맨: 홈 커밍","2017-08-02","117",8123,7209548,29
"3604","스파이더맨: 홈 커밍","2017-08-03","116",7051,7216599,30
"3605","스파이더맨: 홈 커밍","2017-08-04","116",7144,7223743,31
"3606","스파이더맨: 홈 커밍","2017-08-05","120",9586,7233329,32
"3607","스파이더맨: 홈 커밍","2017-08-06","116",7437,7240766,33
"3608","스파이더맨: 홈 커밍","2017-08-07","126",4430,7245196,34
"3609","스파이더맨: 홈 커밍","2017-08-08","121",4702,7249898,35
"3610","스파이더맨: 홈 커밍","2017-08-09","32",1601,7251499,36
"3611","스파이더맨: 홈 커밍","2017-08-10","20",676,7252175,37
"3612","스파이더맨: 홈 커밍","2017-08-11","18",835,7253010,38
"3613","스파이더맨: 홈 커밍","2017-08-12","21",1044,7254054,39
"3614","스파이더맨: 홈 커밍","2017-08-13","19",824,7254878,40
"3615","스파이더맨: 홈 커밍","2017-08-14","18",839,7255717,41
"3616","스파이더맨: 홈 커밍","2017-08-15","6",266,7255983,42
"3617","스파이더맨: 홈 커밍","2017-08-16","7",225,7256208,43
"3618","스파이더맨: 홈 커밍","2017-08-17","4",188,7256396,44
"3619","스파이더맨: 홈 커밍","2017-08-18","4",157,7256553,45
"3620","스파이더맨: 홈 커밍","2017-08-19","6",260,7256813,46
"3621","스파이더맨: 홈 커밍","2017-08-20","3",141,7256954,47
"3622","스파이더맨: 홈 커밍","2017-08-21","4",163,7257117,48
"3623","스파이더맨: 홈 커밍","2017-08-22","3",110,7257227,49
"3624","스파이더맨: 홈 커밍","2017-08-23","2",65,7257292,50
"3625","스파이더맨: 홈 커밍","2017-08-24","2",75,7257367,51
"3626","스파이더맨: 홈 커밍","2017-08-25","2",53,7257420,52
"3627","스파이더맨: 홈 커밍","2017-08-26","2",123,7257543,53
"3628","스파이더맨: 홈 커밍","2017-08-27","2",122,7257665,54
"3629","스파이더맨: 홈 커밍","2017-08-28","2",42,7257707,55
"3630","스파이더맨: 홈 커밍","2017-08-29","2",48,7257755,56
"3631","스파이더맨: 홈 커밍","2017-08-30","2",415,7258170,57
"3632","스파이더맨: 홈 커밍","2017-08-31","1",17,7258187,58
"3633","스파이더맨: 홈 커밍","2017-09-01","1",9,7258196,59
"3634","스파이더맨: 홈 커밍","2017-09-02","1",38,7258234,60
"3635","스파이더맨: 홈 커밍","2017-09-03","1",48,7258282,61
"3636","스파이더맨: 홈 커밍","2017-09-04","1",14,7258296,62
"3637","스파이더맨: 홈 커밍","2017-09-05","1",6,7258302,63
"3638","스파이더맨: 홈 커밍","2017-09-06","1",13,7258315,64
"3639","스파이더맨: 홈 커밍","2017-09-07","1",10,7258325,65
"3640","스파이더맨: 홈 커밍","2017-09-08","1",2,7258327,66
"3641","스파이더맨: 홈 커밍","2017-09-09","1",30,7258357,67
"3642","스파이더맨: 홈 커밍","2017-09-10","1",17,7258374,68
"3643","스파이더맨: 홈 커밍","2017-09-11","1",14,7258388,69
"3644","스파이더맨: 홈 커밍","2017-09-12","1",5,7258393,70
"3645","스파이더맨: 홈 커밍","2017-09-13","1",9,7258402,71
"3646","스파이더맨: 홈 커밍","2017-09-15","1",5,7258407,72
"3647","스파이더맨: 홈 커밍","2017-09-18","1",7,7258414,73
"3648","스파이더맨: 홈 커밍","2017-09-19","1",5,7258419,74
"3649","스파이더맨: 홈 커밍","2017-09-20","1",1,7258420,75
"3650","스파이더맨: 홈 커밍","2017-09-23","1",258,7258678,76
"3651","미녀와 야수","2017-02-21","1",200,200,0
"3652","미녀와 야수","2017-03-03","2",629,829,0
"3653","미녀와 야수","2017-03-14","4",1664,2493,0
"3654","미녀와 야수","2017-03-16","1,244",166930,169423,1
"3655","미녀와 야수","2017-03-17","1,260",234961,404384,2
"3656","미녀와 야수","2017-03-18","1,611",602569,1006953,3
"3657","미녀와 야수","2017-03-19","1,627",564477,1571430,4
"3658","미녀와 야수","2017-03-20","1,336",144248,1715678,5
"3659","미녀와 야수","2017-03-21","1,352",136339,1852017,6
"3660","미녀와 야수","2017-03-22","1,318",124015,1976032,7
"3661","미녀와 야수","2017-03-23","896",99762,2075794,8
"3662","미녀와 야수","2017-03-24","939",158998,2234792,9
"3663","미녀와 야수","2017-03-25","1,221",456409,2691201,10
"3664","미녀와 야수","2017-03-26","1,256",413463,3104664,11
"3665","미녀와 야수","2017-03-27","961",81433,3186097,12
"3666","미녀와 야수","2017-03-28","974",73783,3259880,13
"3667","미녀와 야수","2017-03-29","758",122513,3382393,14
"3668","미녀와 야수","2017-03-30","740",62955,3445348,15
"3669","미녀와 야수","2017-03-31","811",106055,3551403,16
"3670","미녀와 야수","2017-04-01","1,105",306314,3857717,17
"3671","미녀와 야수","2017-04-02","1,123",239654,4097371,18
"3672","미녀와 야수","2017-04-03","790",49485,4146856,19
"3673","미녀와 야수","2017-04-04","791",44223,4191079,20
"3674","미녀와 야수","2017-04-05","620",42189,4233268,21
"3675","미녀와 야수","2017-04-06","577",41678,4274946,22
"3676","미녀와 야수","2017-04-07","623",58295,4333241,23
"3677","미녀와 야수","2017-04-08","959",153866,4487107,24
"3678","미녀와 야수","2017-04-09","942",134921,4622028,25
"3679","미녀와 야수","2017-04-10","646",26982,4649010,26
"3680","미녀와 야수","2017-04-11","650",25764,4674774,27
"3681","미녀와 야수","2017-04-12","500",19461,4694235,28
"3682","미녀와 야수","2017-04-13","476",16951,4711186,29
"3683","미녀와 야수","2017-04-14","506",26570,4737756,30
"3684","미녀와 야수","2017-04-15","652",68987,4806743,31
"3685","미녀와 야수","2017-04-16","653",57978,4864721,32
"3686","미녀와 야수","2017-04-17","487",15468,4880189,33
"3687","미녀와 야수","2017-04-18","480",13367,4893556,34
"3688","미녀와 야수","2017-04-19","478",13702,4907258,35
"3689","미녀와 야수","2017-04-20","422",11035,4918293,36
"3690","미녀와 야수","2017-04-21","467",16904,4935197,37
"3691","미녀와 야수","2017-04-22","593",46734,4981931,38
"3692","미녀와 야수","2017-04-23","613",41250,5023181,39
"3693","미녀와 야수","2017-04-24","454",9413,5032594,40
"3694","미녀와 야수","2017-04-25","453",10580,5043174,41
"3695","미녀와 야수","2017-04-26","258",7663,5050837,42
"3696","미녀와 야수","2017-04-27","231",4994,5055831,43
"3697","미녀와 야수","2017-04-28","214",7294,5063125,44
"3698","미녀와 야수","2017-04-29","238",14999,5078124,45
"3699","미녀와 야수","2017-04-30","239",15987,5094111,46
"3700","미녀와 야수","2017-05-01","250",13249,5107360,47
"3701","미녀와 야수","2017-05-02","215",8490,5115850,48
"3702","미녀와 야수","2017-05-03","45",3990,5119840,49
"3703","미녀와 야수","2017-05-04","46",3216,5123056,50
"3704","미녀와 야수","2017-05-05","58",4737,5127793,51
"3705","미녀와 야수","2017-05-06","50",2715,5130508,52
"3706","미녀와 야수","2017-05-07","50",1796,5132304,53
"3707","미녀와 야수","2017-05-08","48",1104,5133408,54
"3708","미녀와 야수","2017-05-09","13",788,5134196,55
"3709","미녀와 야수","2017-05-10","15",258,5134454,56
"3710","미녀와 야수","2017-05-11","15",172,5134626,57
"3711","미녀와 야수","2017-05-12","12",247,5134873,58
"3712","미녀와 야수","2017-05-13","16",707,5135580,59
"3713","미녀와 야수","2017-05-14","11",378,5135958,60
"3714","미녀와 야수","2017-05-15","11",122,5136080,61
"3715","미녀와 야수","2017-05-16","12",144,5136224,62
"3716","미녀와 야수","2017-05-17","12",91,5136315,63
"3717","미녀와 야수","2017-05-18","10",83,5136398,64
"3718","미녀와 야수","2017-05-19","10",98,5136496,65
"3719","미녀와 야수","2017-05-20","10",178,5136674,66
"3720","미녀와 야수","2017-05-21","10",118,5136792,67
"3721","미녀와 야수","2017-05-22","10",119,5136911,68
"3722","미녀와 야수","2017-05-23","10",63,5136974,69
"3723","미녀와 야수","2017-05-24","10",101,5137075,70
"3724","미녀와 야수","2017-05-25","6",132,5137207,71
"3725","미녀와 야수","2017-05-26","5",50,5137257,72
"3726","미녀와 야수","2017-05-27","6",91,5137348,73
"3727","미녀와 야수","2017-05-28","7",97,5137445,74
"3728","미녀와 야수","2017-05-29","6",52,5137497,75
"3729","미녀와 야수","2017-05-30","6",78,5137575,76
"3730","미녀와 야수","2017-05-31","5",50,5137625,77
"3731","미녀와 야수","2017-06-01","5",50,5137675,78
"3732","미녀와 야수","2017-06-02","5",50,5137725,79
"3733","미녀와 야수","2017-06-03","7",86,5137811,80
"3734","미녀와 야수","2017-06-04","7",90,5137901,81
"3735","미녀와 야수","2017-06-05","6",87,5137988,82
"3736","미녀와 야수","2017-06-06","6",56,5138044,83
"3737","미녀와 야수","2017-06-07","5",50,5138094,84
"3738","미녀와 야수","2017-06-17","1",99,5138193,85
"3739","미녀와 야수","2017-10-19","1",3,5138196,86
"3740","미녀와 야수","2017-10-20","1",7,5138203,87
"3741","미녀와 야수","2017-10-21","1",7,5138210,88
"3742","미녀와 야수","2017-10-22","1",10,5138220,89
"3743","미녀와 야수","2017-10-23","1",7,5138227,90
"3744","미녀와 야수","2017-10-24","1",11,5138238,91
"3745","미녀와 야수","2017-10-25","1",46,5138284,92
"3746","미녀와 야수","2017-11-01","1",11,5138295,93
"3747","미녀와 야수","2017-11-03","1",33,5138328,94
"3748","킹스맨: 골든 서클","2017-09-19","3",1416,1416,0
"3749","킹스맨: 골든 서클","2017-09-20","3",1141,2557,0
"3750","킹스맨: 골든 서클","2017-09-21","3",2019,4576,0
"3751","킹스맨: 골든 서클","2017-09-23","1",186,4762,0
"3752","킹스맨: 골든 서클","2017-09-26","3",973,5735,0
"3753","킹스맨: 골든 서클","2017-09-27","1,687",481948,487683,1
"3754","킹스맨: 골든 서클","2017-09-28","1,582",278537,766220,2
"3755","킹스맨: 골든 서클","2017-09-29","1,594",345663,1111883,3
"3756","킹스맨: 골든 서클","2017-09-30","1,677",618884,1730767,4
"3757","킹스맨: 골든 서클","2017-10-01","1,678",619904,2350671,5
"3758","킹스맨: 골든 서클","2017-10-02","1,661",475202,2825873,6
"3759","킹스맨: 골든 서클","2017-10-03","1,015",271178,3097051,7
"3760","킹스맨: 골든 서클","2017-10-04","995",280831,3377882,8
"3761","킹스맨: 골든 서클","2017-10-05","945",306471,3684353,9
"3762","킹스맨: 골든 서클","2017-10-06","910",286426,3970779,10
"3763","킹스맨: 골든 서클","2017-10-07","878",227000,4197779,11
"3764","킹스맨: 골든 서클","2017-10-08","857",203249,4401028,12
"3765","킹스맨: 골든 서클","2017-10-09","793",142491,4543519,13
"3766","킹스맨: 골든 서클","2017-10-10","725",45508,4589027,14
"3767","킹스맨: 골든 서클","2017-10-11","700",42007,4631034,15
"3768","킹스맨: 골든 서클","2017-10-12","505",27998,4659032,16
"3769","킹스맨: 골든 서클","2017-10-13","525",35902,4694934,17
"3770","킹스맨: 골든 서클","2017-10-14","543",63696,4758630,18
"3771","킹스맨: 골든 서클","2017-10-15","529",52430,4811060,19
"3772","킹스맨: 골든 서클","2017-10-16","510",21345,4832405,20
"3773","킹스맨: 골든 서클","2017-10-17","514",18669,4851074,21
"3774","킹스맨: 골든 서클","2017-10-18","510",17952,4869026,22
"3775","킹스맨: 골든 서클","2017-10-19","302",8586,4877612,23
"3776","킹스맨: 골든 서클","2017-10-20","310",10829,4888441,24
"3777","킹스맨: 골든 서클","2017-10-21","311",18355,4906796,25
"3778","킹스맨: 골든 서클","2017-10-22","309",15283,4922079,26
"3779","킹스맨: 골든 서클","2017-10-23","297",7090,4929169,27
"3780","킹스맨: 골든 서클","2017-10-24","297",7164,4936333,28
"3781","킹스맨: 골든 서클","2017-10-25","28",749,4937082,29
"3782","킹스맨: 골든 서클","2017-10-26","25",529,4937611,30
"3783","킹스맨: 골든 서클","2017-10-27","29",977,4938588,31
"3784","킹스맨: 골든 서클","2017-10-28","20",972,4939560,32
"3785","킹스맨: 골든 서클","2017-10-29","22",884,4940444,33
"3786","킹스맨: 골든 서클","2017-10-30","28",616,4941060,34
"3787","킹스맨: 골든 서클","2017-10-31","25",659,4941719,35
"3788","킹스맨: 골든 서클","2017-11-01","25",519,4942238,36
"3789","킹스맨: 골든 서클","2017-11-02","11",136,4942374,37
"3790","킹스맨: 골든 서클","2017-11-03","9",118,4942492,38
"3791","킹스맨: 골든 서클","2017-11-04","7",147,4942639,39
"3792","킹스맨: 골든 서클","2017-11-05","8",169,4942808,40
"3793","킹스맨: 골든 서클","2017-11-06","8",120,4942928,41
"3794","킹스맨: 골든 서클","2017-11-07","9",113,4943041,42
"3795","킹스맨: 골든 서클","2017-11-08","8",107,4943148,43
"3796","킹스맨: 골든 서클","2017-11-09","6",69,4943217,44
"3797","킹스맨: 골든 서클","2017-11-10","6",70,4943287,45
"3798","킹스맨: 골든 서클","2017-11-11","5",110,4943397,46
"3799","킹스맨: 골든 서클","2017-11-12","6",126,4943523,47
"3800","킹스맨: 골든 서클","2017-11-13","6",71,4943594,48
"3801","킹스맨: 골든 서클","2017-11-14","5",72,4943666,49
"3802","킹스맨: 골든 서클","2017-11-15","5",62,4943728,50
"3803","킹스맨: 골든 서클","2017-11-16","6",99,4943827,51
"3804","킹스맨: 골든 서클","2017-11-17","6",105,4943932,52
"3805","킹스맨: 골든 서클","2017-11-18","6",130,4944062,53
"3806","킹스맨: 골든 서클","2017-11-19","6",131,4944193,54
"3807","킹스맨: 골든 서클","2017-11-20","6",95,4944288,55
"3808","킹스맨: 골든 서클","2017-11-21","6",92,4944380,56
"3809","킹스맨: 골든 서클","2017-11-22","6",96,4944476,57
"3810","킹스맨: 골든 서클","2017-11-23","5",90,4944566,58
"3811","킹스맨: 골든 서클","2017-11-24","6",94,4944660,59
"3812","킹스맨: 골든 서클","2017-11-25","5",120,4944780,60
"3813","킹스맨: 골든 서클","2017-11-26","5",120,4944900,61
"3814","킹스맨: 골든 서클","2017-11-27","6",97,4944997,62
"3815","킹스맨: 골든 서클","2017-11-28","6",93,4945090,63
"3816","킹스맨: 골든 서클","2017-11-29","5",90,4945180,64
"3817","킹스맨: 골든 서클","2017-12-02","1",304,4945484,65
"3818","토르: 라그나로크","2017-10-18","1",140,140,0
"3819","토르: 라그나로크","2017-10-23","1",624,764,0
"3820","토르: 라그나로크","2017-10-24","5",1747,2511,0
"3821","토르: 라그나로크","2017-10-25","1,601",415741,418252,1
"3822","토르: 라그나로크","2017-10-26","1,513",217223,635475,2
"3823","토르: 라그나로크","2017-10-27","1,554",316499,951974,3
"3824","토르: 라그나로크","2017-10-28","1,640",662646,1614620,4
"3825","토르: 라그나로크","2017-10-29","1,597",599966,2214586,5
"3826","토르: 라그나로크","2017-10-30","1,448",152634,2367220,6
"3827","토르: 라그나로크","2017-10-31","1,456",140706,2507926,7
"3828","토르: 라그나로크","2017-11-01","1,431",129636,2637562,8
"3829","토르: 라그나로크","2017-11-02","1,000",99572,2737134,9
"3830","토르: 라그나로크","2017-11-03","1,017",162641,2899775,10
"3831","토르: 라그나로크","2017-11-04","1,047",365000,3264775,11
"3832","토르: 라그나로크","2017-11-05","1,039",306265,3571040,12
"3833","토르: 라그나로크","2017-11-06","943",71307,3642347,13
"3834","토르: 라그나로크","2017-11-07","962",62157,3704504,14
"3835","토르: 라그나로크","2017-11-08","841",61380,3765884,15
"3836","토르: 라그나로크","2017-11-09","708",51340,3817224,16
"3837","토르: 라그나로크","2017-11-10","740",79054,3896278,17
"3838","토르: 라그나로크","2017-11-11","856",213813,4110091,18
"3839","토르: 라그나로크","2017-11-12","832",172871,4282962,19
"3840","토르: 라그나로크","2017-11-13","733",41186,4324148,20
"3841","토르: 라그나로크","2017-11-14","746",36953,4361101,21
"3842","토르: 라그나로크","2017-11-15","764",31204,4392305,22
"3843","토르: 라그나로크","2017-11-16","494",31835,4424140,23
"3844","토르: 라그나로크","2017-11-17","494",30287,4454427,24
"3845","토르: 라그나로크","2017-11-18","563",72424,4526851,25
"3846","토르: 라그나로크","2017-11-19","574",65541,4592392,26
"3847","토르: 라그나로크","2017-11-20","491",18001,4610393,27
"3848","토르: 라그나로크","2017-11-21","495",15323,4625716,28
"3849","토르: 라그나로크","2017-11-22","423",12529,4638245,29
"3850","토르: 라그나로크","2017-11-23","422",15417,4653662,30
"3851","토르: 라그나로크","2017-11-24","429",19514,4673176,31
"3852","토르: 라그나로크","2017-11-25","480",39962,4713138,32
"3853","토르: 라그나로크","2017-11-26","484",39538,4752676,33
"3854","토르: 라그나로크","2017-11-27","428",12285,4764961,34
"3855","토르: 라그나로크","2017-11-28","428",11189,4776150,35
"3856","토르: 라그나로크","2017-11-29","225",6856,4783006,36
"3857","토르: 라그나로크","2017-11-30","227",6507,4789513,37
"3858","토르: 라그나로크","2017-12-01","228",7879,4797392,38
"3859","토르: 라그나로크","2017-12-02","205",13158,4810550,39
"3860","토르: 라그나로크","2017-12-03","206",12638,4823188,40
"3861","토르: 라그나로크","2017-12-04","223",4556,4827744,41
"3862","토르: 라그나로크","2017-12-05","222",4238,4831982,42
"3863","토르: 라그나로크","2017-12-06","224",4314,4836296,43
"3864","토르: 라그나로크","2017-12-07","90",1745,4838041,44
"3865","토르: 라그나로크","2017-12-08","93",2114,4840155,45
"3866","토르: 라그나로크","2017-12-09","84",4052,4844207,46
"3867","토르: 라그나로크","2017-12-10","81",3139,4847346,47
"3868","토르: 라그나로크","2017-12-11","81",1455,4848801,48
"3869","토르: 라그나로크","2017-12-12","81",1435,4850236,49
"3870","토르: 라그나로크","2017-12-13","79",1523,4851759,50
"3871","토르: 라그나로크","2017-12-14","6",190,4851949,51
"3872","토르: 라그나로크","2017-12-15","5",163,4852112,52
"3873","토르: 라그나로크","2017-12-16","9",544,4852656,53
"3874","토르: 라그나로크","2017-12-17","7",367,4853023,54
"3875","토르: 라그나로크","2017-12-18","6",146,4853169,55
"3876","토르: 라그나로크","2017-12-19","5",128,4853297,56
"3877","토르: 라그나로크","2017-12-20","2",34,4853331,57
"3878","토르: 라그나로크","2017-12-21","2",57,4853388,58
"3879","토르: 라그나로크","2017-12-22","2",35,4853423,59
"3880","토르: 라그나로크","2017-12-23","2",51,4853474,60
"3881","토르: 라그나로크","2017-12-24","2",80,4853554,61
"3882","토르: 라그나로크","2017-12-25","2",126,4853680,62
"3883","토르: 라그나로크","2017-12-26","2",88,4853768,63
"3884","토르: 라그나로크","2017-12-27","1",3,4853771,64
"3885","토르: 라그나로크","2017-12-28","1",7,4853778,65
"3886","토르: 라그나로크","2018-01-07","1",157,4853935,66
"3887","토르: 라그나로크","2018-01-19","5",514,4854449,67
"3888","토르: 라그나로크","2018-01-20","10",729,4855178,68
"3889","토르: 라그나로크","2018-01-21","9",654,4855832,69
"3890","토르: 라그나로크","2018-01-26","9",425,4856257,70
"3891","토르: 라그나로크","2018-01-27","7",346,4856603,71
"3892","토르: 라그나로크","2018-01-28","11",549,4857152,72
"3893","토르: 라그나로크","2018-07-31","1",306,4857458,73
"3894","토르: 라그나로크","2018-10-25","1",28,4857486,74
"3895","토르: 라그나로크","2018-10-26","1",68,4857554,75
"3896","토르: 라그나로크","2018-10-27","1",161,4857715,76
"3897","토르: 라그나로크","2018-10-28","1",65,4857780,77
"3898","토르: 라그나로크","2018-10-29","1",9,4857789,78
"3899","토르: 라그나로크","2018-10-30","1",3,4857792,79
"3900","토르: 라그나로크","2018-11-01","2",150,4857942,80
"3901","토르: 라그나로크","2018-11-02","1",57,4857999,81
"3902","토르: 라그나로크","2018-11-03","2",250,4858249,82
"3903","토르: 라그나로크","2018-11-04","2",194,4858443,83
"3904","토르: 라그나로크","2018-11-05","2",54,4858497,84
"3905","토르: 라그나로크","2018-11-06","2",47,4858544,85
"3906","토르: 라그나로크","2018-11-07","1",28,4858572,86
"3907","미이라","2017-06-02","1",250,250,0
"3908","미이라","2017-06-05","1",303,553,0
"3909","미이라","2017-06-06","1,257",873117,873670,1
"3910","미이라","2017-06-07","1,126",214604,1088274,2
"3911","미이라","2017-06-08","1,120",167531,1255805,3
"3912","미이라","2017-06-09","1,170",222022,1477827,4
"3913","미이라","2017-06-10","1,254",483476,1961303,5
"3914","미이라","2017-06-11","1,251",422898,2384201,6
"3915","미이라","2017-06-12","1,086",106244,2490445,7
"3916","미이라","2017-06-13","1,094",89712,2580157,8
"3917","미이라","2017-06-14","1,070",88983,2669140,9
"3918","미이라","2017-06-15","864",73443,2742583,10
"3919","미이라","2017-06-16","892",98073,2840656,11
"3920","미이라","2017-06-17","931",210633,3051289,12
"3921","미이라","2017-06-18","933",189596,3240885,13
"3922","미이라","2017-06-19","831",54700,3295585,14
"3923","미이라","2017-06-20","844",51044,3346629,15
"3924","미이라","2017-06-21","547",28457,3375086,16
"3925","미이라","2017-06-22","536",25459,3400545,17
"3926","미이라","2017-06-23","548",30257,3430802,18
"3927","미이라","2017-06-24","591",67485,3498287,19
"3928","미이라","2017-06-25","570",64167,3562454,20
"3929","미이라","2017-06-26","510",22016,3584470,21
"3930","미이라","2017-06-27","534",20298,3604768,22
"3931","미이라","2017-06-28","286",9460,3614228,23
"3932","미이라","2017-06-29","284",6450,3620678,24
"3933","미이라","2017-06-30","288",8271,3628949,25
"3934","미이라","2017-07-01","314",15977,3644926,26
"3935","미이라","2017-07-02","322",16355,3661281,27
"3936","미이라","2017-07-03","287",6130,3667411,28
"3937","미이라","2017-07-04","282",5985,3673396,29
"3938","미이라","2017-07-05","71",903,3674299,30
"3939","미이라","2017-07-06","53",508,3674807,31
"3940","미이라","2017-07-07","61",996,3675803,32
"3941","미이라","2017-07-08","44",1148,3676951,33
"3942","미이라","2017-07-09","53",1132,3678083,34
"3943","미이라","2017-07-10","63",539,3678622,35
"3944","미이라","2017-07-11","61",537,3679159,36
"3945","미이라","2017-07-12","83",1027,3680186,37
"3946","미이라","2017-07-13","67",873,3681059,38
"3947","미이라","2017-07-14","70",1338,3682397,39
"3948","미이라","2017-07-15","70",2343,3684740,40
"3949","미이라","2017-07-16","72",2038,3686778,41
"3950","미이라","2017-07-17","65",775,3687553,42
"3951","미이라","2017-07-18","63",761,3688314,43
"3952","미이라","2017-07-19","58",511,3688825,44
"3953","미이라","2017-07-20","5",50,3688875,45
"3954","미이라","2017-07-21","5",50,3688925,46
"3955","미이라","2017-07-23","5",50,3688975,47
"3956","미이라","2017-07-24","5",50,3689025,48
"3957","미이라","2017-07-25","5",50,3689075,49
"3958","미이라","2017-07-26","5",50,3689125,50
"3959","미이라","2017-07-27","5",50,3689175,51
"3960","미이라","2017-07-28","5",50,3689225,52
"3961","미이라","2017-07-30","4",40,3689265,53
"3962","미이라","2017-07-31","5",60,3689325,54
"3963","분노의 질주: 더 익스트림","2017-04-06","1",200,200,0
"3964","분노의 질주: 더 익스트림","2017-04-11","1",303,503,0
"3965","분노의 질주: 더 익스트림","2017-04-12","1,238",208481,208984,1
"3966","분노의 질주: 더 익스트림","2017-04-13","1,295",162386,371370,2
"3967","분노의 질주: 더 익스트림","2017-04-14","1,337",227537,598907,3
"3968","분노의 질주: 더 익스트림","2017-04-15","1,469",437834,1036741,4
"3969","분노의 질주: 더 익스트림","2017-04-16","1,457",391851,1428592,5
"3970","분노의 질주: 더 익스트림","2017-04-17","1,294",147098,1575690,6
"3971","분노의 질주: 더 익스트림","2017-04-18","1,330",113803,1689493,7
"3972","분노의 질주: 더 익스트림","2017-04-19","1,309",105485,1794978,8
"3973","분노의 질주: 더 익스트림","2017-04-20","1,182",103894,1898872,9
"3974","분노의 질주: 더 익스트림","2017-04-21","1,216",143780,2042652,10
"3975","분노의 질주: 더 익스트림","2017-04-22","1,283",288020,2330672,11
"3976","분노의 질주: 더 익스트림","2017-04-23","1,264",250791,2581463,12
"3977","분노의 질주: 더 익스트림","2017-04-24","1,197",73571,2655034,13
"3978","분노의 질주: 더 익스트림","2017-04-25","1,211",69702,2724736,14
"3979","분노의 질주: 더 익스트림","2017-04-26","643",73324,2798060,15
"3980","분노의 질주: 더 익스트림","2017-04-27","630",48097,2846157,16
"3981","분노의 질주: 더 익스트림","2017-04-28","659",75156,2921313,17
"3982","분노의 질주: 더 익스트림","2017-04-29","697",136724,3058037,18
"3983","분노의 질주: 더 익스트림","2017-04-30","715",141287,3199324,19
"3984","분노의 질주: 더 익스트림","2017-05-01","755",106836,3306160,20
"3985","분노의 질주: 더 익스트림","2017-05-02","725",63166,3369326,21
"3986","분노의 질주: 더 익스트림","2017-05-03","451",55437,3424763,22
"3987","분노의 질주: 더 익스트림","2017-05-04","462",41125,3465888,23
"3988","분노의 질주: 더 익스트림","2017-05-05","444",50923,3516811,24
"3989","분노의 질주: 더 익스트림","2017-05-06","451",44131,3560942,25
"3990","분노의 질주: 더 익스트림","2017-05-07","446",30612,3591554,26
"3991","분노의 질주: 더 익스트림","2017-05-08","439",18064,3609618,27
"3992","분노의 질주: 더 익스트림","2017-05-09","195",10874,3620492,28
"3993","분노의 질주: 더 익스트림","2017-05-10","191",4358,3624850,29
"3994","분노의 질주: 더 익스트림","2017-05-11","181",3549,3628399,30
"3995","분노의 질주: 더 익스트림","2017-05-12","178",4449,3632848,31
"3996","분노의 질주: 더 익스트림","2017-05-13","153",7257,3640105,32
"3997","분노의 질주: 더 익스트림","2017-05-14","150",5662,3645767,33
"3998","분노의 질주: 더 익스트림","2017-05-15","173",2848,3648615,34
"3999","분노의 질주: 더 익스트림","2017-05-16","166",2462,3651077,35
"4000","분노의 질주: 더 익스트림","2017-05-17","17",464,3651541,36
"4001","분노의 질주: 더 익스트림","2017-05-18","10",84,3651625,37
"4002","분노의 질주: 더 익스트림","2017-05-19","6",79,3651704,38
"4003","분노의 질주: 더 익스트림","2017-05-20","7",138,3651842,39
"4004","분노의 질주: 더 익스트림","2017-05-21","6",95,3651937,40
"4005","분노의 질주: 더 익스트림","2017-05-22","10",72,3652009,41
"4006","분노의 질주: 더 익스트림","2017-05-23","7",49,3652058,42
"4007","분노의 질주: 더 익스트림","2017-05-24","2",86,3652144,43
"4008","분노의 질주: 더 익스트림","2017-05-25","1",55,3652199,44
"4009","분노의 질주: 더 익스트림","2017-05-26","1",54,3652253,45
"4010","분노의 질주: 더 익스트림","2017-05-27","1",63,3652316,46
"4011","분노의 질주: 더 익스트림","2017-05-28","1",60,3652376,47
"4012","분노의 질주: 더 익스트림","2017-05-29","1",51,3652427,48
"4013","분노의 질주: 더 익스트림","2017-05-30","1",56,3652483,49
"4014","분노의 질주: 더 익스트림","2017-05-31","1",53,3652536,50
"4015","분노의 질주: 더 익스트림","2017-06-01","1",52,3652588,51
"4016","분노의 질주: 더 익스트림","2017-06-02","1",52,3652640,52
"4017","분노의 질주: 더 익스트림","2017-06-03","1",59,3652699,53
"4018","분노의 질주: 더 익스트림","2017-06-04","1",55,3652754,54
"4019","분노의 질주: 더 익스트림","2017-06-05","1",56,3652810,55
"4020","분노의 질주: 더 익스트림","2017-06-06","1",60,3652870,56
"4021","분노의 질주: 더 익스트림","2017-06-07","1",53,3652923,57
"4022","분노의 질주: 더 익스트림","2017-06-08","1",53,3652976,58
"4023","분노의 질주: 더 익스트림","2017-06-09","1",52,3653028,59
"4024","분노의 질주: 더 익스트림","2017-06-10","1",50,3653078,60
"4025","분노의 질주: 더 익스트림","2017-06-11","1",53,3653131,61
"4026","분노의 질주: 더 익스트림","2017-06-12","1",52,3653183,62
"4027","분노의 질주: 더 익스트림","2017-06-13","1",55,3653238,63
"4028","너의 이름은.","2016-12-20","1",284,284,0
"4029","너의 이름은.","2016-12-21","3",698,982,0
"4030","너의 이름은.","2016-12-28","4",1353,2335,0
"4031","너의 이름은.","2016-12-30","1",255,2590,0
"4032","너의 이름은.","2016-12-31","275",34173,36763,0
"4033","너의 이름은.","2017-01-01","275",37418,74181,0
"4034","너의 이름은.","2017-01-02","1",58,74239,0
"4035","너의 이름은.","2017-01-04","555",138028,212267,1
"4036","너의 이름은.","2017-01-05","780",132463,344730,2
"4037","너의 이름은.","2017-01-06","907",169402,514132,3
"4038","너의 이름은.","2017-01-07","933",335325,849457,4
"4039","너의 이름은.","2017-01-08","947",333008,1182465,5
"4040","너의 이름은.","2017-01-09","801",154781,1337246,6
"4041","너의 이름은.","2017-01-10","805",150777,1488023,7
"4042","너의 이름은.","2017-01-11","740",140350,1628373,8
"4043","너의 이름은.","2017-01-12","714",121478,1749851,9
"4044","너의 이름은.","2017-01-13","759",148996,1898847,10
"4045","너의 이름은.","2017-01-14","845",292247,2191094,11
"4046","너의 이름은.","2017-01-15","842",298280,2489374,12
"4047","너의 이름은.","2017-01-16","759",97566,2586940,13
"4048","너의 이름은.","2017-01-17","788",93300,2680240,14
"4049","너의 이름은.","2017-01-18","573",58068,2738308,15
"4050","너의 이름은.","2017-01-19","601",53380,2791688,16
"4051","너의 이름은.","2017-01-20","578",55958,2847646,17
"4052","너의 이름은.","2017-01-21","605",107103,2954749,18
"4053","너의 이름은.","2017-01-22","593",97603,3052352,19
"4054","너의 이름은.","2017-01-23","558",40227,3092579,20
"4055","너의 이름은.","2017-01-24","553",41488,3134067,21
"4056","너의 이름은.","2017-01-25","478",39161,3173228,22
"4057","너의 이름은.","2017-01-26","495",39450,3212678,23
"4058","너의 이름은.","2017-01-27","529",53932,3266610,24
"4059","너의 이름은.","2017-01-28","499",45660,3312270,25
"4060","너의 이름은.","2017-01-29","492",55061,3367331,26
"4061","너의 이름은.","2017-01-30","470",58556,3425887,27
"4062","너의 이름은.","2017-01-31","459",28695,3454582,28
"4063","너의 이름은.","2017-02-01","425",17774,3472356,29
"4064","너의 이름은.","2017-02-02","363",13249,3485605,30
"4065","너의 이름은.","2017-02-03","379",15053,3500658,31
"4066","너의 이름은.","2017-02-04","383",28466,3529124,32
"4067","너의 이름은.","2017-02-05","383",25533,3554657,33
"4068","너의 이름은.","2017-02-06","378",8883,3563540,34
"4069","너의 이름은.","2017-02-07","376",10175,3573715,35
"4070","너의 이름은.","2017-02-08","327",9140,3582855,36
"4071","너의 이름은.","2017-02-09","149",5711,3588566,37
"4072","너의 이름은.","2017-02-10","149",4704,3593270,38
"4073","너의 이름은.","2017-02-11","161",12081,3605351,39
"4074","너의 이름은.","2017-02-12","162",9670,3615021,40
"4075","너의 이름은.","2017-02-13","154",3639,3618660,41
"4076","너의 이름은.","2017-02-14","151",4106,3622766,42
"4077","너의 이름은.","2017-02-15","71",1967,3624733,43
"4078","너의 이름은.","2017-02-16","58",1520,3626253,44
"4079","너의 이름은.","2017-02-17","66",2144,3628397,45
"4080","너의 이름은.","2017-02-18","68",3743,3632140,46
"4081","너의 이름은.","2017-02-19","71",3507,3635647,47
"4082","너의 이름은.","2017-02-20","53",1547,3637194,48
"4083","너의 이름은.","2017-02-21","54",1674,3638868,49
"4084","너의 이름은.","2017-02-22","27",903,3639771,50
"4085","너의 이름은.","2017-02-23","25",613,3640384,51
"4086","너의 이름은.","2017-02-24","23",640,3641024,52
"4087","너의 이름은.","2017-02-25","23",1051,3642075,53
"4088","너의 이름은.","2017-02-26","26",1149,3643224,54
"4089","너의 이름은.","2017-02-27","21",682,3643906,55
"4090","너의 이름은.","2017-02-28","22",841,3644747,56
"4091","너의 이름은.","2017-03-01","14",830,3645577,57
"4092","너의 이름은.","2017-03-02","9",181,3645758,58
"4093","너의 이름은.","2017-03-03","11",327,3646085,59
"4094","너의 이름은.","2017-03-04","15",683,3646768,60
"4095","너의 이름은.","2017-03-05","14",677,3647445,61
"4096","너의 이름은.","2017-03-06","11",110,3647555,62
"4097","너의 이름은.","2017-03-07","11",122,3647677,63
"4098","너의 이름은.","2017-03-08","7",102,3647779,64
"4099","너의 이름은.","2017-03-09","6",81,3647860,65
"4100","너의 이름은.","2017-03-10","7",123,3647983,66
"4101","너의 이름은.","2017-03-11","7",375,3648358,67
"4102","너의 이름은.","2017-03-12","8",351,3648709,68
"4103","너의 이름은.","2017-03-13","7",91,3648800,69
"4104","너의 이름은.","2017-03-14","7",73,3648873,70
"4105","너의 이름은.","2017-03-15","7",105,3648978,71
"4106","너의 이름은.","2017-03-16","4",35,3649013,72
"4107","너의 이름은.","2017-03-17","4",47,3649060,73
"4108","너의 이름은.","2017-03-18","8",276,3649336,74
"4109","너의 이름은.","2017-03-19","7",246,3649582,75
"4110","너의 이름은.","2017-03-20","4",38,3649620,76
"4111","너의 이름은.","2017-03-21","5",83,3649703,77
"4112","너의 이름은.","2017-03-22","5",37,3649740,78
"4113","너의 이름은.","2017-03-23","2",31,3649771,79
"4114","너의 이름은.","2017-03-24","3",148,3649919,80
"4115","너의 이름은.","2017-03-25","4",100,3650019,81
"4116","너의 이름은.","2017-03-26","7",296,3650315,82
"4117","너의 이름은.","2017-03-27","2",22,3650337,83
"4118","너의 이름은.","2017-03-28","3",76,3650413,84
"4119","너의 이름은.","2017-03-29","2",23,3650436,85
"4120","너의 이름은.","2017-03-30","2",34,3650470,86
"4121","너의 이름은.","2017-03-31","2",60,3650530,87
"4122","너의 이름은.","2017-04-01","2",109,3650639,88
"4123","너의 이름은.","2017-04-02","2",133,3650772,89
"4124","너의 이름은.","2017-04-03","2",59,3650831,90
"4125","너의 이름은.","2017-04-04","2",32,3650863,91
"4126","너의 이름은.","2017-04-06","1",15,3650878,92
"4127","너의 이름은.","2017-04-07","1",65,3650943,93
"4128","너의 이름은.","2017-04-08","1",51,3650994,94
"4129","너의 이름은.","2017-04-09","2",94,3651088,95
"4130","너의 이름은.","2017-04-10","2",44,3651132,96
"4131","너의 이름은.","2017-04-11","1",5,3651137,97
"4132","너의 이름은.","2017-04-12","1",5,3651142,98
"4133","너의 이름은.","2017-04-13","1",3,3651145,99
"4134","너의 이름은.","2017-04-14","1",7,3651152,100
"4135","너의 이름은.","2017-04-15","2",94,3651246,101
"4136","너의 이름은.","2017-04-16","2",63,3651309,102
"4137","너의 이름은.","2017-04-17","1",4,3651313,103
"4138","너의 이름은.","2017-04-18","1",7,3651320,104
"4139","너의 이름은.","2017-04-19","1",9,3651329,105
"4140","너의 이름은.","2017-04-21","1",19,3651348,106
"4141","너의 이름은.","2017-04-22","1",29,3651377,107
"4142","너의 이름은.","2017-04-23","1",70,3651447,108
"4143","너의 이름은.","2017-04-25","1",0,3651447,109
"4144","너의 이름은.","2017-04-28","2",10,3651457,110
"4145","너의 이름은.","2017-04-29","2",172,3651629,111
"4146","너의 이름은.","2017-04-30","3",165,3651794,112
"4147","너의 이름은.","2017-05-01","1",75,3651869,113
"4148","너의 이름은.","2017-05-03","1",24,3651893,114
"4149","너의 이름은.","2017-05-05","1",84,3651977,115
"4150","너의 이름은.","2017-05-06","1",58,3652035,116
"4151","너의 이름은.","2017-05-07","1",46,3652081,117
"4152","너의 이름은.","2017-05-08","1",23,3652104,118
"4153","너의 이름은.","2017-05-09","1",100,3652204,119
"4154","너의 이름은.","2017-05-10","1",0,3652204,120
"4155","너의 이름은.","2017-05-13","1",58,3652262,121
"4156","너의 이름은.","2017-05-14","1",44,3652306,122
"4157","너의 이름은.","2017-05-19","1",85,3652391,123
"4158","너의 이름은.","2017-05-20","1",42,3652433,124
"4159","너의 이름은.","2017-05-21","1",74,3652507,125
"4160","너의 이름은.","2017-05-25","1",0,3652507,126
"4161","너의 이름은.","2017-05-27","1",50,3652557,127
"4162","너의 이름은.","2017-05-28","1",62,3652619,128
"4163","너의 이름은.","2017-06-03","1",45,3652664,129
"4164","너의 이름은.","2017-06-04","1",37,3652701,130
"4165","너의 이름은.","2017-06-10","1",75,3652776,131
"4166","너의 이름은.","2017-06-11","1",140,3652916,132
"4167","너의 이름은.","2017-06-24","1",97,3653013,133
"4168","너의 이름은.","2017-06-29","1",0,3653013,134
"4169","너의 이름은.","2017-07-11","2",464,3653477,135
"4170","너의 이름은.","2017-07-13","221",1928,3655405,136
"4171","너의 이름은.","2017-07-14","221",1763,3657168,137
"4172","너의 이름은.","2017-07-15","198",4049,3661217,138
"4173","너의 이름은.","2017-07-16","192",3680,3664897,139
"4174","너의 이름은.","2017-07-17","173",940,3665837,140
"4175","너의 이름은.","2017-07-18","173",1074,3666911,141
"4176","너의 이름은.","2017-07-19","136",2914,3669825,142
"4177","너의 이름은.","2017-07-20","19",317,3670142,143
"4178","너의 이름은.","2017-07-21","18",309,3670451,144
"4179","너의 이름은.","2017-07-22","14",348,3670799,145
"4180","너의 이름은.","2017-07-23","16",445,3671244,146
"4181","너의 이름은.","2017-07-24","15",252,3671496,147
"4182","너의 이름은.","2017-07-25","15",251,3671747,148
"4183","너의 이름은.","2017-07-26","24",273,3672020,149
"4184","너의 이름은.","2017-07-27","23",265,3672285,150
"4185","너의 이름은.","2017-07-28","10",129,3672414,151
"4186","너의 이름은.","2017-07-29","8",110,3672524,152
"4187","너의 이름은.","2017-07-30","10",183,3672707,153
"4188","너의 이름은.","2017-07-31","9",103,3672810,154
"4189","너의 이름은.","2017-08-01","9",121,3672931,155
"4190","너의 이름은.","2017-08-02","5",50,3672981,156
"4191","너의 이름은.","2017-08-03","5",50,3673031,157
"4192","너의 이름은.","2017-08-04","5",50,3673081,158
"4193","너의 이름은.","2017-08-05","6",148,3673229,159
"4194","너의 이름은.","2017-08-06","5",25,3673254,160
"4195","너의 이름은.","2017-08-07","5",25,3673279,161
"4196","너의 이름은.","2017-08-08","5",25,3673304,162
"4197","너의 이름은.","2017-08-09","5",25,3673329,163
"4198","너의 이름은.","2017-08-10","5",25,3673354,164
"4199","너의 이름은.","2017-08-11","5",25,3673379,165
"4200","너의 이름은.","2017-08-12","5",25,3673404,166
"4201","너의 이름은.","2017-08-26","1",97,3673501,167
"4202","너의 이름은.","2017-09-01","1",0,3673501,168
"4203","너의 이름은.","2017-09-09","2",29,3673530,169
"4204","너의 이름은.","2017-09-10","2",90,3673620,170
"4205","너의 이름은.","2017-09-16","3",43,3673663,171
"4206","너의 이름은.","2017-09-17","2",43,3673706,172
"4207","너의 이름은.","2017-09-18","1",4,3673710,173
"4208","너의 이름은.","2017-09-23","2",125,3673835,174
"4209","너의 이름은.","2017-09-24","1",40,3673875,175
"4210","너의 이름은.","2017-09-28","1",10,3673885,176
"4211","너의 이름은.","2017-11-04","1",0,3673885,177
"4212","너의 이름은.","2017-11-12","1",37,3673922,178
"4213","너의 이름은.","2017-11-25","2",79,3674001,179
"4214","너의 이름은.","2017-11-28","2",31,3674032,180
"4215","너의 이름은.","2017-12-05","1",100,3674132,181
"4216","너의 이름은.","2017-12-06","1",60,3674192,182
"4217","너의 이름은.","2017-12-08","2",72,3674264,183
"4218","너의 이름은.","2017-12-09","1",54,3674318,184
"4219","너의 이름은.","2017-12-10","1",53,3674371,185
"4220","너의 이름은.","2017-12-20","1",0,3674371,186
"4221","너의 이름은.","2018-01-03","1",32,3674403,187
"4222","너의 이름은.","2018-01-04","115",13070,3687473,188
"4223","너의 이름은.","2018-01-05","121",5519,3692992,189
"4224","너의 이름은.","2018-01-06","120",6225,3699217,190
"4225","너의 이름은.","2018-01-07","116",6018,3705235,191
"4226","너의 이름은.","2018-01-08","68",1100,3706335,192
"4227","너의 이름은.","2018-01-09","78",2591,3708926,193
"4228","너의 이름은.","2018-01-10","60",1139,3710065,194
"4229","너의 이름은.","2018-01-11","4",168,3710233,195
"4230","너의 이름은.","2018-01-12","4",176,3710409,196
"4231","너의 이름은.","2018-01-13","5",271,3710680,197
"4232","너의 이름은.","2018-01-14","6",147,3710827,198
"4233","너의 이름은.","2018-01-15","4",56,3710883,199
"4234","너의 이름은.","2018-01-16","5",116,3710999,200
"4235","너의 이름은.","2018-01-17","4",135,3711134,201
"4236","너의 이름은.","2018-01-18","1",8,3711142,202
"4237","너의 이름은.","2018-01-19","1",9,3711151,203
"4238","너의 이름은.","2018-01-20","1",16,3711167,204
"4239","너의 이름은.","2018-01-21","1",3,3711170,205
"4240","너의 이름은.","2018-01-22","1",6,3711176,206
"4241","너의 이름은.","2018-01-23","2",6,3711182,207
"4242","너의 이름은.","2018-01-24","1",3,3711185,208
"4243","너의 이름은.","2018-01-25","1",9,3711194,209
"4244","너의 이름은.","2018-01-26","1",2,3711196,210
"4245","너의 이름은.","2018-01-27","1",5,3711201,211
"4246","너의 이름은.","2018-01-28","1",13,3711214,212
"4247","너의 이름은.","2018-01-29","1",6,3711220,213
"4248","너의 이름은.","2018-01-30","1",4,3711224,214
"4249","너의 이름은.","2018-01-31","1",1,3711225,215
"4250","너의 이름은.","2018-02-01","1",11,3711236,216
"4251","너의 이름은.","2018-02-02","1",3,3711239,217
"4252","너의 이름은.","2018-02-03","1",2,3711241,218
"4253","너의 이름은.","2018-02-04","1",1,3711242,219
"4254","너의 이름은.","2018-02-05","1",1,3711243,220
"4255","너의 이름은.","2018-02-07","1",2,3711245,221
"4256","너의 이름은.","2018-03-31","1",53,3711298,222
"4257","너의 이름은.","2018-04-18","1",12,3711310,223
"4258","너의 이름은.","2018-06-13","1",65,3711375,224
"4259","너의 이름은.","2018-07-11","1",32,3711407,225
"4260","너의 이름은.","2018-08-15","1",36,3711443,226
"4261","너의 이름은.","2018-08-24","1",15,3711458,227
"4262","너의 이름은.","2018-08-25","1",8,3711466,228
"4263","너의 이름은.","2018-08-27","1",3,3711469,229
"4264","너의 이름은.","2018-09-04","1",6,3711475,230
"4265","너의 이름은.","2018-09-07","1",104,3711579,231
"4266","너의 이름은.","2018-09-08","2",416,3711995,232
"4267","너의 이름은.","2018-09-09","1",432,3712427,233
"4268","너의 이름은.","2018-09-15","1",39,3712466,234
"4269","너의 이름은.","2018-09-20","1",18,3712484,235
"4270","너의 이름은.","2018-09-23","1",50,3712534,236
"4271","너의 이름은.","2018-09-25","1",30,3712564,237
"4272","너의 이름은.","2018-09-28","1",12,3712576,238
"4273","너의 이름은.","2018-10-20","1",1,3712577,239
"4274","너의 이름은.","2018-10-24","1",5,3712582,240
"4275","너의 이름은.","2018-10-27","1",2,3712584,241
"4276","너의 이름은.","2018-11-01","1",6,3712590,242
"4277","너의 이름은.","2018-11-09","1",2,3712592,243
"4278","너의 이름은.","2018-11-13","1",2,3712594,244
"4279","너의 이름은.","2018-11-17","1",0,3712594,245
"4280","너의 이름은.","2018-11-27","1",2,3712596,246
"4281","너의 이름은.","2018-11-29","1",1,3712597,247
"4282","너의 이름은.","2019-01-04","1",56,3712653,248
"4283","너의 이름은.","2019-02-18","1",11,3712664,249
"4284","너의 이름은.","2019-02-25","1",12,3712676,250
"4285","너의 이름은.","2019-03-02","1",126,3712802,251
"4286","너의 이름은.","2019-03-11","1",2,3712804,252
"4287","슈퍼배드 3","2017-07-20","1",274,274,0
"4288","슈퍼배드 3","2017-07-25","4",1096,1370,0
"4289","슈퍼배드 3","2017-07-26","810",195774,197144,1
"4290","슈퍼배드 3","2017-07-27","812",175856,373000,2
"4291","슈퍼배드 3","2017-07-28","875",195260,568260,3
"4292","슈퍼배드 3","2017-07-29","1,029",340504,908764,4
"4293","슈퍼배드 3","2017-07-30","1,057",317075,1225839,5
"4294","슈퍼배드 3","2017-07-31","950",264090,1489929,6
"4295","슈퍼배드 3","2017-08-01","997",242820,1732749,7
"4296","슈퍼배드 3","2017-08-02","844",189977,1922726,8
"4297","슈퍼배드 3","2017-08-03","859",158155,2080881,9
"4298","슈퍼배드 3","2017-08-04","884",143904,2224785,10
"4299","슈퍼배드 3","2017-08-05","914",203999,2428784,11
"4300","슈퍼배드 3","2017-08-06","880",187543,2616327,12
"4301","슈퍼배드 3","2017-08-07","785",75133,2691460,13
"4302","슈퍼배드 3","2017-08-08","783",75391,2766851,14
"4303","슈퍼배드 3","2017-08-09","567",46902,2813753,15
"4304","슈퍼배드 3","2017-08-10","516",40250,2854003,16
"4305","슈퍼배드 3","2017-08-11","531",38090,2892093,17
"4306","슈퍼배드 3","2017-08-12","525",69613,2961706,18
"4307","슈퍼배드 3","2017-08-13","532",66581,3028287,19
"4308","슈퍼배드 3","2017-08-14","505",40123,3068410,20
"4309","슈퍼배드 3","2017-08-15","431",65587,3133997,21
"4310","슈퍼배드 3","2017-08-16","398",18071,3152068,22
"4311","슈퍼배드 3","2017-08-17","346",17107,3169175,23
"4312","슈퍼배드 3","2017-08-18","357",17362,3186537,24
"4313","슈퍼배드 3","2017-08-19","376",31759,3218296,25
"4314","슈퍼배드 3","2017-08-20","370",33539,3251835,26
"4315","슈퍼배드 3","2017-08-21","298",8570,3260405,27
"4316","슈퍼배드 3","2017-08-22","308",9111,3269516,28
"4317","슈퍼배드 3","2017-08-23","218",4930,3274446,29
"4318","슈퍼배드 3","2017-08-24","154",3772,3278218,30
"4319","슈퍼배드 3","2017-08-25","146",2591,3280809,31
"4320","슈퍼배드 3","2017-08-26","222",13178,3293987,32
"4321","슈퍼배드 3","2017-08-27","224",13924,3307911,33
"4322","슈퍼배드 3","2017-08-28","127",1629,3309540,34
"4323","슈퍼배드 3","2017-08-29","125",1762,3311302,35
"4324","슈퍼배드 3","2017-08-30","57",1575,3312877,36
"4325","슈퍼배드 3","2017-08-31","42",1032,3313909,37
"4326","슈퍼배드 3","2017-09-01","40",757,3314666,38
"4327","슈퍼배드 3","2017-09-02","90",3394,3318060,39
"4328","슈퍼배드 3","2017-09-03","95",3697,3321757,40
"4329","슈퍼배드 3","2017-09-04","32",142,3321899,41
"4330","슈퍼배드 3","2017-09-05","28",194,3322093,42
"4331","슈퍼배드 3","2017-09-06","10",59,3322152,43
"4332","슈퍼배드 3","2017-09-07","7",39,3322191,44
"4333","슈퍼배드 3","2017-09-08","6",75,3322266,45
"4334","슈퍼배드 3","2017-09-09","16",424,3322690,46
"4335","슈퍼배드 3","2017-09-10","18",580,3323270,47
"4336","슈퍼배드 3","2017-09-11","9",69,3323339,48
"4337","슈퍼배드 3","2017-09-12","8",65,3323404,49
"4338","슈퍼배드 3","2017-09-13","6",67,3323471,50
"4339","슈퍼배드 3","2017-09-14","6",64,3323535,51
"4340","슈퍼배드 3","2017-09-15","7",139,3323674,52
"4341","슈퍼배드 3","2017-09-16","9",141,3323815,53
"4342","슈퍼배드 3","2017-09-17","9",149,3323964,54
"4343","슈퍼배드 3","2017-09-18","7",64,3324028,55
"4344","슈퍼배드 3","2017-09-19","7",91,3324119,56
"4345","슈퍼배드 3","2017-09-20","8",168,3324287,57
"4346","슈퍼배드 3","2017-09-21","6",66,3324353,58
"4347","슈퍼배드 3","2017-09-22","6",62,3324415,59
"4348","슈퍼배드 3","2017-09-23","8",101,3324516,60
"4349","슈퍼배드 3","2017-09-24","10",142,3324658,61
"4350","슈퍼배드 3","2017-09-25","1",2,3324660,62
"4351","슈퍼배드 3","2017-09-26","2",12,3324672,63
"4352","슈퍼배드 3","2017-09-27","1",4,3324676,64
"4353","슈퍼배드 3","2017-09-28","2",181,3324857,65
"4354","슈퍼배드 3","2017-10-02","1",4,3324861,66
"4355","슈퍼배드 3","2017-12-01","2",13,3324874,67
"4356","캐리비안의 해적: 죽은 자는 말이 없다","2017-05-23","4",1859,1859,0
"4357","캐리비안의 해적: 죽은 자는 말이 없다","2017-05-24","1,357",206541,208400,1
"4358","캐리비안의 해적: 죽은 자는 말이 없다","2017-05-25","1,309",162826,371226,2
"4359","캐리비안의 해적: 죽은 자는 말이 없다","2017-05-26","1,329",220949,592175,3
"4360","캐리비안의 해적: 죽은 자는 말이 없다","2017-05-27","1,324",488214,1080389,4
"4361","캐리비안의 해적: 죽은 자는 말이 없다","2017-05-28","1,314",446266,1526655,5
"4362","캐리비안의 해적: 죽은 자는 말이 없다","2017-05-29","1,204",116006,1642661,6
"4363","캐리비안의 해적: 죽은 자는 말이 없다","2017-05-30","1,212",100048,1742709,7
"4364","캐리비안의 해적: 죽은 자는 말이 없다","2017-05-31","761",122409,1865118,8
"4365","캐리비안의 해적: 죽은 자는 말이 없다","2017-06-01","710",67078,1932196,9
"4366","캐리비안의 해적: 죽은 자는 말이 없다","2017-06-02","722",89719,2021915,10
"4367","캐리비안의 해적: 죽은 자는 말이 없다","2017-06-03","756",215180,2237095,11
"4368","캐리비안의 해적: 죽은 자는 말이 없다","2017-06-04","776",193400,2430495,12
"4369","캐리비안의 해적: 죽은 자는 말이 없다","2017-06-05","732",115760,2546255,13
"4370","캐리비안의 해적: 죽은 자는 말이 없다","2017-06-06","561",140246,2686501,14
"4371","캐리비안의 해적: 죽은 자는 말이 없다","2017-06-07","508",25871,2712372,15
"4372","캐리비안의 해적: 죽은 자는 말이 없다","2017-06-08","461",19365,2731737,16
"4373","캐리비안의 해적: 죽은 자는 말이 없다","2017-06-09","483",28206,2759943,17
"4374","캐리비안의 해적: 죽은 자는 말이 없다","2017-06-10","512",63514,2823457,18
"4375","캐리비안의 해적: 죽은 자는 말이 없다","2017-06-11","506",57959,2881416,19
"4376","캐리비안의 해적: 죽은 자는 말이 없다","2017-06-12","450",15309,2896725,20
"4377","캐리비안의 해적: 죽은 자는 말이 없다","2017-06-13","434",13317,2910042,21
"4378","캐리비안의 해적: 죽은 자는 말이 없다","2017-06-14","449",14569,2924611,22
"4379","캐리비안의 해적: 죽은 자는 말이 없다","2017-06-15","357",8970,2933581,23
"4380","캐리비안의 해적: 죽은 자는 말이 없다","2017-06-16","384",13358,2946939,24
"4381","캐리비안의 해적: 죽은 자는 말이 없다","2017-06-17","396",31722,2978661,25
"4382","캐리비안의 해적: 죽은 자는 말이 없다","2017-06-18","402",28423,3007084,26
"4383","캐리비안의 해적: 죽은 자는 말이 없다","2017-06-19","352",9248,3016332,27
"4384","캐리비안의 해적: 죽은 자는 말이 없다","2017-06-20","344",9168,3025500,28
"4385","캐리비안의 해적: 죽은 자는 말이 없다","2017-06-21","97",2700,3028200,29
"4386","캐리비안의 해적: 죽은 자는 말이 없다","2017-06-22","70",1742,3029942,30
"4387","캐리비안의 해적: 죽은 자는 말이 없다","2017-06-23","71",1819,3031761,31
"4388","캐리비안의 해적: 죽은 자는 말이 없다","2017-06-24","69",3646,3035407,32
"4389","캐리비안의 해적: 죽은 자는 말이 없다","2017-06-25","73",4186,3039593,33
"4390","캐리비안의 해적: 죽은 자는 말이 없다","2017-06-26","72",1823,3041416,34
"4391","캐리비안의 해적: 죽은 자는 말이 없다","2017-06-27","73",2051,3043467,35
"4392","캐리비안의 해적: 죽은 자는 말이 없다","2017-06-28","18",689,3044156,36
"4393","캐리비안의 해적: 죽은 자는 말이 없다","2017-06-29","14",415,3044571,37
"4394","캐리비안의 해적: 죽은 자는 말이 없다","2017-06-30","22",878,3045449,38
"4395","캐리비안의 해적: 죽은 자는 말이 없다","2017-07-01","29",1233,3046682,39
"4396","캐리비안의 해적: 죽은 자는 말이 없다","2017-07-02","28",1146,3047828,40
"4397","캐리비안의 해적: 죽은 자는 말이 없다","2017-07-03","20",472,3048300,41
"4398","캐리비안의 해적: 죽은 자는 말이 없다","2017-07-04","19",504,3048804,42
"4399","캐리비안의 해적: 죽은 자는 말이 없다","2017-07-05","6",54,3048858,43
"4400","캐리비안의 해적: 죽은 자는 말이 없다","2017-07-06","3",61,3048919,44
"4401","캐리비안의 해적: 죽은 자는 말이 없다","2017-07-07","5",96,3049015,45
"4402","캐리비안의 해적: 죽은 자는 말이 없다","2017-07-08","6",215,3049230,46
"4403","캐리비안의 해적: 죽은 자는 말이 없다","2017-07-09","2",118,3049348,47
"4404","캐리비안의 해적: 죽은 자는 말이 없다","2017-07-10","6",88,3049436,48
"4405","캐리비안의 해적: 죽은 자는 말이 없다","2017-07-11","3",56,3049492,49
"4406","캐리비안의 해적: 죽은 자는 말이 없다","2017-07-12","4",58,3049550,50
"4407","캐리비안의 해적: 죽은 자는 말이 없다","2017-07-13","2",17,3049567,51
"4408","캐리비안의 해적: 죽은 자는 말이 없다","2017-07-14","2",21,3049588,52
"4409","캐리비안의 해적: 죽은 자는 말이 없다","2017-07-15","2",29,3049617,53
"4410","캐리비안의 해적: 죽은 자는 말이 없다","2017-07-16","1",4,3049621,54
"4411","캐리비안의 해적: 죽은 자는 말이 없다","2017-07-17","2",20,3049641,55
"4412","캐리비안의 해적: 죽은 자는 말이 없다","2017-07-18","1",18,3049659,56
"4413","캐리비안의 해적: 죽은 자는 말이 없다","2017-07-19","1",96,3049755,57
"4414","캐리비안의 해적: 죽은 자는 말이 없다","2017-07-24","1",139,3049894,58
"4415","덩케르크","2017-07-18","19",3040,3040,0
"4416","덩케르크","2017-07-19","20",2981,6021,0
"4417","덩케르크","2017-07-20","1,252",224242,230263,1
"4418","덩케르크","2017-07-21","1,245",248042,478305,2
"4419","덩케르크","2017-07-22","1,207",460182,938487,3
"4420","덩케르크","2017-07-23","1,181",411132,1349619,4
"4421","덩케르크","2017-07-24","1,135",154426,1504045,5
"4422","덩케르크","2017-07-25","1,153",141556,1645601,6
"4423","덩케르크","2017-07-26","628",97068,1742669,7
"4424","덩케르크","2017-07-27","619",70612,1813281,8
"4425","덩케르크","2017-07-28","602",88910,1902191,9
"4426","덩케르크","2017-07-29","634",142131,2044322,10
"4427","덩케르크","2017-07-30","664",135170,2179492,11
"4428","덩케르크","2017-07-31","669",96408,2275900,12
"4429","덩케르크","2017-08-01","691",89585,2365485,13
"4430","덩케르크","2017-08-02","438",40643,2406128,14
"4431","덩케르크","2017-08-03","432",37230,2443358,15
"4432","덩케르크","2017-08-04","430",41859,2485217,16
"4433","덩케르크","2017-08-05","416",58495,2543712,17
"4434","덩케르크","2017-08-06","412",50096,2593808,18
"4435","덩케르크","2017-08-07","413",27298,2621106,19
"4436","덩케르크","2017-08-08","433",28156,2649262,20
"4437","덩케르크","2017-08-09","163",12309,2661571,21
"4438","덩케르크","2017-08-10","112",10111,2671682,22
"4439","덩케르크","2017-08-11","113",11369,2683051,23
"4440","덩케르크","2017-08-12","117",18052,2701103,24
"4441","덩케르크","2017-08-13","106",15704,2716807,25
"4442","덩케르크","2017-08-14","113",16150,2732957,26
"4443","덩케르크","2017-08-15","62",4592,2737549,27
"4444","덩케르크","2017-08-16","57",2734,2740283,28
"4445","덩케르크","2017-08-17","34",1971,2742254,29
"4446","덩케르크","2017-08-18","37",1825,2744079,30
"4447","덩케르크","2017-08-19","48",3062,2747141,31
"4448","덩케르크","2017-08-20","49",3181,2750322,32
"4449","덩케르크","2017-08-21","46",1722,2752044,33
"4450","덩케르크","2017-08-22","46",1533,2753577,34
"4451","덩케르크","2017-08-23","24",2285,2755862,35
"4452","덩케르크","2017-08-24","19",2255,2758117,36
"4453","덩케르크","2017-08-25","17",2331,2760448,37
"4454","덩케르크","2017-08-26","23",3848,2764296,38
"4455","덩케르크","2017-08-27","21",3237,2767533,39
"4456","덩케르크","2017-08-28","23",2234,2769767,40
"4457","덩케르크","2017-08-29","23",2102,2771869,41
"4458","덩케르크","2017-08-30","8",1189,2773058,42
"4459","덩케르크","2017-08-31","10",1242,2774300,43
"4460","덩케르크","2017-09-01","13",1321,2775621,44
"4461","덩케르크","2017-09-02","13",1713,2777334,45
"4462","덩케르크","2017-09-03","14",1666,2779000,46
"4463","덩케르크","2017-09-04","12",903,2779903,47
"4464","덩케르크","2017-09-05","12",833,2780736,48
"4465","덩케르크","2017-09-06","5",367,2781103,49
"4466","덩케르크","2017-09-07","5",67,2781170,50
"4467","덩케르크","2017-09-08","5",122,2781292,51
"4468","덩케르크","2017-09-09","5",297,2781589,52
"4469","덩케르크","2017-09-10","6",211,2781800,53
"4470","덩케르크","2017-09-11","6",356,2782156,54
"4471","덩케르크","2017-09-12","6",87,2782243,55
"4472","덩케르크","2017-09-13","5",64,2782307,56
"4473","덩케르크","2017-09-14","4",49,2782356,57
"4474","덩케르크","2017-09-15","4",60,2782416,58
"4475","덩케르크","2017-09-16","3",88,2782504,59
"4476","덩케르크","2017-09-17","3",87,2782591,60
"4477","덩케르크","2017-09-18","3",314,2782905,61
"4478","덩케르크","2017-09-19","3",444,2783349,62
"4479","덩케르크","2017-09-20","3",420,2783769,63
"4480","덩케르크","2017-09-21","2",566,2784335,64
"4481","덩케르크","2017-09-22","2",549,2784884,65
"4482","덩케르크","2017-09-23","1",776,2785660,66
"4483","덩케르크","2017-09-24","2",651,2786311,67
"4484","덩케르크","2017-09-25","2",382,2786693,68
"4485","덩케르크","2017-09-26","2",244,2786937,69
"4486","덩케르크","2017-10-23","1",160,2787097,70
"4487","덩케르크","2017-10-24","1",99,2787196,71
"4488","덩케르크","2017-10-25","1",92,2787288,72
"4489","덩케르크","2017-11-01","1",130,2787418,73
"4490","덩케르크","2017-11-05","1",359,2787777,74
"4491","덩케르크","2017-11-20","1",0,2787777,75
"4492","덩케르크","2017-12-02","1",67,2787844,76
"4493","덩케르크","2017-12-10","8",753,2788597,77
"4494","덩케르크","2017-12-15","1",29,2788626,78
"4495","덩케르크","2017-12-17","1",56,2788682,79
"4496","덩케르크","2017-12-20","1",50,2788732,80
"4497","덩케르크","2018-01-19","7",446,2789178,81
"4498","덩케르크","2018-01-20","10",739,2789917,82
"4499","덩케르크","2018-01-21","7",505,2790422,83
"4500","덩케르크","2018-01-26","8",259,2790681,84
"4501","덩케르크","2018-01-27","8",467,2791148,85
"4502","덩케르크","2018-01-28","7",351,2791499,86
"4503","덩케르크","2018-02-08","4",118,2791617,87
"4504","덩케르크","2018-02-09","3",73,2791690,88
"4505","덩케르크","2018-02-12","3",42,2791732,89
"4506","덩케르크","2018-02-13","4",90,2791822,90
"4507","덩케르크","2018-02-14","2",46,2791868,91
"4508","덩케르크","2018-02-15","4",86,2791954,92
"4509","덩케르크","2018-02-17","4",167,2792121,93
"4510","덩케르크","2018-02-18","1",68,2792189,94
"4511","덩케르크","2018-02-21","2",34,2792223,95
"4512","덩케르크","2018-02-22","1",13,2792236,96
"4513","덩케르크","2018-02-23","3",38,2792274,97
"4514","덩케르크","2018-02-25","2",53,2792327,98
"4515","덩케르크","2018-02-26","2",36,2792363,99
"4516","덩케르크","2018-02-28","2",33,2792396,100
"4517","덩케르크","2018-03-01","1",44,2792440,101
"4518","덩케르크","2018-03-02","1",31,2792471,102
"4519","덩케르크","2018-03-05","1",38,2792509,103
"4520","덩케르크","2018-03-07","1",10,2792519,104
"4521","덩케르크","2018-03-09","1",30,2792549,105
"4522","덩케르크","2018-03-12","1",14,2792563,106
"4523","덩케르크","2018-03-13","1",28,2792591,107
"4524","덩케르크","2018-03-15","1",13,2792604,108
"4525","덩케르크","2018-03-18","1",21,2792625,109
"4526","덩케르크","2018-03-21","1",39,2792664,110
"4527","덩케르크","2018-03-22","1",13,2792677,111
"4528","덩케르크","2018-03-23","1",14,2792691,112
"4529","덩케르크","2018-03-27","1",14,2792705,113
"4530","가디언즈 오브 갤럭시 VOL. 2","2017-04-29","1",2,2,0
"4531","가디언즈 오브 갤럭시 VOL. 2","2017-05-01","3",416,418,0
"4532","가디언즈 오브 갤럭시 VOL. 2","2017-05-02","1,033",148071,148489,0
"4533","가디언즈 오브 갤럭시 VOL. 2","2017-05-03","1,166",422412,570901,1
"4534","가디언즈 오브 갤럭시 VOL. 2","2017-05-04","1,154",269106,840007,2
"4535","가디언즈 오브 갤럭시 VOL. 2","2017-05-05","1,218",373681,1213688,3
"4536","가디언즈 오브 갤럭시 VOL. 2","2017-05-06","1,133",286689,1500377,4
"4537","가디언즈 오브 갤럭시 VOL. 2","2017-05-07","1,084",223461,1723838,5
"4538","가디언즈 오브 갤럭시 VOL. 2","2017-05-08","999",102201,1826039,6
"4539","가디언즈 오브 갤럭시 VOL. 2","2017-05-09","748",183247,2009286,7
"4540","가디언즈 오브 갤럭시 VOL. 2","2017-05-10","692",46708,2055994,8
"4541","가디언즈 오브 갤럭시 VOL. 2","2017-05-11","694",43911,2099905,9
"4542","가디언즈 오브 갤럭시 VOL. 2","2017-05-12","683",65437,2165342,10
"4543","가디언즈 오브 갤럭시 VOL. 2","2017-05-13","734",140079,2305421,11
"4544","가디언즈 오브 갤럭시 VOL. 2","2017-05-14","720",120264,2425685,12
"4545","가디언즈 오브 갤럭시 VOL. 2","2017-05-15","672",37940,2463625,13
"4546","가디언즈 오브 갤럭시 VOL. 2","2017-05-16","672",31765,2495390,14
"4547","가디언즈 오브 갤럭시 VOL. 2","2017-05-17","473",21142,2516532,15
"4548","가디언즈 오브 갤럭시 VOL. 2","2017-05-18","465",17631,2534163,16
"4549","가디언즈 오브 갤럭시 VOL. 2","2017-05-19","473",26219,2560382,17
"4550","가디언즈 오브 갤럭시 VOL. 2","2017-05-20","490",54193,2614575,18
"4551","가디언즈 오브 갤럭시 VOL. 2","2017-05-21","498",49239,2663814,19
"4552","가디언즈 오브 갤럭시 VOL. 2","2017-05-22","462",14274,2678088,20
"4553","가디언즈 오브 갤럭시 VOL. 2","2017-05-23","458",12409,2690497,21
"4554","가디언즈 오브 갤럭시 VOL. 2","2017-05-24","242",5708,2696205,22
"4555","가디언즈 오브 갤럭시 VOL. 2","2017-05-25","167",3854,2700059,23
"4556","가디언즈 오브 갤럭시 VOL. 2","2017-05-26","168",5146,2705205,24
"4557","가디언즈 오브 갤럭시 VOL. 2","2017-05-27","145",8768,2713973,25
"4558","가디언즈 오브 갤럭시 VOL. 2","2017-05-28","139",8350,2722323,26
"4559","가디언즈 오브 갤럭시 VOL. 2","2017-05-29","159",3177,2725500,27
"4560","가디언즈 오브 갤럭시 VOL. 2","2017-05-30","155",3192,2728692,28
"4561","가디언즈 오브 갤럭시 VOL. 2","2017-05-31","33",1271,2729963,29
"4562","가디언즈 오브 갤럭시 VOL. 2","2017-06-01","30",511,2730474,30
"4563","가디언즈 오브 갤럭시 VOL. 2","2017-06-02","33",687,2731161,31
"4564","가디언즈 오브 갤럭시 VOL. 2","2017-06-03","25",889,2732050,32
"4565","가디언즈 오브 갤럭시 VOL. 2","2017-06-04","26",994,2733044,33
"4566","가디언즈 오브 갤럭시 VOL. 2","2017-06-05","26",814,2733858,34
"4567","가디언즈 오브 갤럭시 VOL. 2","2017-06-06","7",427,2734285,35
"4568","가디언즈 오브 갤럭시 VOL. 2","2017-06-07","7",154,2734439,36
"4569","가디언즈 오브 갤럭시 VOL. 2","2017-06-08","4",103,2734542,37
"4570","가디언즈 오브 갤럭시 VOL. 2","2017-06-09","3",56,2734598,38
"4571","가디언즈 오브 갤럭시 VOL. 2","2017-06-10","3",177,2734775,39
"4572","가디언즈 오브 갤럭시 VOL. 2","2017-06-11","4",169,2734944,40
"4573","가디언즈 오브 갤럭시 VOL. 2","2017-06-12","4",48,2734992,41
"4574","가디언즈 오브 갤럭시 VOL. 2","2017-06-13","5",114,2735106,42
"4575","가디언즈 오브 갤럭시 VOL. 2","2017-06-14","3",104,2735210,43
"4576","가디언즈 오브 갤럭시 VOL. 2","2017-06-15","1",21,2735231,44
"4577","가디언즈 오브 갤럭시 VOL. 2","2017-06-16","1",20,2735251,45
"4578","가디언즈 오브 갤럭시 VOL. 2","2017-06-17","1",42,2735293,46
"4579","가디언즈 오브 갤럭시 VOL. 2","2017-06-18","1",42,2735335,47
"4580","가디언즈 오브 갤럭시 VOL. 2","2017-06-19","1",24,2735359,48
"4581","가디언즈 오브 갤럭시 VOL. 2","2017-06-20","1",30,2735389,49
"4582","가디언즈 오브 갤럭시 VOL. 2","2017-06-21","1",23,2735412,50
"4583","가디언즈 오브 갤럭시 VOL. 2","2017-06-22","1",44,2735456,51
"4584","가디언즈 오브 갤럭시 VOL. 2","2017-06-23","1",23,2735479,52
"4585","가디언즈 오브 갤럭시 VOL. 2","2017-06-24","1",41,2735520,53
"4586","가디언즈 오브 갤럭시 VOL. 2","2017-06-25","1",73,2735593,54
"4587","가디언즈 오브 갤럭시 VOL. 2","2017-06-26","1",39,2735632,55
"4588","가디언즈 오브 갤럭시 VOL. 2","2017-06-27","1",89,2735721,56
"4589","가디언즈 오브 갤럭시 VOL. 2","2018-10-25","1",2,2735723,57
"4590","가디언즈 오브 갤럭시 VOL. 2","2018-10-26","1",17,2735740,58
"4591","가디언즈 오브 갤럭시 VOL. 2","2018-10-29","1",8,2735748,59
"4592","가디언즈 오브 갤럭시 VOL. 2","2018-10-31","1",18,2735766,60
"4593","가디언즈 오브 갤럭시 VOL. 2","2018-11-01","1",11,2735777,61
"4594","가디언즈 오브 갤럭시 VOL. 2","2018-11-02","1",28,2735805,62
"4595","가디언즈 오브 갤럭시 VOL. 2","2018-11-03","1",65,2735870,63
"4596","가디언즈 오브 갤럭시 VOL. 2","2018-11-04","2",73,2735943,64
"4597","가디언즈 오브 갤럭시 VOL. 2","2018-11-05","1",17,2735960,65
"4598","가디언즈 오브 갤럭시 VOL. 2","2018-11-06","1",52,2736012,66
"4599","가디언즈 오브 갤럭시 VOL. 2","2018-11-07","1",48,2736060,67
"4600","트랜스포머: 최후의 기사","2017-06-20","4",1839,1839,0
"4601","트랜스포머: 최후의 기사","2017-06-21","1,739",285979,287818,1
"4602","트랜스포머: 최후의 기사","2017-06-22","1,711",196749,484567,2
"4603","트랜스포머: 최후의 기사","2017-06-23","1,727",240810,725377,3
"4604","트랜스포머: 최후의 기사","2017-06-24","1,709",540674,1266051,4
"4605","트랜스포머: 최후의 기사","2017-06-25","1,674",484562,1750613,5
"4606","트랜스포머: 최후의 기사","2017-06-26","1,535",101082,1851695,6
"4607","트랜스포머: 최후의 기사","2017-06-27","1,539",79111,1930806,7
"4608","트랜스포머: 최후의 기사","2017-06-28","910",84629,2015435,8
"4609","트랜스포머: 최후의 기사","2017-06-29","859",46591,2062026,9
"4610","트랜스포머: 최후의 기사","2017-06-30","869",63927,2125953,10
"4611","트랜스포머: 최후의 기사","2017-07-01","877",151334,2277287,11
"4612","트랜스포머: 최후의 기사","2017-07-02","894",140851,2418138,12
"4613","트랜스포머: 최후의 기사","2017-07-03","807",31444,2449582,13
"4614","트랜스포머: 최후의 기사","2017-07-04","801",30372,2479954,14
"4615","트랜스포머: 최후의 기사","2017-07-05","392",8739,2488693,15
"4616","트랜스포머: 최후의 기사","2017-07-06","380",8558,2497251,16
"4617","트랜스포머: 최후의 기사","2017-07-07","399",12684,2509935,17
"4618","트랜스포머: 최후의 기사","2017-07-08","401",29332,2539267,18
"4619","트랜스포머: 최후의 기사","2017-07-09","394",27613,2566880,19
"4620","트랜스포머: 최후의 기사","2017-07-10","371",6203,2573083,20
"4621","트랜스포머: 최후의 기사","2017-07-11","382",6793,2579876,21
"4622","트랜스포머: 최후의 기사","2017-07-12","293",4360,2584236,22
"4623","트랜스포머: 최후의 기사","2017-07-13","205",2642,2586878,23
"4624","트랜스포머: 최후의 기사","2017-07-14","212",4027,2590905,24
"4625","트랜스포머: 최후의 기사","2017-07-15","203",8824,2599729,25
"4626","트랜스포머: 최후의 기사","2017-07-16","191",7394,2607123,26
"4627","트랜스포머: 최후의 기사","2017-07-17","188",2084,2609207,27
"4628","트랜스포머: 최후의 기사","2017-07-18","196",2181,2611388,28
"4629","트랜스포머: 최후의 기사","2017-07-19","129",1576,2612964,29
"4630","트랜스포머: 최후의 기사","2017-07-20","5",139,2613103,30
"4631","트랜스포머: 최후의 기사","2017-07-21","8",224,2613327,31
"4632","트랜스포머: 최후의 기사","2017-07-22","7",283,2613610,32
"4633","트랜스포머: 최후의 기사","2017-07-23","9",305,2613915,33
"4634","트랜스포머: 최후의 기사","2017-07-24","9",135,2614050,34
"4635","트랜스포머: 최후의 기사","2017-07-25","8",278,2614328,35
"4636","트랜스포머: 최후의 기사","2017-07-26","1",273,2614601,36
"4637","보스 베이비","2017-04-19","1",326,326,0
"4638","보스 베이비","2017-04-25","3",622,948,0
"4639","보스 베이비","2017-04-26","4",948,1896,0
"4640","보스 베이비","2017-05-01","1",326,2222,0
"4641","보스 베이비","2017-05-03","799",237463,239685,1
"4642","보스 베이비","2017-05-04","863",202935,442620,2
"4643","보스 베이비","2017-05-05","1,116",352637,795257,3
"4644","보스 베이비","2017-05-06","1,033",219836,1015093,4
"4645","보스 베이비","2017-05-07","996",192172,1207265,5
"4646","보스 베이비","2017-05-08","771",48542,1255807,6
"4647","보스 베이비","2017-05-09","764",261424,1517231,7
"4648","보스 베이비","2017-05-10","529",28623,1545854,8
"4649","보스 베이비","2017-05-11","550",27873,1573727,9
"4650","보스 베이비","2017-05-12","579",42863,1616590,10
"4651","보스 베이비","2017-05-13","720",144673,1761263,11
"4652","보스 베이비","2017-05-14","723",160758,1922021,12
"4653","보스 베이비","2017-05-15","558",37848,1959869,13
"4654","보스 베이비","2017-05-16","544",24749,1984618,14
"4655","보스 베이비","2017-05-17","418",16783,2001401,15
"4656","보스 베이비","2017-05-18","419",15057,2016458,16
"4657","보스 베이비","2017-05-19","446",21326,2037784,17
"4658","보스 베이비","2017-05-20","632",84272,2122056,18
"4659","보스 베이비","2017-05-21","645",88138,2210194,19
"4660","보스 베이비","2017-05-22","430",10885,2221079,20
"4661","보스 베이비","2017-05-23","416",9015,2230094,21
"4662","보스 베이비","2017-05-24","309",6424,2236518,22
"4663","보스 베이비","2017-05-25","260",4303,2240821,23
"4664","보스 베이비","2017-05-26","265",5589,2246410,24
"4665","보스 베이비","2017-05-27","493",43734,2290144,25
"4666","보스 베이비","2017-05-28","500",50392,2340536,26
"4667","보스 베이비","2017-05-29","259",4278,2344814,27
"4668","보스 베이비","2017-05-30","262",3937,2348751,28
"4669","보스 베이비","2017-05-31","94",2285,2351036,29
"4670","보스 베이비","2017-06-01","77",1419,2352455,30
"4671","보스 베이비","2017-06-02","81",1493,2353948,31
"4672","보스 베이비","2017-06-03","253",15992,2369940,32
"4673","보스 베이비","2017-06-04","245",16036,2385976,33
"4674","보스 베이비","2017-06-05","114",5674,2391650,34
"4675","보스 베이비","2017-06-06","182",21751,2413401,35
"4676","보스 베이비","2017-06-07","54",658,2414059,36
"4677","보스 베이비","2017-06-08","35",460,2414519,37
"4678","보스 베이비","2017-06-09","33",314,2414833,38
"4679","보스 베이비","2017-06-10","161",8016,2422849,39
"4680","보스 베이비","2017-06-11","166",9872,2432721,40
"4681","보스 베이비","2017-06-12","28",189,2432910,41
"4682","보스 베이비","2017-06-13","28",203,2433113,42
"4683","보스 베이비","2017-06-14","27",405,2433518,43
"4684","보스 베이비","2017-06-15","10",323,2433841,44
"4685","보스 베이비","2017-06-16","7",36,2433877,45
"4686","보스 베이비","2017-06-17","97",4291,2438168,46
"4687","보스 베이비","2017-06-18","101",5160,2443328,47
"4688","보스 베이비","2017-06-19","10",218,2443546,48
"4689","보스 베이비","2017-06-20","12",207,2443753,49
"4690","보스 베이비","2017-06-21","8",117,2443870,50
"4691","보스 베이비","2017-06-22","9",179,2444049,51
"4692","보스 베이비","2017-06-23","8",123,2444172,52
"4693","보스 베이비","2017-06-24","42",1834,2446006,53
"4694","보스 베이비","2017-06-25","47",2702,2448708,54
"4695","보스 베이비","2017-06-26","4",202,2448910,55
"4696","보스 베이비","2017-06-27","3",22,2448932,56
"4697","보스 베이비","2017-06-28","2",25,2448957,57
"4698","보스 베이비","2017-06-29","2",52,2449009,58
"4699","보스 베이비","2017-06-30","3",133,2449142,59
"4700","보스 베이비","2017-07-01","11",506,2449648,60
"4701","보스 베이비","2017-07-02","13",788,2450436,61
"4702","보스 베이비","2017-07-04","2",4,2450440,62
"4703","보스 베이비","2017-07-06","1",20,2450460,63
"4704","보스 베이비","2017-07-07","2",132,2450592,64
"4705","보스 베이비","2017-07-08","11",493,2451085,65
"4706","보스 베이비","2017-07-09","11",457,2451542,66
"4707","보스 베이비","2017-07-10","3",103,2451645,67
"4708","보스 베이비","2017-07-15","1",23,2451668,68
"4709","보스 베이비","2017-07-16","1",31,2451699,69
"4710","보스 베이비","2017-07-17","1",220,2451919,70
"4711","보스 베이비","2017-09-18","1",93,2452012,71
"4712","보스 베이비","2017-09-21","1",201,2452213,72
"4713","보스 베이비","2017-10-13","1",3,2452216,73
"4714","보스 베이비","2017-10-14","1",12,2452228,74
"4715","보스 베이비","2017-10-15","1",10,2452238,75
"4716","보스 베이비","2017-10-17","1",5,2452243,76
"4717","보스 베이비","2017-10-18","1",2,2452245,77
"4718","보스 베이비","2017-12-01","2",0,2452245,78
"4719","모아나","2017-01-05","1",282,282,0
"4720","모아나","2017-01-08","6",910,1192,0
"4721","모아나","2017-01-11","16",3891,5083,0
"4722","모아나","2017-01-12","756",84797,89880,1
"4723","모아나","2017-01-13","795",84390,174270,2
"4724","모아나","2017-01-14","912",243738,418008,3
"4725","모아나","2017-01-15","953",255212,673220,4
"4726","모아나","2017-01-16","780",64650,737870,5
"4727","모아나","2017-01-17","802",76621,814491,6
"4728","모아나","2017-01-18","593",48075,862566,7
"4729","모아나","2017-01-19","605",53001,915567,8
"4730","모아나","2017-01-20","618",48522,964089,9
"4731","모아나","2017-01-21","715",141432,1105521,10
"4732","모아나","2017-01-22","746",145485,1251006,11
"4733","모아나","2017-01-23","637",40440,1291446,12
"4734","모아나","2017-01-24","640",50077,1341523,13
"4735","모아나","2017-01-25","591",45856,1387379,14
"4736","모아나","2017-01-26","571",42954,1430333,15
"4737","모아나","2017-01-27","693",88759,1519092,16
"4738","모아나","2017-01-28","689",83424,1602516,17
"4739","모아나","2017-01-29","708",126246,1728762,18
"4740","모아나","2017-01-30","696",157236,1885998,19
"4741","모아나","2017-01-31","577",47046,1933044,20
"4742","모아나","2017-02-01","520",22344,1955388,21
"4743","모아나","2017-02-02","491",19177,1974565,22
"4744","모아나","2017-02-03","488",19657,1994222,23
"4745","모아나","2017-02-04","562",73943,2068165,24
"4746","모아나","2017-02-05","583",77871,2146036,25
"4747","모아나","2017-02-06","467",11293,2157329,26
"4748","모아나","2017-02-07","478",13612,2170941,27
"4749","모아나","2017-02-08","389",11805,2182746,28
"4750","모아나","2017-02-09","281",7596,2190342,29
"4751","모아나","2017-02-10","285",7735,2198077,30
"4752","모아나","2017-02-11","390",31321,2229398,31
"4753","모아나","2017-02-12","401",34967,2264365,32
"4754","모아나","2017-02-13","278",5571,2269936,33
"4755","모아나","2017-02-14","283",6731,2276667,34
"4756","모아나","2017-02-15","131",3764,2280431,35
"4757","모아나","2017-02-16","69",1821,2282252,36
"4758","모아나","2017-02-17","77",2053,2284305,37
"4759","모아나","2017-02-18","87",5667,2289972,38
"4760","모아나","2017-02-19","85",5953,2295925,39
"4761","모아나","2017-02-20","61",1330,2297255,40
"4762","모아나","2017-02-21","69",1939,2299194,41
"4763","모아나","2017-02-22","21",889,2300083,42
"4764","모아나","2017-02-23","18",611,2300694,43
"4765","모아나","2017-02-24","22",795,2301489,44
"4766","모아나","2017-02-25","30",1568,2303057,45
"4767","모아나","2017-02-26","34",1866,2304923,46
"4768","모아나","2017-02-27","20",649,2305572,47
"4769","모아나","2017-02-28","20",784,2306356,48
"4770","모아나","2017-03-01","16",1339,2307695,49
"4771","모아나","2017-03-02","6",84,2307779,50
"4772","모아나","2017-03-03","5",42,2307821,51
"4773","모아나","2017-03-04","18",560,2308381,52
"4774","모아나","2017-03-05","18",698,2309079,53
"4775","모아나","2017-03-06","4",24,2309103,54
"4776","모아나","2017-03-07","3",9,2309112,55
"4777","모아나","2017-03-08","3",9,2309121,56
"4778","모아나","2017-03-09","3",34,2309155,57
"4779","모아나","2017-03-10","3",48,2309203,58
"4780","모아나","2017-03-11","12",430,2309633,59
"4781","모아나","2017-03-12","10",269,2309902,60
"4782","모아나","2017-03-13","3",10,2309912,61
"4783","모아나","2017-03-14","4",27,2309939,62
"4784","모아나","2017-03-15","3",12,2309951,63
"4785","모아나","2017-03-17","2",18,2309969,64
"4786","모아나","2017-03-18","3",32,2310001,65
"4787","모아나","2017-03-19","2",30,2310031,66
"4788","모아나","2017-03-20","1",3,2310034,67
"4789","모아나","2017-03-21","1",10,2310044,68
"4790","모아나","2017-03-22","1",10,2310054,69
"4791","모아나","2017-10-12","1",2,2310056,70
"4792","모아나","2017-10-13","1",9,2310065,71
"4793","모아나","2017-10-14","1",21,2310086,72
"4794","모아나","2017-10-15","1",26,2310112,73
"4795","모아나","2017-10-16","1",11,2310123,74
"4796","모아나","2017-10-17","1",16,2310139,75
"4797","모아나","2017-10-18","1",12,2310151,76
"4798","모아나","2017-11-02","1",4,2310155,77
"4799","모아나","2017-11-03","1",8,2310163,78
"4800","모아나","2017-11-04","1",8,2310171,79
"4801","모아나","2017-11-05","1",16,2310187,80
"4802","모아나","2017-11-06","1",3,2310190,81
"4803","모아나","2017-11-07","1",11,2310201,82
"4804","모아나","2017-11-08","1",5,2310206,83
"4805","로건","2017-02-23","1",401,401,0
"4806","로건","2017-02-26","1",252,653,0
"4807","로건","2017-02-27","2",378,1031,0
"4808","로건","2017-02-28","831",97994,99025,0
"4809","로건","2017-03-01","849",256255,355280,1
"4810","로건","2017-03-02","817",91603,446883,2
"4811","로건","2017-03-03","852",120875,567758,3
"4812","로건","2017-03-04","926",269110,836868,4
"4813","로건","2017-03-05","954",242997,1079865,5
"4814","로건","2017-03-06","886",87367,1167232,6
"4815","로건","2017-03-07","877",78915,1246147,7
"4816","로건","2017-03-08","822",66647,1312794,8
"4817","로건","2017-03-09","804",58148,1370942,9
"4818","로건","2017-03-10","831",78974,1449916,10
"4819","로건","2017-03-11","899",175967,1625883,11
"4820","로건","2017-03-12","880",145438,1771321,12
"4821","로건","2017-03-13","807",43840,1815161,13
"4822","로건","2017-03-14","815",44292,1859453,14
"4823","로건","2017-03-15","819",39860,1899313,15
"4824","로건","2017-03-16","491",24933,1924246,16
"4825","로건","2017-03-17","492",35023,1959269,17
"4826","로건","2017-03-18","521",69438,2028707,18
"4827","로건","2017-03-19","517",54260,2082967,19
"4828","로건","2017-03-20","508",19285,2102252,20
"4829","로건","2017-03-21","500",17445,2119697,21
"4830","로건","2017-03-22","515",12272,2131969,22
"4831","로건","2017-03-23","212",3778,2135747,23
"4832","로건","2017-03-24","213",5647,2141394,24
"4833","로건","2017-03-25","186",8114,2149508,25
"4834","로건","2017-03-26","174",6243,2155751,26
"4835","로건","2017-03-27","222",3334,2159085,27
"4836","로건","2017-03-28","217",3095,2162180,28
"4837","로건","2017-03-29","34",659,2162839,29
"4838","로건","2017-03-30","27",420,2163259,30
"4839","로건","2017-03-31","25",663,2163922,31
"4840","로건","2017-04-01","22",964,2164886,32
"4841","로건","2017-04-02","21",724,2165610,33
"4842","로건","2017-04-03","26",363,2165973,34
"4843","로건","2017-04-04","24",363,2166336,35
"4844","로건","2017-04-05","7",155,2166491,36
"4845","로건","2017-04-06","6",102,2166593,37
"4846","로건","2017-04-07","5",108,2166701,38
"4847","로건","2017-04-08","6",219,2166920,39
"4848","로건","2017-04-09","6",147,2167067,40
"4849","로건","2017-04-10","5",63,2167130,41
"4850","로건","2017-04-11","10",169,2167299,42
"4851","로건","2017-04-12","6",159,2167458,43
"4852","로건","2017-04-13","5",93,2167551,44
"4853","로건","2017-04-14","5",94,2167645,45
"4854","로건","2017-04-15","5",114,2167759,46
"4855","로건","2017-04-16","5",120,2167879,47
"4856","로건","2017-04-17","5",94,2167973,48
"4857","로건","2017-04-18","4",60,2168033,49
"4858","로건","2017-04-19","5",70,2168103,50
"4859","로건","2017-04-20","3",50,2168153,51
"4860","로건","2017-04-21","3",50,2168203,52
"4861","로건","2017-04-22","3",65,2168268,53
"4862","로건","2017-04-23","3",65,2168333,54
"4863","로건","2017-04-24","3",50,2168383,55
"4864","로건","2017-04-25","3",30,2168413,56
"4865","로건","2017-04-26","2",30,2168443,57
"4866","로건","2017-04-27","2",30,2168473,58
"4867","로건","2017-04-28","3",70,2168543,59
"4868","로건","2017-04-29","2",45,2168588,60
"4869","로건","2017-04-30","2",45,2168633,61
"4870","로건","2017-05-01","3",107,2168740,62
"4871","로건","2017-05-02","2",96,2168836,63
"4872","로건","2017-05-03","2",105,2168941,64
"4873","로건","2017-05-04","2",98,2169039,65
"4874","로건","2017-05-05","1",10,2169049,66
"4875","로건","2017-05-06","1",25,2169074,67
"4876","로건","2017-05-07","1",25,2169099,68
"4877","로건","2017-05-08","1",10,2169109,69
"4878","원더 우먼","2017-05-29","7",2718,2718,0
"4879","원더 우먼","2017-05-30","1",598,3316,0
"4880","원더 우먼","2017-05-31","941",206944,210260,1
"4881","원더 우먼","2017-06-01","913",116912,327172,2
"4882","원더 우먼","2017-06-02","958",154172,481344,3
"4883","원더 우먼","2017-06-03","1,030",356552,837896,4
"4884","원더 우먼","2017-06-04","1,034",320498,1158394,5
"4885","원더 우먼","2017-06-05","996",182781,1341175,6
"4886","원더 우먼","2017-06-06","750",203859,1545034,7
"4887","원더 우먼","2017-06-07","731",42680,1587714,8
"4888","원더 우먼","2017-06-08","598",31667,1619381,9
"4889","원더 우먼","2017-06-09","607",45025,1664406,10
"4890","원더 우먼","2017-06-10","611",103585,1767991,11
"4891","원더 우먼","2017-06-11","604",91939,1859930,12
"4892","원더 우먼","2017-06-12","548",25772,1885702,13
"4893","원더 우먼","2017-06-13","557",23181,1908883,14
"4894","원더 우먼","2017-06-14","550",24765,1933648,15
"4895","원더 우먼","2017-06-15","468",17754,1951402,16
"4896","원더 우먼","2017-06-16","486",24054,1975456,17
"4897","원더 우먼","2017-06-17","510",56027,2031483,18
"4898","원더 우먼","2017-06-18","499",48556,2080039,19
"4899","원더 우먼","2017-06-19","440",14521,2094560,20
"4900","원더 우먼","2017-06-20","441",14509,2109069,21
"4901","원더 우먼","2017-06-21","209",5170,2114239,22
"4902","원더 우먼","2017-06-22","151",3803,2118042,23
"4903","원더 우먼","2017-06-23","150",4629,2122671,24
"4904","원더 우먼","2017-06-24","165",9665,2132336,25
"4905","원더 우먼","2017-06-25","168",9238,2141574,26
"4906","원더 우먼","2017-06-26","169",4136,2145710,27
"4907","원더 우먼","2017-06-27","172",4205,2149915,28
"4908","원더 우먼","2017-06-28","35",1106,2151021,29
"4909","원더 우먼","2017-06-29","29",957,2151978,30
"4910","원더 우먼","2017-06-30","33",1174,2153152,31
"4911","원더 우먼","2017-07-01","47",2668,2155820,32
"4912","원더 우먼","2017-07-02","46",2257,2158077,33
"4913","원더 우먼","2017-07-03","36",877,2158954,34
"4914","원더 우먼","2017-07-04","35",940,2159894,35
"4915","원더 우먼","2017-07-05","9",207,2160101,36
"4916","원더 우먼","2017-07-06","5",33,2160134,37
"4917","원더 우먼","2017-07-07","6",239,2160373,38
"4918","원더 우먼","2017-07-08","2",123,2160496,39
"4919","원더 우먼","2017-07-09","2",101,2160597,40
"4920","원더 우먼","2017-07-10","3",45,2160642,41
"4921","원더 우먼","2017-07-11","4",77,2160719,42
"4922","원더 우먼","2017-07-12","33",505,2161224,43
"4923","원더 우먼","2017-07-13","37",491,2161715,44
"4924","원더 우먼","2017-07-14","34",612,2162327,45
"4925","원더 우먼","2017-07-15","37",1037,2163364,46
"4926","원더 우먼","2017-07-16","35",766,2164130,47
"4927","원더 우먼","2017-07-17","36",389,2164519,48
"4928","원더 우먼","2017-07-18","36",416,2164935,49
"4929","원더 우먼","2017-07-19","24",341,2165276,50
"4930","원더 우먼","2017-07-20","1",15,2165291,51
"4931","원더 우먼","2017-07-21","1",8,2165299,52
"4932","원더 우먼","2017-07-22","1",13,2165312,53
"4933","원더 우먼","2017-07-23","1",18,2165330,54
"4934","원더 우먼","2017-07-24","1",11,2165341,55
"4935","원더 우먼","2017-07-25","1",60,2165401,56
"4936","원더 우먼","2017-09-01","1",0,2165401,57
"4937","겟 아웃","2017-05-11","1",274,274,0
"4938","겟 아웃","2017-05-17","531",92124,92398,1
"4939","겟 아웃","2017-05-18","622",108629,201027,2
"4940","겟 아웃","2017-05-19","740",170206,371233,3
"4941","겟 아웃","2017-05-20","923",333900,705133,4
"4942","겟 아웃","2017-05-21","945",298866,1003999,5
"4943","겟 아웃","2017-05-22","782",99654,1103653,6
"4944","겟 아웃","2017-05-23","796",85896,1189549,7
"4945","겟 아웃","2017-05-24","636",71894,1261443,8
"4946","겟 아웃","2017-05-25","567",58759,1320202,9
"4947","겟 아웃","2017-05-26","596",84409,1404611,10
"4948","겟 아웃","2017-05-27","602",170299,1574910,11
"4949","겟 아웃","2017-05-28","616",147898,1722808,12
"4950","겟 아웃","2017-05-29","563",41046,1763854,13
"4951","겟 아웃","2017-05-30","580",35637,1799491,14
"4952","겟 아웃","2017-05-31","466",39102,1838593,15
"4953","겟 아웃","2017-06-01","434",26331,1864924,16
"4954","겟 아웃","2017-06-02","457",31940,1896864,17
"4955","겟 아웃","2017-06-03","475",61165,1958029,18
"4956","겟 아웃","2017-06-04","474",50722,2008751,19
"4957","겟 아웃","2017-06-05","469",33622,2042373,20
"4958","겟 아웃","2017-06-06","290",30499,2072872,21
"4959","겟 아웃","2017-06-07","280",7052,2079924,22
"4960","겟 아웃","2017-06-08","180",3700,2083624,23
"4961","겟 아웃","2017-06-09","180",4780,2088404,24
"4962","겟 아웃","2017-06-10","180",9887,2098291,25
"4963","겟 아웃","2017-06-11","174",7578,2105869,26
"4964","겟 아웃","2017-06-12","164",2649,2108518,27
"4965","겟 아웃","2017-06-13","167",2334,2110852,28
"4966","겟 아웃","2017-06-14","166",2735,2113587,29
"4967","겟 아웃","2017-06-15","54",1090,2114677,30
"4968","겟 아웃","2017-06-16","62",1568,2116245,31
"4969","겟 아웃","2017-06-17","61",3266,2119511,32
"4970","겟 아웃","2017-06-18","58",2596,2122107,33
"4971","겟 아웃","2017-06-19","60",1104,2123211,34
"4972","겟 아웃","2017-06-20","63",1264,2124475,35
"4973","겟 아웃","2017-06-21","18",372,2124847,36
"4974","겟 아웃","2017-06-22","6",299,2125146,37
"4975","겟 아웃","2017-06-23","7",300,2125446,38
"4976","겟 아웃","2017-06-24","11",962,2126408,39
"4977","겟 아웃","2017-06-25","9",851,2127259,40
"4978","겟 아웃","2017-06-26","9",358,2127617,41
"4979","겟 아웃","2017-06-27","10",397,2128014,42
"4980","겟 아웃","2017-06-28","4",237,2128251,43
"4981","겟 아웃","2017-06-29","5",106,2128357,44
"4982","겟 아웃","2017-06-30","5",215,2128572,45
"4983","겟 아웃","2017-07-01","8",603,2129175,46
"4984","겟 아웃","2017-07-02","6",511,2129686,47
"4985","겟 아웃","2017-07-03","6",201,2129887,48
"4986","겟 아웃","2017-07-04","6",247,2130134,49
"4987","겟 아웃","2017-07-05","4",67,2130201,50
"4988","겟 아웃","2017-07-06","5",92,2130293,51
"4989","겟 아웃","2017-07-07","4",96,2130389,52
"4990","겟 아웃","2017-07-08","2",96,2130485,53
"4991","겟 아웃","2017-07-09","2",59,2130544,54
"4992","겟 아웃","2017-07-10","2",21,2130565,55
"4993","겟 아웃","2017-07-11","4",61,2130626,56
"4994","겟 아웃","2017-07-12","24",542,2131168,57
"4995","겟 아웃","2017-07-13","21",644,2131812,58
"4996","겟 아웃","2017-07-14","38",1121,2132933,59
"4997","겟 아웃","2017-07-15","39",1703,2134636,60
"4998","겟 아웃","2017-07-16","36",1168,2135804,61
"4999","겟 아웃","2017-07-17","45",839,2136643,62
"5000","겟 아웃","2017-07-18","45",801,2137444,63
"5001","겟 아웃","2017-07-19","33",595,2138039,64
"5002","겟 아웃","2017-07-20","1",15,2138054,65
"5003","겟 아웃","2017-07-21","1",31,2138085,66
"5004","겟 아웃","2017-07-23","1",19,2138104,67
"5005","겟 아웃","2017-07-24","1",4,2138108,68
"5006","겟 아웃","2017-07-25","1",12,2138120,69
"5007","겟 아웃","2017-07-26","1",2,2138122,70
"5008","겟 아웃","2017-07-27","1",1,2138123,71
"5009","겟 아웃","2017-07-29","1",9,2138132,72
"5010","겟 아웃","2017-07-30","1",8,2138140,73
"5011","겟 아웃","2017-07-31","1",4,2138144,74
"5012","겟 아웃","2017-08-01","1",2,2138146,75
"5013","겟 아웃","2017-10-26","1",1,2138147,76
"5014","겟 아웃","2017-10-27","1",3,2138150,77
"5015","겟 아웃","2017-10-28","1",4,2138154,78
"5016","겟 아웃","2017-10-29","1",9,2138163,79
"5017","겟 아웃","2017-10-30","1",4,2138167,80
"5018","겟 아웃","2017-11-01","1",7,2138174,81
"5019","겟 아웃","2018-02-08","1",37,2138211,82
"5020","겟 아웃","2018-02-09","3",34,2138245,83
"5021","겟 아웃","2018-02-13","3",22,2138267,84
"5022","겟 아웃","2018-02-14","1",22,2138289,85
"5023","겟 아웃","2018-02-15","3",32,2138321,86
"5024","겟 아웃","2018-02-17","1",14,2138335,87
"5025","겟 아웃","2018-02-19","3",40,2138375,88
"5026","겟 아웃","2018-02-20","1",11,2138386,89
"5027","겟 아웃","2018-02-27","1",14,2138400,90
"5028","겟 아웃","2018-03-02","3",25,2138425,91
"5029","혹성탈출: 종의 전쟁","2017-07-31","1",406,406,0
"5030","혹성탈출: 종의 전쟁","2017-08-04","2",283,689,0
"5031","혹성탈출: 종의 전쟁","2017-08-07","17",2250,2939,0
"5032","혹성탈출: 종의 전쟁","2017-08-08","5",873,3812,0
"5033","혹성탈출: 종의 전쟁","2017-08-09","4",1289,5101,0
"5034","혹성탈출: 종의 전쟁","2017-08-10","1",192,5293,0
"5035","혹성탈출: 종의 전쟁","2017-08-11","1",624,5917,0
"5036","혹성탈출: 종의 전쟁","2017-08-14","2",506,6423,0
"5037","혹성탈출: 종의 전쟁","2017-08-15","1,017",568300,574723,1
"5038","혹성탈출: 종의 전쟁","2017-08-16","949",159615,734338,2
"5039","혹성탈출: 종의 전쟁","2017-08-17","884",123106,857444,3
"5040","혹성탈출: 종의 전쟁","2017-08-18","896",139589,997033,4
"5041","혹성탈출: 종의 전쟁","2017-08-19","835",283205,1280238,5
"5042","혹성탈출: 종의 전쟁","2017-08-20","833",260675,1540913,6
"5043","혹성탈출: 종의 전쟁","2017-08-21","755",71141,1612054,7
"5044","혹성탈출: 종의 전쟁","2017-08-22","764",61048,1673102,8
"5045","혹성탈출: 종의 전쟁","2017-08-23","553",36577,1709679,9
"5046","혹성탈출: 종의 전쟁","2017-08-24","526",34575,1744254,10
"5047","혹성탈출: 종의 전쟁","2017-08-25","518",40216,1784470,11
"5048","혹성탈출: 종의 전쟁","2017-08-26","525",85862,1870332,12
"5049","혹성탈출: 종의 전쟁","2017-08-27","507",76457,1946789,13
"5050","혹성탈출: 종의 전쟁","2017-08-28","487",21369,1968158,14
"5051","혹성탈출: 종의 전쟁","2017-08-29","489",20027,1988185,15
"5052","혹성탈출: 종의 전쟁","2017-08-30","242",10861,1999046,16
"5053","혹성탈출: 종의 전쟁","2017-08-31","204",5613,2004659,17
"5054","혹성탈출: 종의 전쟁","2017-09-01","202",6537,2011196,18
"5055","혹성탈출: 종의 전쟁","2017-09-02","210",13597,2024793,19
"5056","혹성탈출: 종의 전쟁","2017-09-03","212",12154,2036947,20
"5057","혹성탈출: 종의 전쟁","2017-09-04","189",3185,2040132,21
"5058","혹성탈출: 종의 전쟁","2017-09-05","185",2752,2042884,22
"5059","혹성탈출: 종의 전쟁","2017-09-06","53",982,2043866,23
"5060","혹성탈출: 종의 전쟁","2017-09-07","44",795,2044661,24
"5061","혹성탈출: 종의 전쟁","2017-09-08","41",592,2045253,25
"5062","혹성탈출: 종의 전쟁","2017-09-09","47",1552,2046805,26
"5063","혹성탈출: 종의 전쟁","2017-09-10","42",1495,2048300,27
"5064","혹성탈출: 종의 전쟁","2017-09-11","34",429,2048729,28
"5065","혹성탈출: 종의 전쟁","2017-09-12","36",336,2049065,29
"5066","혹성탈출: 종의 전쟁","2017-09-13","30",237,2049302,30
"5067","혹성탈출: 종의 전쟁","2017-09-14","2",45,2049347,31
"5068","혹성탈출: 종의 전쟁","2017-09-15","2",44,2049391,32
"5069","혹성탈출: 종의 전쟁","2017-09-16","3",135,2049526,33
"5070","혹성탈출: 종의 전쟁","2017-09-17","3",99,2049625,34
"5071","혹성탈출: 종의 전쟁","2017-09-18","1",10,2049635,35
"5072","혹성탈출: 종의 전쟁","2017-09-19","2",14,2049649,36
"5073","혹성탈출: 종의 전쟁","2017-09-20","3",116,2049765,37
"5074","혹성탈출: 종의 전쟁","2017-09-21","1",10,2049775,38
"5075","혹성탈출: 종의 전쟁","2017-09-22","1",10,2049785,39
"5076","혹성탈출: 종의 전쟁","2017-09-23","1",25,2049810,40
"5077","혹성탈출: 종의 전쟁","2017-09-24","1",25,2049835,41
"5078","혹성탈출: 종의 전쟁","2017-09-25","1",10,2049845,42
"5079","혹성탈출: 종의 전쟁","2017-09-26","5",90,2049935,43
"5080","혹성탈출: 종의 전쟁","2017-09-27","5",90,2050025,44
"5081","혹성탈출: 종의 전쟁","2017-09-28","5",90,2050115,45
"5082","혹성탈출: 종의 전쟁","2017-09-29","5",90,2050205,46
"5083","혹성탈출: 종의 전쟁","2017-09-30","5",120,2050325,47
"5084","혹성탈출: 종의 전쟁","2017-10-01","5",120,2050445,48
"5085","혹성탈출: 종의 전쟁","2017-10-02","5",90,2050535,49
"5086","혹성탈출: 종의 전쟁","2017-10-03","4",60,2050595,50
"5087","혹성탈출: 종의 전쟁","2017-10-04","4",60,2050655,51
"5088","혹성탈출: 종의 전쟁","2017-10-05","4",60,2050715,52
"5089","혹성탈출: 종의 전쟁","2017-10-06","4",60,2050775,53
"5090","혹성탈출: 종의 전쟁","2017-10-07","4",90,2050865,54
"5091","혹성탈출: 종의 전쟁","2017-10-08","4",90,2050955,55
"5092","혹성탈출: 종의 전쟁","2017-10-09","4",60,2051015,56
"5093","혹성탈출: 종의 전쟁","2017-10-10","2",20,2051035,57
"5094","혹성탈출: 종의 전쟁","2017-10-11","2",20,2051055,58
"5095","혹성탈출: 종의 전쟁","2017-10-12","2",20,2051075,59
"5096","혹성탈출: 종의 전쟁","2017-10-13","2",20,2051095,60
"5097","혹성탈출: 종의 전쟁","2017-10-14","2",50,2051145,61
"5098","혹성탈출: 종의 전쟁","2017-10-15","2",50,2051195,62
"5099","혹성탈출: 종의 전쟁","2017-10-16","2",20,2051215,63
"5100","혹성탈출: 종의 전쟁","2017-10-17","1",10,2051225,64
"5101","혹성탈출: 종의 전쟁","2017-10-18","1",10,2051235,65
"5102","혹성탈출: 종의 전쟁","2017-10-19","1",10,2051245,66
"5103","혹성탈출: 종의 전쟁","2017-10-20","1",10,2051255,67
"5104","혹성탈출: 종의 전쟁","2017-10-21","1",25,2051280,68
"5105","혹성탈출: 종의 전쟁","2017-10-22","1",25,2051305,69
"5106","혹성탈출: 종의 전쟁","2017-10-23","1",10,2051315,70
"5107","애나벨 : 인형의 주인","2017-08-02","9",3051,3051,0
"5108","애나벨 : 인형의 주인","2017-08-07","1",208,3259,0
"5109","애나벨 : 인형의 주인","2017-08-08","4",895,4154,0
"5110","애나벨 : 인형의 주인","2017-08-09","492",24864,29018,0
"5111","애나벨 : 인형의 주인","2017-08-10","593",154719,183737,1
"5112","애나벨 : 인형의 주인","2017-08-11","742",197805,381542,2
"5113","애나벨 : 인형의 주인","2017-08-12","947",281643,663185,3
"5114","애나벨 : 인형의 주인","2017-08-13","1,006",271589,934774,4
"5115","애나벨 : 인형의 주인","2017-08-14","922",210169,1144943,5
"5116","애나벨 : 인형의 주인","2017-08-15","742",208675,1353618,6
"5117","애나벨 : 인형의 주인","2017-08-16","672",90651,1444269,7
"5118","애나벨 : 인형의 주인","2017-08-17","546",57319,1501588,8
"5119","애나벨 : 인형의 주인","2017-08-18","525",64836,1566424,9
"5120","애나벨 : 인형의 주인","2017-08-19","549",106304,1672728,10
"5121","애나벨 : 인형의 주인","2017-08-20","539",80878,1753606,11
"5122","애나벨 : 인형의 주인","2017-08-21","478",30339,1783945,12
"5123","애나벨 : 인형의 주인","2017-08-22","483",25768,1809713,13
"5124","애나벨 : 인형의 주인","2017-08-23","316",14462,1824175,14
"5125","애나벨 : 인형의 주인","2017-08-24","246",10793,1834968,15
"5126","애나벨 : 인형의 주인","2017-08-25","253",14838,1849806,16
"5127","애나벨 : 인형의 주인","2017-08-26","265",27008,1876814,17
"5128","애나벨 : 인형의 주인","2017-08-27","260",21123,1897937,18
"5129","애나벨 : 인형의 주인","2017-08-28","248",7541,1905478,19
"5130","애나벨 : 인형의 주인","2017-08-29","253",6727,1912205,20
"5131","애나벨 : 인형의 주인","2017-08-30","99",3934,1916139,21
"5132","애나벨 : 인형의 주인","2017-08-31","81",1910,1918049,22
"5133","애나벨 : 인형의 주인","2017-09-01","85",2777,1920826,23
"5134","애나벨 : 인형의 주인","2017-09-02","94",5707,1926533,24
"5135","애나벨 : 인형의 주인","2017-09-03","89",3888,1930421,25
"5136","애나벨 : 인형의 주인","2017-09-04","79",1253,1931674,26
"5137","애나벨 : 인형의 주인","2017-09-05","81",1163,1932837,27
"5138","애나벨 : 인형의 주인","2017-09-06","11",113,1932950,28
"5139","애나벨 : 인형의 주인","2017-09-07","10",117,1933067,29
"5140","애나벨 : 인형의 주인","2017-09-08","10",184,1933251,30
"5141","애나벨 : 인형의 주인","2017-09-09","11",239,1933490,31
"5142","애나벨 : 인형의 주인","2017-09-10","11",314,1933804,32
"5143","애나벨 : 인형의 주인","2017-09-11","10",85,1933889,33
"5144","애나벨 : 인형의 주인","2017-09-12","10",95,1933984,34
"5145","애나벨 : 인형의 주인","2017-09-13","9",31,1934015,35
"5146","애나벨 : 인형의 주인","2017-09-14","4",12,1934027,36
"5147","애나벨 : 인형의 주인","2017-09-15","6",55,1934082,37
"5148","애나벨 : 인형의 주인","2017-09-16","4",48,1934130,38
"5149","애나벨 : 인형의 주인","2017-09-17","4",33,1934163,39
"5150","애나벨 : 인형의 주인","2017-09-18","4",14,1934177,40
"5151","애나벨 : 인형의 주인","2017-09-19","3",6,1934183,41
"5152","애나벨 : 인형의 주인","2017-09-20","2",9,1934192,42
"5153","애나벨 : 인형의 주인","2017-10-26","1",8,1934200,43
"5154","애나벨 : 인형의 주인","2017-10-27","1",4,1934204,44
"5155","애나벨 : 인형의 주인","2017-10-28","1",11,1934215,45
"5156","애나벨 : 인형의 주인","2017-10-30","1",5,1934220,46
"5157","애나벨 : 인형의 주인","2017-10-31","2",27,1934247,47
"5158","애나벨 : 인형의 주인","2017-11-01","1",9,1934256,48
"5159","애나벨 : 인형의 주인","2017-11-16","1",4,1934260,49
"5160","애나벨 : 인형의 주인","2017-11-17","1",2,1934262,50
"5161","애나벨 : 인형의 주인","2017-11-18","1",2,1934264,51
"5162","애나벨 : 인형의 주인","2017-11-21","1",6,1934270,52
"5163","저스티스 리그","2017-11-13","5",1858,1858,0
"5164","저스티스 리그","2017-11-14","1",235,2093,0
"5165","저스티스 리그","2017-11-15","1,192",153553,155646,1
"5166","저스티스 리그","2017-11-16","1,261",164133,319779,2
"5167","저스티스 리그","2017-11-17","1,308",183255,503034,3
"5168","저스티스 리그","2017-11-18","1,260",347934,850968,4
"5169","저스티스 리그","2017-11-19","1,237",290944,1141912,5
"5170","저스티스 리그","2017-11-20","1,168",72978,1214890,6
"5171","저스티스 리그","2017-11-21","1,174",60926,1275816,7
"5172","저스티스 리그","2017-11-22","730",44903,1320719,8
"5173","저스티스 리그","2017-11-23","718",42378,1363097,9
"5174","저스티스 리그","2017-11-24","730",49980,1413077,10
"5175","저스티스 리그","2017-11-25","747",109039,1522116,11
"5176","저스티스 리그","2017-11-26","727",99253,1621369,12
"5177","저스티스 리그","2017-11-27","656",23350,1644719,13
"5178","저스티스 리그","2017-11-28","676",22695,1667414,14
"5179","저스티스 리그","2017-11-29","464",20511,1687925,15
"5180","저스티스 리그","2017-11-30","423",10825,1698750,16
"5181","저스티스 리그","2017-12-01","416",11719,1710469,17
"5182","저스티스 리그","2017-12-02","413",23699,1734168,18
"5183","저스티스 리그","2017-12-03","404",20412,1754580,19
"5184","저스티스 리그","2017-12-04","374",5030,1759610,20
"5185","저스티스 리그","2017-12-05","372",5298,1764908,21
"5186","저스티스 리그","2017-12-06","361",4707,1769615,22
"5187","저스티스 리그","2017-12-07","126",1638,1771253,23
"5188","저스티스 리그","2017-12-08","141",2986,1774239,24
"5189","저스티스 리그","2017-12-09","124",4279,1778518,25
"5190","저스티스 리그","2017-12-10","113",3293,1781811,26
"5191","저스티스 리그","2017-12-11","109",1098,1782909,27
"5192","저스티스 리그","2017-12-12","104",1313,1784222,28
"5193","저스티스 리그","2017-12-13","110",1698,1785920,29
"5194","저스티스 리그","2017-12-14","2",139,1786059,30
"5195","저스티스 리그","2017-12-15","4",67,1786126,31
"5196","저스티스 리그","2017-12-16","8",121,1786247,32
"5197","저스티스 리그","2017-12-17","7",29,1786276,33
"5198","저스티스 리그","2017-12-18","6",32,1786308,34
"5199","저스티스 리그","2017-12-19","6",23,1786331,35
"5200","저스티스 리그","2017-12-20","4",4,1786335,36
"5201","저스티스 리그","2017-12-21","5",5,1786340,37
"5202","저스티스 리그","2017-12-22","5",5,1786345,38
"5203","저스티스 리그","2017-12-23","5",5,1786350,39
"5204","저스티스 리그","2017-12-24","5",5,1786355,40
"5205","저스티스 리그","2017-12-25","5",5,1786360,41
"5206","저스티스 리그","2017-12-26","5",5,1786365,42
"5207","저스티스 리그","2017-12-27","5",5,1786370,43
"5208","저스티스 리그","2017-12-28","3",3,1786373,44
"5209","저스티스 리그","2017-12-29","4",4,1786377,45
"5210","저스티스 리그","2017-12-30","3",3,1786380,46
"5211","저스티스 리그","2017-12-31","3",3,1786383,47
"5212","저스티스 리그","2018-01-01","3",3,1786386,48
"5213","킬러의 보디가드","2017-08-24","1",242,242,0
"5214","킬러의 보디가드","2017-08-25","1",120,362,0
"5215","킬러의 보디가드","2017-08-26","40",8471,8833,0
"5216","킬러의 보디가드","2017-08-27","33",7243,16076,0
"5217","킬러의 보디가드","2017-08-30","380",123601,139677,1
"5218","킬러의 보디가드","2017-08-31","358",81197,220874,2
"5219","킬러의 보디가드","2017-09-01","401",116881,337755,3
"5220","킬러의 보디가드","2017-09-02","462",227264,565019,4
"5221","킬러의 보디가드","2017-09-03","482",211918,776937,5
"5222","킬러의 보디가드","2017-09-04","415",71847,848784,6
"5223","킬러의 보디가드","2017-09-05","424",61543,910327,7
"5224","킬러의 보디가드","2017-09-06","320",47739,958066,8
"5225","킬러의 보디가드","2017-09-07","333",40073,998139,9
"5226","킬러의 보디가드","2017-09-08","344",58037,1056176,10
"5227","킬러의 보디가드","2017-09-09","378",113705,1169881,11
"5228","킬러의 보디가드","2017-09-10","368",103546,1273427,12
"5229","킬러의 보디가드","2017-09-11","319",34320,1307747,13
"5230","킬러의 보디가드","2017-09-12","326",28309,1336056,14
"5231","킬러의 보디가드","2017-09-13","334",26383,1362439,15
"5232","킬러의 보디가드","2017-09-14","206",17280,1379719,16
"5233","킬러의 보디가드","2017-09-15","211",23959,1403678,17
"5234","킬러의 보디가드","2017-09-16","234",49277,1452955,18
"5235","킬러의 보디가드","2017-09-17","235",43443,1496398,19
"5236","킬러의 보디가드","2017-09-18","218",13193,1509591,20
"5237","킬러의 보디가드","2017-09-19","225",11761,1521352,21
"5238","킬러의 보디가드","2017-09-20","232",12330,1533682,22
"5239","킬러의 보디가드","2017-09-21","173",8062,1541744,23
"5240","킬러의 보디가드","2017-09-22","188",11434,1553178,24
"5241","킬러의 보디가드","2017-09-23","216",22896,1576074,25
"5242","킬러의 보디가드","2017-09-24","211",21145,1597219,26
"5243","킬러의 보디가드","2017-09-25","184",6442,1603661,27
"5244","킬러의 보디가드","2017-09-26","190",5825,1609486,28
"5245","킬러의 보디가드","2017-09-27","162",3500,1612986,29
"5246","킬러의 보디가드","2017-09-28","146",2214,1615200,30
"5247","킬러의 보디가드","2017-09-29","150",4733,1619933,31
"5248","킬러의 보디가드","2017-09-30","156",11693,1631626,32
"5249","킬러의 보디가드","2017-10-01","162",14014,1645640,33
"5250","킬러의 보디가드","2017-10-02","169",13216,1658856,34
"5251","킬러의 보디가드","2017-10-03","114",8312,1667168,35
"5252","킬러의 보디가드","2017-10-04","114",10860,1678028,36
"5253","킬러의 보디가드","2017-10-05","112",10780,1688808,37
"5254","킬러의 보디가드","2017-10-06","120",9290,1698098,38
"5255","킬러의 보디가드","2017-10-07","115",6328,1704426,39
"5256","킬러의 보디가드","2017-10-08","104",5286,1709712,40
"5257","킬러의 보디가드","2017-10-09","93",4557,1714269,41
"5258","킬러의 보디가드","2017-10-10","94",1000,1715269,42
"5259","킬러의 보디가드","2017-10-11","98",1060,1716329,43
"5260","킬러의 보디가드","2017-10-12","71",439,1716768,44
"5261","킬러의 보디가드","2017-10-13","70",673,1717441,45
"5262","킬러의 보디가드","2017-10-14","68",1221,1718662,46
"5263","킬러의 보디가드","2017-10-15","67",1218,1719880,47
"5264","킬러의 보디가드","2017-10-16","67",358,1720238,48
"5265","킬러의 보디가드","2017-10-17","62",354,1720592,49
"5266","킬러의 보디가드","2017-10-18","61",373,1720965,50
"5267","킬러의 보디가드","2017-10-19","11",40,1721005,51
"5268","킬러의 보디가드","2017-10-20","20",114,1721119,52
"5269","킬러의 보디가드","2017-10-21","25",224,1721343,53
"5270","킬러의 보디가드","2017-10-22","24",186,1721529,54
"5271","킬러의 보디가드","2017-10-23","20",67,1721596,55
"5272","킬러의 보디가드","2017-10-24","20",123,1721719,56
"5273","킬러의 보디가드","2017-10-25","4",4,1721723,57
"5274","킬러의 보디가드","2017-10-26","5",5,1721728,58
"5275","킬러의 보디가드","2017-10-27","5",5,1721733,59
"5276","킬러의 보디가드","2017-10-28","5",5,1721738,60
"5277","킬러의 보디가드","2017-10-29","5",5,1721743,61
"5278","킬러의 보디가드","2017-10-30","3",3,1721746,62
"5279","킬러의 보디가드","2017-10-31","3",3,1721749,63
"5280","킬러의 보디가드","2017-11-01","3",3,1721752,64
"5281","킬러의 보디가드","2017-11-02","4",4,1721756,65
"5282","킬러의 보디가드","2017-11-03","1",1,1721757,66
"5283","킬러의 보디가드","2017-12-29","1",0,1721757,67
"5284","킬러의 보디가드","2018-06-07","1",8,1721765,68
"5285","킬러의 보디가드","2018-06-18","1",7,1721772,69
"5286","킬러의 보디가드","2018-11-20","1",52,1721824,70
"5287","콩: 스컬 아일랜드","2017-02-23","1",326,326,0
"5288","콩: 스컬 아일랜드","2017-02-27","8",3263,3589,0
"5289","콩: 스컬 아일랜드","2017-02-28","1",195,3784,0
"5290","콩: 스컬 아일랜드","2017-03-06","2",264,4048,0
"5291","콩: 스컬 아일랜드","2017-03-07","4",970,5018,0
"5292","콩: 스컬 아일랜드","2017-03-08","780",93804,98822,1
"5293","콩: 스컬 아일랜드","2017-03-09","821",89323,188145,2
"5294","콩: 스컬 아일랜드","2017-03-10","846",120878,309023,3
"5295","콩: 스컬 아일랜드","2017-03-11","984",365391,674414,4
"5296","콩: 스컬 아일랜드","2017-03-12","984",336936,1011350,5
"5297","콩: 스컬 아일랜드","2017-03-13","874",64860,1076210,6
"5298","콩: 스컬 아일랜드","2017-03-14","893",63930,1140140,7
"5299","콩: 스컬 아일랜드","2017-03-15","899",55370,1195510,8
"5300","콩: 스컬 아일랜드","2017-03-16","619",36007,1231517,9
"5301","콩: 스컬 아일랜드","2017-03-17","641",51534,1283051,10
"5302","콩: 스컬 아일랜드","2017-03-18","644",141266,1424317,11
"5303","콩: 스컬 아일랜드","2017-03-19","630",124872,1549189,12
"5304","콩: 스컬 아일랜드","2017-03-20","589",24550,1573739,13
"5305","콩: 스컬 아일랜드","2017-03-21","594",21644,1595383,14
"5306","콩: 스컬 아일랜드","2017-03-22","609",14507,1609890,15
"5307","콩: 스컬 아일랜드","2017-03-23","386",5696,1615586,16
"5308","콩: 스컬 아일랜드","2017-03-24","387",8564,1624150,17
"5309","콩: 스컬 아일랜드","2017-03-25","399",25654,1649804,18
"5310","콩: 스컬 아일랜드","2017-03-26","391",24466,1674270,19
"5311","콩: 스컬 아일랜드","2017-03-27","337",4034,1678304,20
"5312","콩: 스컬 아일랜드","2017-03-28","346",3668,1681972,21
"5313","콩: 스컬 아일랜드","2017-03-29","89",1174,1683146,22
"5314","콩: 스컬 아일랜드","2017-03-30","73",1039,1684185,23
"5315","콩: 스컬 아일랜드","2017-03-31","72",776,1684961,24
"5316","콩: 스컬 아일랜드","2017-04-01","70",1982,1686943,25
"5317","콩: 스컬 아일랜드","2017-04-02","70",2033,1688976,26
"5318","콩: 스컬 아일랜드","2017-04-03","64",321,1689297,27
"5319","콩: 스컬 아일랜드","2017-04-04","58",347,1689644,28
"5320","콩: 스컬 아일랜드","2017-04-05","5",56,1689700,29
"5321","콩: 스컬 아일랜드","2017-04-07","2",2,1689702,30
"5322","콩: 스컬 아일랜드","2017-04-08","2",2,1689704,31
"5323","콩: 스컬 아일랜드","2017-04-09","2",2,1689706,32
"5324","콩: 스컬 아일랜드","2017-04-10","2",2,1689708,33
"5325","콩: 스컬 아일랜드","2017-04-11","2",2,1689710,34
"5326","콩: 스컬 아일랜드","2017-04-12","2",2,1689712,35
"5327","콩: 스컬 아일랜드","2017-04-13","2",2,1689714,36
"5328","콩: 스컬 아일랜드","2017-04-14","1",1,1689715,37
"5329","콩: 스컬 아일랜드","2017-04-15","1",1,1689716,38
"5330","콩: 스컬 아일랜드","2017-04-16","1",1,1689717,39
"5331","콩: 스컬 아일랜드","2017-04-25","1",0,1689717,40
"5332","23 아이덴티티","2017-02-14","1",274,274,0
"5333","23 아이덴티티","2017-02-22","503",137005,137279,1
"5334","23 아이덴티티","2017-02-23","651",130784,268063,2
"5335","23 아이덴티티","2017-02-24","831",150119,418182,3
"5336","23 아이덴티티","2017-02-25","952",283621,701803,4
"5337","23 아이덴티티","2017-02-26","934",265101,966904,5
"5338","23 아이덴티티","2017-02-27","799",113233,1080137,6
"5339","23 아이덴티티","2017-02-28","841",116555,1196692,7
"5340","23 아이덴티티","2017-03-01","540",119402,1316094,8
"5341","23 아이덴티티","2017-03-02","505",32123,1348217,9
"5342","23 아이덴티티","2017-03-03","499",36224,1384441,10
"5343","23 아이덴티티","2017-03-04","539",77733,1462174,11
"5344","23 아이덴티티","2017-03-05","525",65168,1527342,12
"5345","23 아이덴티티","2017-03-06","469",18765,1546107,13
"5346","23 아이덴티티","2017-03-07","470",16504,1562611,14
"5347","23 아이덴티티","2017-03-08","396",11348,1573959,15
"5348","23 아이덴티티","2017-03-09","357",9442,1583401,16
"5349","23 아이덴티티","2017-03-10","361",11908,1595309,17
"5350","23 아이덴티티","2017-03-11","400",28415,1623724,18
"5351","23 아이덴티티","2017-03-12","398",23740,1647464,19
"5352","23 아이덴티티","2017-03-13","361",6510,1653974,20
"5353","23 아이덴티티","2017-03-14","371",6632,1660606,21
"5354","23 아이덴티티","2017-03-15","376",6130,1666736,22
"5355","23 아이덴티티","2017-03-16","73",1098,1667834,23
"5356","23 아이덴티티","2017-03-17","79",1474,1669308,24
"5357","23 아이덴티티","2017-03-18","64",2631,1671939,25
"5358","23 아이덴티티","2017-03-19","70",1951,1673890,26
"5359","23 아이덴티티","2017-03-20","79",764,1674654,27
"5360","23 아이덴티티","2017-03-21","75",752,1675406,28
"5361","23 아이덴티티","2017-03-22","38",313,1675719,29
"5362","23 아이덴티티","2017-03-23","2",9,1675728,30
"5363","23 아이덴티티","2017-03-24","2",19,1675747,31
"5364","23 아이덴티티","2017-03-25","2",17,1675764,32
"5365","23 아이덴티티","2017-03-26","2",21,1675785,33
"5366","23 아이덴티티","2017-03-28","1",13,1675798,34
"5367","23 아이덴티티","2017-10-26","1",1,1675799,35
"5368","23 아이덴티티","2017-10-27","1",2,1675801,36
"5369","23 아이덴티티","2017-10-28","1",2,1675803,37
"5370","23 아이덴티티","2017-10-29","1",4,1675807,38
"5371","23 아이덴티티","2017-10-30","1",4,1675811,39
"5372","23 아이덴티티","2017-10-31","1",5,1675816,40
"5373","23 아이덴티티","2017-11-01","1",3,1675819,41
"5374","23 아이덴티티","2019-01-17","1",192,1676011,42
"5375","해피 데스데이","2017-10-11","1",170,170,0
"5376","해피 데스데이","2017-11-02","1",200,370,0
"5377","해피 데스데이","2017-11-07","1",218,588,0
"5378","해피 데스데이","2017-11-08","472",45059,45647,1
"5379","해피 데스데이","2017-11-09","475",48693,94340,2
"5380","해피 데스데이","2017-11-10","510",73194,167534,3
"5381","해피 데스데이","2017-11-11","651",181615,349149,4
"5382","해피 데스데이","2017-11-12","714",157596,506745,5
"5383","해피 데스데이","2017-11-13","598",50167,556912,6
"5384","해피 데스데이","2017-11-14","608",45647,602559,7
"5385","해피 데스데이","2017-11-15","616",68605,671164,8
"5386","해피 데스데이","2017-11-16","578",75181,746345,9
"5387","해피 데스데이","2017-11-17","640",59283,805628,10
"5388","해피 데스데이","2017-11-18","691",126412,932040,11
"5389","해피 데스데이","2017-11-19","689",105849,1037889,12
"5390","해피 데스데이","2017-11-20","575",32023,1069912,13
"5391","해피 데스데이","2017-11-21","582",27967,1097879,14
"5392","해피 데스데이","2017-11-22","513",29475,1127354,15
"5393","해피 데스데이","2017-11-23","515",32324,1159678,16
"5394","해피 데스데이","2017-11-24","518",34324,1194002,17
"5395","해피 데스데이","2017-11-25","543",59581,1253583,18
"5396","해피 데스데이","2017-11-26","536",52144,1305727,19
"5397","해피 데스데이","2017-11-27","485",16420,1322147,20
"5398","해피 데스데이","2017-11-28","488",15072,1337219,21
"5399","해피 데스데이","2017-11-29","289",8752,1345971,22
"5400","해피 데스데이","2017-11-30","269",5033,1351004,23
"5401","해피 데스데이","2017-12-01","270",6029,1357033,24
"5402","해피 데스데이","2017-12-02","252",8718,1365751,25
"5403","해피 데스데이","2017-12-03","243",6370,1372121,26
"5404","해피 데스데이","2017-12-04","213",2257,1374378,27
"5405","해피 데스데이","2017-12-05","214",2277,1376655,28
"5406","해피 데스데이","2017-12-06","205",2185,1378840,29
"5407","해피 데스데이","2017-12-07","35",524,1379364,30
"5408","해피 데스데이","2017-12-08","33",364,1379728,31
"5409","해피 데스데이","2017-12-09","29",701,1380429,32
"5410","해피 데스데이","2017-12-10","30",639,1381068,33
"5411","해피 데스데이","2017-12-11","32",450,1381518,34
"5412","해피 데스데이","2017-12-12","27",511,1382029,35
"5413","해피 데스데이","2017-12-13","24",381,1382410,36
"5414","해피 데스데이","2017-12-14","2",20,1382430,37
"5415","해피 데스데이","2017-12-15","2",20,1382450,38
"5416","해피 데스데이","2017-12-16","2",20,1382470,39
"5417","해피 데스데이","2017-12-17","2",20,1382490,40
"5418","해피 데스데이","2017-12-18","2",20,1382510,41
"5419","해피 데스데이","2017-12-19","2",20,1382530,42
"5420","해피 데스데이","2017-12-20","2",20,1382550,43
"5421","해피 데스데이","2017-12-21","2",20,1382570,44
"5422","해피 데스데이","2017-12-22","2",20,1382590,45
"5423","해피 데스데이","2017-12-23","2",20,1382610,46
"5424","해피 데스데이","2017-12-24","2",20,1382630,47
"5425","해피 데스데이","2017-12-25","2",20,1382650,48
"5426","에이리언: 커버넌트","2017-05-04","2",1245,1245,0
"5427","에이리언: 커버넌트","2017-05-08","1",598,1843,0
"5428","에이리언: 커버넌트","2017-05-09","841",279185,281028,1
"5429","에이리언: 커버넌트","2017-05-10","769",81345,362373,2
"5430","에이리언: 커버넌트","2017-05-11","790",72975,435348,3
"5431","에이리언: 커버넌트","2017-05-12","830",107955,543303,4
"5432","에이리언: 커버넌트","2017-05-13","822",226810,770113,5
"5433","에이리언: 커버넌트","2017-05-14","836",189844,959957,6
"5434","에이리언: 커버넌트","2017-05-15","776",58773,1018730,7
"5435","에이리언: 커버넌트","2017-05-16","762",44467,1063197,8
"5436","에이리언: 커버넌트","2017-05-17","503",25972,1089169,9
"5437","에이리언: 커버넌트","2017-05-18","516",22037,1111206,10
"5438","에이리언: 커버넌트","2017-05-19","525",29962,1141168,11
"5439","에이리언: 커버넌트","2017-05-20","537",56816,1197984,12
"5440","에이리언: 커버넌트","2017-05-21","538",46943,1244927,13
"5441","에이리언: 커버넌트","2017-05-22","487",14579,1259506,14
"5442","에이리언: 커버넌트","2017-05-23","489",12672,1272178,15
"5443","에이리언: 커버넌트","2017-05-24","272",5667,1277845,16
"5444","에이리언: 커버넌트","2017-05-25","154",2795,1280640,17
"5445","에이리언: 커버넌트","2017-05-26","156",3669,1284309,18
"5446","에이리언: 커버넌트","2017-05-27","136",6752,1291061,19
"5447","에이리언: 커버넌트","2017-05-28","133",5383,1296444,20
"5448","에이리언: 커버넌트","2017-05-29","150",2553,1298997,21
"5449","에이리언: 커버넌트","2017-05-30","147",2605,1301602,22
"5450","에이리언: 커버넌트","2017-05-31","17",530,1302132,23
"5451","에이리언: 커버넌트","2017-06-01","10",444,1302576,24
"5452","에이리언: 커버넌트","2017-06-02","9",385,1302961,25
"5453","에이리언: 커버넌트","2017-06-03","7",520,1303481,26
"5454","에이리언: 커버넌트","2017-06-04","7",377,1303858,27
"5455","에이리언: 커버넌트","2017-06-05","10",359,1304217,28
"5456","에이리언: 커버넌트","2017-06-06","6",267,1304484,29
"5457","에이리언: 커버넌트","2017-06-07","4",156,1304640,30
"5458","에이리언: 커버넌트","2017-06-08","1",10,1304650,31
"5459","에이리언: 커버넌트","2017-06-09","2",53,1304703,32
"5460","에이리언: 커버넌트","2017-06-10","2",53,1304756,33
"5461","에이리언: 커버넌트","2017-06-11","2",59,1304815,34
"5462","에이리언: 커버넌트","2017-06-12","2",51,1304866,35
"5463","에이리언: 커버넌트","2017-06-13","2",23,1304889,36
"5464","에이리언: 커버넌트","2017-06-14","2",27,1304916,37
"5465","에이리언: 커버넌트","2017-06-15","1",10,1304926,38
"5466","에이리언: 커버넌트","2017-06-16","1",10,1304936,39
"5467","에이리언: 커버넌트","2017-06-17","1",25,1304961,40
"5468","에이리언: 커버넌트","2017-06-18","1",25,1304986,41
"5469","에이리언: 커버넌트","2017-06-19","1",10,1304996,42
"5470","에이리언: 커버넌트","2017-06-20","1",10,1305006,43
"5471","에이리언: 커버넌트","2017-06-21","4",80,1305086,44
"5472","에이리언: 커버넌트","2017-06-22","4",80,1305166,45
"5473","에이리언: 커버넌트","2017-06-23","4",80,1305246,46
"5474","에이리언: 커버넌트","2017-06-24","4",95,1305341,47
"5475","에이리언: 커버넌트","2017-06-25","4",95,1305436,48
"5476","에이리언: 커버넌트","2017-06-26","4",80,1305516,49
"5477","에이리언: 커버넌트","2017-06-27","3",70,1305586,50
"5478","에이리언: 커버넌트","2017-06-28","3",70,1305656,51
"5479","에이리언: 커버넌트","2017-06-29","3",70,1305726,52
"5480","에이리언: 커버넌트","2017-06-30","5",100,1305826,53
"5481","에이리언: 커버넌트","2017-07-01","5",115,1305941,54
"5482","에이리언: 커버넌트","2017-07-02","5",115,1306056,55
"5483","에이리언: 커버넌트","2017-07-03","5",100,1306156,56
"5484","에이리언: 커버넌트","2017-07-04","5",100,1306256,57
"5485","에이리언: 커버넌트","2017-07-05","5",100,1306356,58
"5486","에이리언: 커버넌트","2017-07-06","5",100,1306456,59
"5487","에이리언: 커버넌트","2017-07-07","3",70,1306526,60
"5488","에이리언: 커버넌트","2017-07-08","3",70,1306596,61
"5489","에이리언: 커버넌트","2017-07-09","3",70,1306666,62
"5490","에이리언: 커버넌트","2017-07-10","3",70,1306736,63
"5491","에이리언: 커버넌트","2017-07-11","3",70,1306806,64
"5492","에이리언: 커버넌트","2017-07-12","2",40,1306846,65
"5493","에이리언: 커버넌트","2017-07-13","2",40,1306886,66
"5494","에이리언: 커버넌트","2017-07-14","2",40,1306926,67
"5495","에이리언: 커버넌트","2017-07-15","2",40,1306966,68
"5496","에이리언: 커버넌트","2017-07-16","2",40,1307006,69
"5497","에이리언: 커버넌트","2017-07-17","2",40,1307046,70
"5498","에이리언: 커버넌트","2017-07-18","2",40,1307086,71
"5499","에이리언: 커버넌트","2017-07-19","1",20,1307106,72
"5500","에이리언: 커버넌트","2017-07-20","1",20,1307126,73
"5501","에이리언: 커버넌트","2017-07-21","1",20,1307146,74
"5502","에이리언: 커버넌트","2017-07-22","1",20,1307166,75
"5503","에이리언: 커버넌트","2017-07-23","1",20,1307186,76
"5504","에이리언: 커버넌트","2017-07-24","1",20,1307206,77
"5505","에이리언: 커버넌트","2017-07-25","1",20,1307226,78
"5506","라라랜드","2016-11-30","1",326,326,0
"5507","라라랜드","2016-12-05","5",2128,2454,0
"5508","라라랜드","2016-12-06","12",2718,5172,0
"5509","라라랜드","2016-12-07","712",62258,67430,1
"5510","라라랜드","2016-12-08","703",68872,136302,2
"5511","라라랜드","2016-12-09","727",97061,233363,3
"5512","라라랜드","2016-12-10","706",170504,403867,4
"5513","라라랜드","2016-12-11","682",159563,563430,5
"5514","라라랜드","2016-12-12","690",74966,638396,6
"5515","라라랜드","2016-12-13","694",82143,720539,7
"5516","라라랜드","2016-12-14","587",73640,794179,8
"5517","라라랜드","2016-12-15","614",76574,870753,9
"5518","라라랜드","2016-12-16","629",100684,971437,10
"5519","라라랜드","2016-12-17","710",170412,1141849,11
"5520","라라랜드","2016-12-18","700",155711,1297560,12
"5521","라라랜드","2016-12-19","650",76629,1374189,13
"5522","라라랜드","2016-12-20","672",83807,1457996,14
"5523","라라랜드","2016-12-21","490",51360,1509356,15
"5524","라라랜드","2016-12-22","514",55850,1565206,16
"5525","라라랜드","2016-12-23","570",74341,1639547,17
"5526","라라랜드","2016-12-24","671",157182,1796729,18
"5527","라라랜드","2016-12-25","681",148148,1944877,19
"5528","라라랜드","2016-12-26","616",60955,2005832,20
"5529","라라랜드","2016-12-27","616",61309,2067141,21
"5530","라라랜드","2016-12-28","518",69149,2136290,22
"5531","라라랜드","2016-12-29","514",59810,2196100,23
"5532","라라랜드","2016-12-30","532",80472,2276572,24
"5533","라라랜드","2016-12-31","573",108536,2385108,25
"5534","라라랜드","2017-01-01","590",87529,2472637,26
"5535","라라랜드","2017-01-02","556",45780,2518417,27
"5536","라라랜드","2017-01-03","567",41085,2559502,28
"5537","라라랜드","2017-01-04","385",25457,2584959,29
"5538","라라랜드","2017-01-05","388",24059,2609018,30
"5539","라라랜드","2017-01-06","390",28540,2637558,31
"5540","라라랜드","2017-01-07","373",48729,2686287,32
"5541","라라랜드","2017-01-08","387",42658,2728945,33
"5542","라라랜드","2017-01-09","401",21210,2750155,34
"5543","라라랜드","2017-01-10","403",27160,2777315,35
"5544","라라랜드","2017-01-11","309",21988,2799303,36
"5545","라라랜드","2017-01-12","262",17385,2816688,37
"5546","라라랜드","2017-01-13","305",21825,2838513,38
"5547","라라랜드","2017-01-14","360",45303,2883816,39
"5548","라라랜드","2017-01-15","358",40288,2924104,40
"5549","라라랜드","2017-01-16","347",17258,2941362,41
"5550","라라랜드","2017-01-17","357",17977,2959339,42
"5551","라라랜드","2017-01-18","225",8833,2968172,43
"5552","라라랜드","2017-01-19","226",9337,2977509,44
"5553","라라랜드","2017-01-20","228",10966,2988475,45
"5554","라라랜드","2017-01-21","243",18699,3007174,46
"5555","라라랜드","2017-01-22","234",16278,3023452,47
"5556","라라랜드","2017-01-23","247",8829,3032281,48
"5557","라라랜드","2017-01-24","248",9377,3041658,49
"5558","라라랜드","2017-01-25","188",9443,3051101,50
"5559","라라랜드","2017-01-26","191",12680,3063781,51
"5560","라라랜드","2017-01-27","189",16867,3080648,52
"5561","라라랜드","2017-01-28","205",19012,3099660,53
"5562","라라랜드","2017-01-29","204",22454,3122114,54
"5563","라라랜드","2017-01-30","204",23881,3145995,55
"5564","라라랜드","2017-01-31","216",12189,3158184,56
"5565","라라랜드","2017-02-01","218",8823,3167007,57
"5566","라라랜드","2017-02-02","194",7590,3174597,58
"5567","라라랜드","2017-02-03","200",8818,3183415,59
"5568","라라랜드","2017-02-04","199",14872,3198287,60
"5569","라라랜드","2017-02-05","201",12189,3210476,61
"5570","라라랜드","2017-02-06","201",5876,3216352,62
"5571","라라랜드","2017-02-07","205",6050,3222402,63
"5572","라라랜드","2017-02-08","196",6035,3228437,64
"5573","라라랜드","2017-02-09","117",3511,3231948,65
"5574","라라랜드","2017-02-10","124",4326,3236274,66
"5575","라라랜드","2017-02-11","130",8164,3244438,67
"5576","라라랜드","2017-02-12","128",7351,3251789,68
"5577","라라랜드","2017-02-13","137",4483,3256272,69
"5578","라라랜드","2017-02-14","148",5135,3261407,70
"5579","라라랜드","2017-02-15","86",2623,3264030,71
"5580","라라랜드","2017-02-16","80",2657,3266687,72
"5581","라라랜드","2017-02-17","87",3723,3270410,73
"5582","라라랜드","2017-02-18","87",5921,3276331,74
"5583","라라랜드","2017-02-19","93",5914,3282245,75
"5584","라라랜드","2017-02-20","91",3023,3285268,76
"5585","라라랜드","2017-02-21","97",3504,3288772,77
"5586","라라랜드","2017-02-22","88",2490,3291262,78
"5587","라라랜드","2017-02-23","84",2348,3293610,79
"5588","라라랜드","2017-02-24","77",2440,3296050,80
"5589","라라랜드","2017-02-25","85",6020,3302070,81
"5590","라라랜드","2017-02-26","87",6239,3308309,82
"5591","라라랜드","2017-02-27","92",4651,3312960,83
"5592","라라랜드","2017-02-28","102",6483,3319443,84
"5593","라라랜드","2017-03-01","87",9364,3328807,85
"5594","라라랜드","2017-03-02","98",3367,3332174,86
"5595","라라랜드","2017-03-03","137",5279,3337453,87
"5596","라라랜드","2017-03-04","165",13089,3350542,88
"5597","라라랜드","2017-03-05","162",11473,3362015,89
"5598","라라랜드","2017-03-06","156",4388,3366403,90
"5599","라라랜드","2017-03-07","175",6040,3372443,91
"5600","라라랜드","2017-03-08","166",4583,3377026,92
"5601","라라랜드","2017-03-09","160",4643,3381669,93
"5602","라라랜드","2017-03-10","168",5982,3387651,94
"5603","라라랜드","2017-03-11","197",13709,3401360,95
"5604","라라랜드","2017-03-12","202",13144,3414504,96
"5605","라라랜드","2017-03-13","175",4524,3419028,97
"5606","라라랜드","2017-03-14","192",5373,3424401,98
"5607","라라랜드","2017-03-15","180",5353,3429754,99
"5608","라라랜드","2017-03-16","140",3355,3433109,100
"5609","라라랜드","2017-03-17","144",4086,3437195,101
"5610","라라랜드","2017-03-18","149",8356,3445551,102
"5611","라라랜드","2017-03-19","156",7953,3453504,103
"5612","라라랜드","2017-03-20","161",3252,3456756,104
"5613","라라랜드","2017-03-21","158",3929,3460685,105
"5614","라라랜드","2017-03-22","148",3464,3464149,106
"5615","라라랜드","2017-03-23","64",1225,3465374,107
"5616","라라랜드","2017-03-24","66",1659,3467033,108
"5617","라라랜드","2017-03-25","72",3419,3470452,109
"5618","라라랜드","2017-03-26","74",3352,3473804,110
"5619","라라랜드","2017-03-27","86",1482,3475286,111
"5620","라라랜드","2017-03-28","86",1740,3477026,112
"5621","라라랜드","2017-03-29","52",1249,3478275,113
"5622","라라랜드","2017-03-30","51",1046,3479321,114
"5623","라라랜드","2017-03-31","52",1423,3480744,115
"5624","라라랜드","2017-04-01","46",2070,3482814,116
"5625","라라랜드","2017-04-02","43",1644,3484458,117
"5626","라라랜드","2017-04-03","50",934,3485392,118
"5627","라라랜드","2017-04-04","50",878,3486270,119
"5628","라라랜드","2017-04-05","43",832,3487102,120
"5629","라라랜드","2017-04-06","35",573,3487675,121
"5630","라라랜드","2017-04-07","35",772,3488447,122
"5631","라라랜드","2017-04-08","34",1199,3489646,123
"5632","라라랜드","2017-04-09","36",1210,3490856,124
"5633","라라랜드","2017-04-10","38",647,3491503,125
"5634","라라랜드","2017-04-11","36",682,3492185,126
"5635","라라랜드","2017-04-12","22",456,3492641,127
"5636","라라랜드","2017-04-13","16",305,3492946,128
"5637","라라랜드","2017-04-14","17",370,3493316,129
"5638","라라랜드","2017-04-15","23",565,3493881,130
"5639","라라랜드","2017-04-16","20",590,3494471,131
"5640","라라랜드","2017-04-17","21",393,3494864,132
"5641","라라랜드","2017-04-18","21",387,3495251,133
"5642","라라랜드","2017-04-19","22",327,3495578,134
"5643","라라랜드","2017-04-20","9",182,3495760,135
"5644","라라랜드","2017-04-21","10",215,3495975,136
"5645","라라랜드","2017-04-22","14",551,3496526,137
"5646","라라랜드","2017-04-23","17",538,3497064,138
"5647","라라랜드","2017-04-24","11",184,3497248,139
"5648","라라랜드","2017-04-25","11",198,3497446,140
"5649","라라랜드","2017-04-26","9",208,3497654,141
"5650","라라랜드","2017-04-27","8",161,3497815,142
"5651","라라랜드","2017-04-28","11",269,3498084,143
"5652","라라랜드","2017-04-29","8",497,3498581,144
"5653","라라랜드","2017-04-30","10",668,3499249,145
"5654","라라랜드","2017-05-01","9",550,3499799,146
"5655","라라랜드","2017-05-02","11",234,3500033,147
"5656","라라랜드","2017-05-03","9",351,3500384,148
"5657","라라랜드","2017-05-04","9",261,3500645,149
"5658","라라랜드","2017-05-05","11",328,3500973,150
"5659","라라랜드","2017-05-06","11",297,3501270,151
"5660","라라랜드","2017-05-07","12",273,3501543,152
"5661","라라랜드","2017-05-08","12",224,3501767,153
"5662","라라랜드","2017-05-09","8",297,3502064,154
"5663","라라랜드","2017-05-10","8",78,3502142,155
"5664","라라랜드","2017-05-11","7",77,3502219,156
"5665","라라랜드","2017-05-12","9",248,3502467,157
"5666","라라랜드","2017-05-13","7",222,3502689,158
"5667","라라랜드","2017-05-14","7",178,3502867,159
"5668","라라랜드","2017-05-15","9",157,3503024,160
"5669","라라랜드","2017-05-16","8",97,3503121,161
"5670","라라랜드","2017-05-17","4",64,3503185,162
"5671","라라랜드","2017-05-18","4",55,3503240,163
"5672","라라랜드","2017-05-19","7",372,3503612,164
"5673","라라랜드","2017-05-20","3",112,3503724,165
"5674","라라랜드","2017-05-21","5",176,3503900,166
"5675","라라랜드","2017-05-22","5",93,3503993,167
"5676","라라랜드","2017-05-23","5",181,3504174,168
"5677","라라랜드","2017-05-24","3",26,3504200,169
"5678","라라랜드","2017-05-25","1",16,3504216,170
"5679","라라랜드","2017-05-26","2",38,3504254,171
"5680","라라랜드","2017-05-27","2",93,3504347,172
"5681","라라랜드","2017-05-28","3",88,3504435,173
"5682","라라랜드","2017-05-29","3",45,3504480,174
"5683","라라랜드","2017-05-30","3",40,3504520,175
"5684","라라랜드","2017-05-31","1",10,3504530,176
"5685","라라랜드","2017-06-01","2",128,3504658,177
"5686","라라랜드","2017-06-02","1",24,3504682,178
"5687","라라랜드","2017-06-03","2",122,3504804,179
"5688","라라랜드","2017-06-04","2",117,3504921,180
"5689","라라랜드","2017-06-05","1",29,3504950,181
"5690","라라랜드","2017-06-10","1",22,3504972,182
"5691","라라랜드","2017-06-11","1",55,3505027,183
"5692","라라랜드","2017-06-18","1",75,3505102,184
"5693","라라랜드","2017-06-25","1",75,3505177,185
"5694","라라랜드","2017-06-30","1",145,3505322,186
"5695","라라랜드","2017-07-01","1",40,3505362,187
"5696","라라랜드","2017-07-02","1",60,3505422,188
"5697","라라랜드","2017-07-07","2",310,3505732,189
"5698","라라랜드","2017-07-09","1",71,3505803,190
"5699","라라랜드","2017-07-10","1",57,3505860,191
"5700","라라랜드","2017-07-11","2",257,3506117,192
"5701","라라랜드","2017-07-12","1",83,3506200,193
"5702","라라랜드","2017-07-16","2",167,3506367,194
"5703","라라랜드","2017-07-20","1",68,3506435,195
"5704","라라랜드","2017-07-23","1",77,3506512,196
"5705","라라랜드","2017-07-27","1",103,3506615,197
"5706","라라랜드","2017-07-30","1",77,3506692,198
"5707","라라랜드","2017-07-31","2",572,3507264,199
"5708","라라랜드","2017-08-01","2",348,3507612,200
"5709","라라랜드","2017-08-02","1",10,3507622,201
"5710","라라랜드","2017-08-06","1",79,3507701,202
"5711","라라랜드","2017-08-13","1",80,3507781,203
"5712","라라랜드","2017-08-20","1",81,3507862,204
"5713","라라랜드","2017-08-27","1",74,3507936,205
"5714","라라랜드","2017-09-01","2",52,3507988,206
"5715","라라랜드","2017-09-03","1",75,3508063,207
"5716","라라랜드","2017-09-16","2",83,3508146,208
"5717","라라랜드","2017-09-17","1",258,3508404,209
"5718","라라랜드","2017-09-18","2",37,3508441,210
"5719","라라랜드","2017-09-19","3",78,3508519,211
"5720","라라랜드","2017-09-20","3",52,3508571,212
"5721","라라랜드","2017-09-21","2",45,3508616,213
"5722","라라랜드","2017-09-22","3",106,3508722,214
"5723","라라랜드","2017-09-23","3",153,3508875,215
"5724","라라랜드","2017-09-24","4",229,3509104,216
"5725","라라랜드","2017-09-26","2",91,3509195,217
"5726","라라랜드","2017-09-27","1",76,3509271,218
"5727","라라랜드","2017-09-29","2",61,3509332,219
"5728","라라랜드","2017-10-01","3",104,3509436,220
"5729","라라랜드","2017-10-02","1",8,3509444,221
"5730","라라랜드","2017-10-03","2",130,3509574,222
"5731","라라랜드","2017-10-06","2",110,3509684,223
"5732","라라랜드","2017-10-07","2",31,3509715,224
"5733","라라랜드","2017-10-08","3",117,3509832,225
"5734","라라랜드","2017-10-09","2",71,3509903,226
"5735","라라랜드","2017-10-10","1",78,3509981,227
"5736","라라랜드","2017-10-11","1",2,3509983,228
"5737","라라랜드","2017-10-13","1",4,3509987,229
"5738","라라랜드","2017-10-14","1",74,3510061,230
"5739","라라랜드","2017-10-15","2",75,3510136,231
"5740","라라랜드","2017-10-17","1",53,3510189,232
"5741","라라랜드","2017-10-18","2",49,3510238,233
"5742","라라랜드","2017-10-19","1",64,3510302,234
"5743","라라랜드","2017-10-20","2",48,3510350,235
"5744","라라랜드","2017-10-21","1",133,3510483,236
"5745","라라랜드","2017-10-22","4",244,3510727,237
"5746","라라랜드","2017-10-23","1",55,3510782,238
"5747","라라랜드","2017-10-24","2",73,3510855,239
"5748","라라랜드","2017-10-25","2",68,3510923,240
"5749","라라랜드","2017-10-29","1",62,3510985,241
"5750","라라랜드","2017-10-31","1",38,3511023,242
"5751","라라랜드","2017-11-02","3",360,3511383,243
"5752","라라랜드","2017-11-03","1",22,3511405,244
"5753","라라랜드","2017-11-04","3",356,3511761,245
"5754","라라랜드","2017-11-05","2",117,3511878,246
"5755","라라랜드","2017-11-06","1",7,3511885,247
"5756","라라랜드","2017-11-07","2",42,3511927,248
"5757","라라랜드","2017-11-08","1",13,3511940,249
"5758","라라랜드","2017-11-12","2",124,3512064,250
"5759","라라랜드","2017-11-14","1",39,3512103,251
"5760","라라랜드","2017-11-16","1",28,3512131,252
"5761","라라랜드","2017-11-17","1",53,3512184,253
"5762","라라랜드","2017-11-19","1",66,3512250,254
"5763","라라랜드","2017-11-20","1",21,3512271,255
"5764","라라랜드","2017-11-21","2",51,3512322,256
"5765","라라랜드","2017-11-22","1",50,3512372,257
"5766","라라랜드","2017-11-25","1",45,3512417,258
"5767","라라랜드","2017-11-26","2",113,3512530,259
"5768","라라랜드","2017-11-27","1",9,3512539,260
"5769","라라랜드","2017-11-28","1",27,3512566,261
"5770","라라랜드","2017-12-02","1",38,3512604,262
"5771","라라랜드","2017-12-03","2",93,3512697,263
"5772","라라랜드","2017-12-04","1",6,3512703,264
"5773","라라랜드","2017-12-05","1",16,3512719,265
"5774","라라랜드","2017-12-06","2",359,3513078,266
"5775","라라랜드","2017-12-07","3",87,3513165,267
"5776","라라랜드","2017-12-08","237",11973,3525138,268
"5777","라라랜드","2017-12-09","245",13968,3539106,269
"5778","라라랜드","2017-12-10","247",12980,3552086,270
"5779","라라랜드","2017-12-11","139",2816,3554902,271
"5780","라라랜드","2017-12-12","138",3013,3557915,272
"5781","라라랜드","2017-12-13","131",3270,3561185,273
"5782","라라랜드","2017-12-14","33",787,3561972,274
"5783","라라랜드","2017-12-15","34",1181,3563153,275
"5784","라라랜드","2017-12-16","34",1493,3564646,276
"5785","라라랜드","2017-12-17","33",1020,3565666,277
"5786","라라랜드","2017-12-18","33",650,3566316,278
"5787","라라랜드","2017-12-19","31",819,3567135,279
"5788","라라랜드","2017-12-20","12",177,3567312,280
"5789","라라랜드","2017-12-21","10",182,3567494,281
"5790","라라랜드","2017-12-22","11",189,3567683,282
"5791","라라랜드","2017-12-23","11",338,3568021,283
"5792","라라랜드","2017-12-24","12",1018,3569039,284
"5793","라라랜드","2017-12-25","9",611,3569650,285
"5794","라라랜드","2017-12-26","6",119,3569769,286
"5795","라라랜드","2017-12-27","4",110,3569879,287
"5796","라라랜드","2017-12-28","5",104,3569983,288
"5797","라라랜드","2017-12-29","6",66,3570049,289
"5798","라라랜드","2017-12-30","5",244,3570293,290
"5799","라라랜드","2017-12-31","4",102,3570395,291
"5800","라라랜드","2018-01-01","5",244,3570639,292
"5801","라라랜드","2018-01-02","3",72,3570711,293
"5802","라라랜드","2018-01-03","3",77,3570788,294
"5803","라라랜드","2018-01-04","3",33,3570821,295
"5804","라라랜드","2018-01-05","3",43,3570864,296
"5805","라라랜드","2018-01-06","2",50,3570914,297
"5806","라라랜드","2018-01-07","4",111,3571025,298
"5807","라라랜드","2018-01-11","1",2,3571027,299
"5808","라라랜드","2018-01-13","1",27,3571054,300
"5809","라라랜드","2018-01-16","1",9,3571063,301
"5810","라라랜드","2018-01-19","1",7,3571070,302
"5811","라라랜드","2018-01-20","1",16,3571086,303
"5812","라라랜드","2018-01-21","1",9,3571095,304
"5813","라라랜드","2018-01-24","1",2,3571097,305
"5814","라라랜드","2018-01-27","1",14,3571111,306
"5815","라라랜드","2018-01-28","1",14,3571125,307
"5816","라라랜드","2018-02-03","1",19,3571144,308
"5817","라라랜드","2018-02-06","1",2,3571146,309
"5818","라라랜드","2018-02-11","1",14,3571160,310
"5819","라라랜드","2018-02-14","1",4,3571164,311
"5820","라라랜드","2018-02-16","1",15,3571179,312
"5821","라라랜드","2018-02-17","1",21,3571200,313
"5822","라라랜드","2018-02-18","1",15,3571215,314
"5823","라라랜드","2018-02-20","1",2,3571217,315
"5824","라라랜드","2018-02-24","1",7,3571224,316
"5825","라라랜드","2018-02-25","1",24,3571248,317
"5826","라라랜드","2018-02-26","1",25,3571273,318
"5827","라라랜드","2018-02-27","1",11,3571284,319
"5828","라라랜드","2018-03-06","1",26,3571310,320
"5829","라라랜드","2018-03-08","2",43,3571353,321
"5830","라라랜드","2018-03-12","1",16,3571369,322
"5831","라라랜드","2018-03-14","1",15,3571384,323
"5832","라라랜드","2018-03-16","1",42,3571426,324
"5833","라라랜드","2018-03-23","1",34,3571460,325
"5834","라라랜드","2018-03-27","1",23,3571483,326
"5835","라라랜드","2018-04-01","1",65,3571548,327
"5836","라라랜드","2018-05-01","1",43,3571591,328
"5837","라라랜드","2018-05-09","1",22,3571613,329
"5838","라라랜드","2018-05-12","1",76,3571689,330
"5839","라라랜드","2018-05-16","1",26,3571715,331
"5840","라라랜드","2018-05-17","1",21,3571736,332
"5841","라라랜드","2018-05-18","1",20,3571756,333
"5842","라라랜드","2018-05-23","3",596,3572352,334
"5843","라라랜드","2018-05-25","1",47,3572399,335
"5844","라라랜드","2018-05-28","1",100,3572499,336
"5845","라라랜드","2018-06-06","2",154,3572653,337
"5846","라라랜드","2018-07-01","1",20,3572673,338
"5847","라라랜드","2018-07-09","2",36,3572709,339
"5848","라라랜드","2018-07-10","1",23,3572732,340
"5849","라라랜드","2018-07-11","1",68,3572800,341
"5850","라라랜드","2018-07-12","2",32,3572832,342
"5851","라라랜드","2018-07-14","61",2402,3575234,343
"5852","라라랜드","2018-07-15","62",2689,3577923,344
"5853","라라랜드","2018-07-16","59",1938,3579861,345
"5854","라라랜드","2018-07-17","60",2154,3582015,346
"5855","라라랜드","2018-07-18","57",1718,3583733,347
"5856","라라랜드","2018-07-19","55",1571,3585304,348
"5857","라라랜드","2018-07-20","58",1960,3587264,349
"5858","라라랜드","2018-07-21","54",2544,3589808,350
"5859","라라랜드","2018-07-22","53",2557,3592365,351
"5860","라라랜드","2018-07-23","56",1708,3594073,352
"5861","라라랜드","2018-07-24","55",1900,3595973,353
"5862","라라랜드","2018-07-25","2",40,3596013,354
"5863","라라랜드","2018-07-26","2",22,3596035,355
"5864","라라랜드","2018-07-28","1",95,3596130,356
"5865","라라랜드","2018-07-29","1",33,3596163,357
"5866","라라랜드","2018-07-30","2",12,3596175,358
"5867","라라랜드","2018-07-31","1",12,3596187,359
"5868","라라랜드","2018-08-02","2",13,3596200,360
"5869","라라랜드","2018-08-03","2",38,3596238,361
"5870","라라랜드","2018-08-04","2",67,3596305,362
"5871","라라랜드","2018-08-05","3",53,3596358,363
"5872","라라랜드","2018-08-06","1",43,3596401,364
"5873","라라랜드","2018-08-08","1",14,3596415,365
"5874","라라랜드","2018-08-15","1",74,3596489,366
"5875","라라랜드","2018-08-18","1",24,3596513,367
"5876","라라랜드","2018-08-19","1",22,3596535,368
"5877","라라랜드","2018-08-23","1",14,3596549,369
"5878","라라랜드","2018-08-24","1",0,3596549,370
"5879","라라랜드","2018-08-26","1",24,3596573,371
"5880","라라랜드","2018-08-27","2",28,3596601,372
"5881","라라랜드","2018-08-28","1",28,3596629,373
"5882","라라랜드","2018-08-29","1",9,3596638,374
"5883","라라랜드","2018-08-30","1",35,3596673,375
"5884","라라랜드","2018-08-31","2",46,3596719,376
"5885","라라랜드","2018-09-01","3",162,3596881,377
"5886","라라랜드","2018-09-02","1",15,3596896,378
"5887","라라랜드","2018-09-04","1",10,3596906,379
"5888","라라랜드","2018-09-05","2",8,3596914,380
"5889","라라랜드","2018-09-06","1",9,3596923,381
"5890","라라랜드","2018-09-07","2",22,3596945,382
"5891","라라랜드","2018-09-08","2",62,3597007,383
"5892","라라랜드","2018-09-09","1",13,3597020,384
"5893","라라랜드","2018-09-10","2",20,3597040,385
"5894","라라랜드","2018-09-11","3",31,3597071,386
"5895","라라랜드","2018-09-12","3",24,3597095,387
"5896","라라랜드","2018-09-13","4",47,3597142,388
"5897","라라랜드","2018-09-14","3",48,3597190,389
"5898","라라랜드","2018-09-15","3",104,3597294,390
"5899","라라랜드","2018-09-16","4",146,3597440,391
"5900","라라랜드","2018-09-17","3",30,3597470,392
"5901","라라랜드","2018-09-18","4",49,3597519,393
"5902","라라랜드","2018-11-26","1",66,3597585,394
"5903","라라랜드","2018-12-03","1",24,3597609,395
"5904","라라랜드","2018-12-05","1",42,3597651,396
"5905","라라랜드","2018-12-07","1",22,3597673,397
"5906","라라랜드","2018-12-09","1",54,3597727,398
"5907","라라랜드","2018-12-10","1",116,3597843,399
"5908","라라랜드","2018-12-11","2",104,3597947,400
"5909","라라랜드","2018-12-13","1",53,3598000,401
"5910","라라랜드","2018-12-14","1",27,3598027,402
"5911","라라랜드","2018-12-16","1",19,3598046,403
"5912","라라랜드","2018-12-18","1",66,3598112,404
"5913","라라랜드","2018-12-19","1",90,3598202,405
"5914","라라랜드","2018-12-24","1",76,3598278,406
"5915","라라랜드","2018-12-25","1",110,3598388,407
"5916","라라랜드","2019-01-10","2",33,3598421,408
"5917","라라랜드","2019-01-11","2",22,3598443,409
"5918","라라랜드","2019-01-12","5",199,3598642,410
"5919","라라랜드","2019-01-13","4",82,3598724,411
"5920","라라랜드","2019-01-14","5",88,3598812,412
"5921","라라랜드","2019-01-15","2",40,3598852,413
"5922","라라랜드","2019-01-16","3",19,3598871,414
"5923","라라랜드","2019-01-17","5",58,3598929,415
"5924","라라랜드","2019-01-18","2",59,3598988,416
"5925","라라랜드","2019-01-19","5",59,3599047,417
"5926","라라랜드","2019-01-20","1",22,3599069,418
"5927","라라랜드","2019-01-21","1",5,3599074,419
"5928","라라랜드","2019-01-22","3",24,3599098,420
"5929","라라랜드","2019-01-23","5",59,3599157,421
"5930","라라랜드","2019-01-29","1",33,3599190,422
"5931","라라랜드","2019-02-05","1",82,3599272,423
"5932","라라랜드","2019-02-06","1",131,3599403,424
"5933","라라랜드","2019-02-07","1",123,3599526,425
"5934","지오스톰","2017-10-16","1",624,624,0
"5935","지오스톰","2017-10-18","6",832,1456,0
"5936","지오스톰","2017-10-19","669",87805,89261,1
"5937","지오스톰","2017-10-20","780",133276,222537,2
"5938","지오스톰","2017-10-21","847",249965,472502,3
"5939","지오스톰","2017-10-22","854",222256,694758,4
"5940","지오스톰","2017-10-23","774",57979,752737,5
"5941","지오스톰","2017-10-24","768",50612,803349,6
"5942","지오스톰","2017-10-25","572",36023,839372,7
"5943","지오스톰","2017-10-26","517",18643,858015,8
"5944","지오스톰","2017-10-27","546",29376,887391,9
"5945","지오스톰","2017-10-28","516",42469,929860,10
"5946","지오스톰","2017-10-29","512",41114,970974,11
"5947","지오스톰","2017-10-30","474",13429,984403,12
"5948","지오스톰","2017-10-31","483",14776,999179,13
"5949","지오스톰","2017-11-01","462",12792,1011971,14
"5950","지오스톰","2017-11-02","75",1229,1013200,15
"5951","지오스톰","2017-11-03","90",1853,1015053,16
"5952","지오스톰","2017-11-04","85",5202,1020255,17
"5953","지오스톰","2017-11-05","88",5067,1025322,18
"5954","지오스톰","2017-11-06","72",745,1026067,19
"5955","지오스톰","2017-11-07","67",720,1026787,20
"5956","지오스톰","2017-11-08","45",458,1027245,21
"5957","지오스톰","2017-11-09","5",216,1027461,22
"5958","지오스톰","2017-11-10","10",403,1027864,23
"5959","지오스톰","2017-11-11","6",128,1027992,24
"5960","지오스톰","2017-11-12","4",110,1028102,25
"5961","지오스톰","2017-11-13","2",22,1028124,26
"5962","지오스톰","2017-11-14","4",197,1028321,27
"5963","지오스톰","2017-11-15","3",48,1028369,28
"5964","지오스톰","2017-11-16","1",1,1028370,29
"5965","지오스톰","2017-11-17","1",1,1028371,30
"5966","지오스톰","2017-11-18","1",1,1028372,31
"5967","지오스톰","2017-11-19","1",1,1028373,32
"5968","지오스톰","2017-11-20","1",1,1028374,33
"5969","지오스톰","2017-11-21","1",1,1028375,34
"5970","지오스톰","2017-11-22","1",1,1028376,35
"5971","지오스톰","2017-11-23","1",1,1028377,36
"5972","지오스톰","2017-11-24","2",2,1028379,37
"5973","지오스톰","2017-11-25","2",2,1028381,38
"5974","지오스톰","2017-11-26","2",2,1028383,39
"5975","지오스톰","2017-11-27","1",1,1028384,40
"5976","스타워즈: 라스트 제다이","2017-12-07","2",517,517,0
"5977","스타워즈: 라스트 제다이","2017-12-13","2",460,977,0
"5978","스타워즈: 라스트 제다이","2017-12-14","1,107",115246,116223,1
"5979","스타워즈: 라스트 제다이","2017-12-15","1,093",107451,223674,2
"5980","스타워즈: 라스트 제다이","2017-12-16","1,059",223864,447538,3
"5981","스타워즈: 라스트 제다이","2017-12-17","1,024",191509,639047,4
"5982","스타워즈: 라스트 제다이","2017-12-18","974",44526,683573,5
"5983","스타워즈: 라스트 제다이","2017-12-19","973",42585,726158,6
"5984","스타워즈: 라스트 제다이","2017-12-20","523",20752,746910,7
"5985","스타워즈: 라스트 제다이","2017-12-21","496",18681,765591,8
"5986","스타워즈: 라스트 제다이","2017-12-22","482",24765,790356,9
"5987","스타워즈: 라스트 제다이","2017-12-23","384",39258,829614,10
"5988","스타워즈: 라스트 제다이","2017-12-24","346",44653,874267,11
"5989","스타워즈: 라스트 제다이","2017-12-25","323",37388,911655,12
"5990","스타워즈: 라스트 제다이","2017-12-26","398",14971,926626,13
"5991","스타워즈: 라스트 제다이","2017-12-27","75",4378,931004,14
"5992","스타워즈: 라스트 제다이","2017-12-28","47",4010,935014,15
"5993","스타워즈: 라스트 제다이","2017-12-29","39",4406,939420,16
"5994","스타워즈: 라스트 제다이","2017-12-30","31",3472,942892,17
"5995","스타워즈: 라스트 제다이","2017-12-31","35",3655,946547,18
"5996","스타워즈: 라스트 제다이","2018-01-01","35",3298,949845,19
"5997","스타워즈: 라스트 제다이","2018-01-02","37",2913,952758,20
"5998","스타워즈: 라스트 제다이","2018-01-03","15",609,953367,21
"5999","스타워즈: 라스트 제다이","2018-01-04","13",473,953840,22
"6000","스타워즈: 라스트 제다이","2018-01-05","12",622,954462,23
"6001","스타워즈: 라스트 제다이","2018-01-06","15",761,955223,24
"6002","스타워즈: 라스트 제다이","2018-01-07","13",998,956221,25
"6003","스타워즈: 라스트 제다이","2018-01-08","11",326,956547,26
"6004","스타워즈: 라스트 제다이","2018-01-09","13",314,956861,27
"6005","스타워즈: 라스트 제다이","2018-01-10","12",324,957185,28
"6006","스타워즈: 라스트 제다이","2018-01-11","9",272,957457,29
"6007","스타워즈: 라스트 제다이","2018-01-12","9",251,957708,30
"6008","스타워즈: 라스트 제다이","2018-01-13","10",553,958261,31
"6009","스타워즈: 라스트 제다이","2018-01-14","7",444,958705,32
"6010","스타워즈: 라스트 제다이","2018-01-15","7",141,958846,33
"6011","스타워즈: 라스트 제다이","2018-01-16","7",131,958977,34
"6012","스타워즈: 라스트 제다이","2018-01-17","3",44,959021,35
"6013","스타워즈: 라스트 제다이","2018-01-18","1",15,959036,36
"6014","스타워즈: 라스트 제다이","2018-01-19","2",26,959062,37
"6015","스타워즈: 라스트 제다이","2018-01-20","2",52,959114,38
"6016","스타워즈: 라스트 제다이","2018-01-21","2",51,959165,39
"6017","스타워즈: 라스트 제다이","2018-01-22","2",23,959188,40
"6018","스타워즈: 라스트 제다이","2018-01-23","2",24,959212,41
"6019","스타워즈: 라스트 제다이","2018-01-24","1",12,959224,42
"6020","스타워즈: 라스트 제다이","2018-01-25","1",12,959236,43
"6021","스타워즈: 라스트 제다이","2018-01-26","1",8,959244,44
"6022","스타워즈: 라스트 제다이","2018-01-27","3",276,959520,45
"6023","스타워즈: 라스트 제다이","2018-01-28","2",27,959547,46
"6024","스타워즈: 라스트 제다이","2018-01-29","1",8,959555,47
"6025","스타워즈: 라스트 제다이","2018-01-30","1",22,959577,48
"6026","그것","2017-08-31","1",450,450,0
"6027","그것","2017-09-04","1",208,658,0
"6028","그것","2017-09-05","4",610,1268,0
"6029","그것","2017-09-06","752",76925,78193,1
"6030","그것","2017-09-07","785",75819,154012,2
"6031","그것","2017-09-08","804",100066,254078,3
"6032","그것","2017-09-09","837",181519,435597,4
"6033","그것","2017-09-10","805",136830,572427,5
"6034","그것","2017-09-11","731",40529,612956,6
"6035","그것","2017-09-12","739",33140,646096,7
"6036","그것","2017-09-13","690",27646,673742,8
"6037","그것","2017-09-14","456",16765,690507,9
"6038","그것","2017-09-15","462",27068,717575,10
"6039","그것","2017-09-16","481",51798,769373,11
"6040","그것","2017-09-17","481",40416,809789,12
"6041","그것","2017-09-18","430",10386,820175,13
"6042","그것","2017-09-19","417",9039,829214,14
"6043","그것","2017-09-20","418",9148,838362,15
"6044","그것","2017-09-21","220",3979,842341,16
"6045","그것","2017-09-22","238",7073,849414,17
"6046","그것","2017-09-23","237",13134,862548,18
"6047","그것","2017-09-24","240",10361,872909,19
"6048","그것","2017-09-25","219",2992,875901,20
"6049","그것","2017-09-26","215",2772,878673,21
"6050","그것","2017-09-27","35",801,879474,22
"6051","그것","2017-09-28","29",608,880082,23
"6052","그것","2017-09-29","34",1527,881609,24
"6053","그것","2017-09-30","31",1792,883401,25
"6054","그것","2017-10-01","27",1772,885173,26
"6055","그것","2017-10-02","31",1483,886656,27
"6056","그것","2017-10-03","8",313,886969,28
"6057","그것","2017-10-04","7",327,887296,29
"6058","그것","2017-10-05","5",246,887542,30
"6059","그것","2017-10-06","5",237,887779,31
"6060","그것","2017-10-07","6",273,888052,32
"6061","그것","2017-10-08","7",278,888330,33
"6062","그것","2017-10-09","5",186,888516,34
"6063","그것","2017-10-10","3",30,888546,35
"6064","그것","2017-10-11","6",32,888578,36
"6065","그것","2017-10-12","1",8,888586,37
"6066","그것","2017-10-13","1",20,888606,38
"6067","그것","2017-10-15","1",39,888645,39
"6068","그것","2017-10-16","1",6,888651,40
"6069","그것","2017-10-17","1",17,888668,41
"6070","그것","2017-10-18","1",10,888678,42
"6071","그것","2017-10-26","1",5,888683,43
"6072","그것","2017-10-27","1",15,888698,44
"6073","그것","2017-10-28","1",21,888719,45
"6074","그것","2017-10-29","1",6,888725,46
"6075","그것","2017-10-31","2",33,888758,47
"6076","그것","2017-11-01","1",17,888775,48
"6077","그것","2017-11-16","1",10,888785,49
"6078","그것","2017-11-17","1",1,888786,50
"6079","그것","2017-11-18","1",2,888788,51
"6080","그것","2017-11-19","1",19,888807,52
"6081","그것","2017-11-20","1",4,888811,53
"6082","그것","2017-11-21","1",3,888814,54
"6083","그것","2017-12-16","1",12,888826,55
"6084","그것","2017-12-21","1",10,888836,56
"6085","오리엔트 특급 살인","2017-11-17","1",226,226,0
"6086","오리엔트 특급 살인","2017-11-20","1",218,444,0
"6087","오리엔트 특급 살인","2017-11-22","1",389,833,0
"6088","오리엔트 특급 살인","2017-11-23","1",268,1101,0
"6089","오리엔트 특급 살인","2017-11-29","629",94340,95441,1
"6090","오리엔트 특급 살인","2017-11-30","649",60764,156205,2
"6091","오리엔트 특급 살인","2017-12-01","663",70962,227167,3
"6092","오리엔트 특급 살인","2017-12-02","700",141706,368873,4
"6093","오리엔트 특급 살인","2017-12-03","707",119988,488861,5
"6094","오리엔트 특급 살인","2017-12-04","645",38169,527030,6
"6095","오리엔트 특급 살인","2017-12-05","645",36827,563857,7
"6096","오리엔트 특급 살인","2017-12-06","659",35949,599806,8
"6097","오리엔트 특급 살인","2017-12-07","537",27804,627610,9
"6098","오리엔트 특급 살인","2017-12-08","565",36181,663791,10
"6099","오리엔트 특급 살인","2017-12-09","543",58481,722272,11
"6100","오리엔트 특급 살인","2017-12-10","526",49524,771796,12
"6101","오리엔트 특급 살인","2017-12-11","515",20601,792397,13
"6102","오리엔트 특급 살인","2017-12-12","519",19178,811575,14
"6103","오리엔트 특급 살인","2017-12-13","529",21925,833500,15
"6104","오리엔트 특급 살인","2017-12-14","159",6083,839583,16
"6105","오리엔트 특급 살인","2017-12-15","150",5703,845286,17
"6106","오리엔트 특급 살인","2017-12-16","117",5747,851033,18
"6107","오리엔트 특급 살인","2017-12-17","105",4629,855662,19
"6108","오리엔트 특급 살인","2017-12-18","120",3088,858750,20
"6109","오리엔트 특급 살인","2017-12-19","115",2610,861360,21
"6110","오리엔트 특급 살인","2017-12-20","18",473,861833,22
"6111","오리엔트 특급 살인","2017-12-21","8",114,861947,23
"6112","오리엔트 특급 살인","2017-12-22","8",187,862134,24
"6113","오리엔트 특급 살인","2017-12-23","4",266,862400,25
"6114","오리엔트 특급 살인","2017-12-24","2",55,862455,26
"6115","오리엔트 특급 살인","2017-12-25","3",94,862549,27
"6116","오리엔트 특급 살인","2017-12-26","5",347,862896,28
"6117","오리엔트 특급 살인","2017-12-27","3",101,862997,29
"6118","오리엔트 특급 살인","2017-12-28","5",90,863087,30
"6119","오리엔트 특급 살인","2017-12-29","6",240,863327,31
"6120","오리엔트 특급 살인","2017-12-30","5",120,863447,32
"6121","오리엔트 특급 살인","2017-12-31","5",120,863567,33
"6122","오리엔트 특급 살인","2018-01-01","5",90,863657,34
"6123","오리엔트 특급 살인","2018-01-02","5",90,863747,35
"6124","오리엔트 특급 살인","2018-01-03","5",90,863837,36
"6125","오리엔트 특급 살인","2018-01-04","4",60,863897,37
"6126","오리엔트 특급 살인","2018-01-05","4",60,863957,38
"6127","오리엔트 특급 살인","2018-01-06","4",90,864047,39
"6128","오리엔트 특급 살인","2018-01-07","4",90,864137,40
"6129","오리엔트 특급 살인","2018-01-08","4",60,864197,41
"6130","오리엔트 특급 살인","2018-01-09","4",60,864257,42
"6131","오리엔트 특급 살인","2018-01-10","4",60,864317,43
"6132","오리엔트 특급 살인","2018-01-11","3",40,864357,44
"6133","오리엔트 특급 살인","2018-01-12","3",40,864397,45
"6134","오리엔트 특급 살인","2018-01-13","3",70,864467,46
"6135","오리엔트 특급 살인","2018-01-14","3",70,864537,47
"6136","오리엔트 특급 살인","2018-01-15","3",40,864577,48
"6137","오리엔트 특급 살인","2018-01-16","3",40,864617,49
"6138","오리엔트 특급 살인","2018-01-17","3",40,864657,50
"6139","오리엔트 특급 살인","2018-01-18","1",10,864667,51
"6140","오리엔트 특급 살인","2018-01-19","1",10,864677,52
"6141","오리엔트 특급 살인","2018-01-20","1",25,864702,53
"6142","오리엔트 특급 살인","2018-01-21","1",25,864727,54
"6143","오리엔트 특급 살인","2018-01-22","1",10,864737,55
"6144","오리엔트 특급 살인","2018-01-23","1",10,864747,56
"6145","오리엔트 특급 살인","2018-01-24","1",10,864757,57
"6146","베이비 드라이버","2017-08-21","1",100,100,0
"6147","베이비 드라이버","2017-08-25","3",1137,1237,0
"6148","베이비 드라이버","2017-09-13","669",30803,32040,0
"6149","베이비 드라이버","2017-09-14","676",51772,83812,1
"6150","베이비 드라이버","2017-09-15","710",69548,153360,2
"6151","베이비 드라이버","2017-09-16","778",141979,295339,3
"6152","베이비 드라이버","2017-09-17","771",126717,422056,4
"6153","베이비 드라이버","2017-09-18","694",41410,463466,5
"6154","베이비 드라이버","2017-09-19","716",37773,501239,6
"6155","베이비 드라이버","2017-09-20","713",38459,539698,7
"6156","베이비 드라이버","2017-09-21","468",24153,563851,8
"6157","베이비 드라이버","2017-09-22","500",33033,596884,9
"6158","베이비 드라이버","2017-09-23","550",64186,661070,10
"6159","베이비 드라이버","2017-09-24","551",57092,718162,11
"6160","베이비 드라이버","2017-09-25","490",17010,735172,12
"6161","베이비 드라이버","2017-09-26","491",15805,750977,13
"6162","베이비 드라이버","2017-09-27","335",8548,759525,14
"6163","베이비 드라이버","2017-09-28","276",6100,765625,15
"6164","베이비 드라이버","2017-09-29","305",11252,776877,16
"6165","베이비 드라이버","2017-09-30","277",12118,788995,17
"6166","베이비 드라이버","2017-10-01","280",12584,801579,18
"6167","베이비 드라이버","2017-10-02","279",12741,814320,19
"6168","베이비 드라이버","2017-10-03","19",1004,815324,20
"6169","베이비 드라이버","2017-10-04","20",1364,816688,21
"6170","베이비 드라이버","2017-10-05","18",1121,817809,22
"6171","베이비 드라이버","2017-10-06","21",1076,818885,23
"6172","베이비 드라이버","2017-10-07","21",942,819827,24
"6173","베이비 드라이버","2017-10-08","18",875,820702,25
"6174","베이비 드라이버","2017-10-09","20",746,821448,26
"6175","베이비 드라이버","2017-10-10","17",264,821712,27
"6176","베이비 드라이버","2017-10-11","20",309,822021,28
"6177","베이비 드라이버","2017-10-12","4",35,822056,29
"6178","베이비 드라이버","2017-10-13","3",52,822108,30
"6179","베이비 드라이버","2017-10-14","6",145,822253,31
"6180","베이비 드라이버","2017-10-15","6",132,822385,32
"6181","베이비 드라이버","2017-10-16","4",42,822427,33
"6182","베이비 드라이버","2017-10-17","4",39,822466,34
"6183","베이비 드라이버","2017-10-18","5",23,822489,35
"6184","베이비 드라이버","2017-10-19","1",10,822499,36
"6185","베이비 드라이버","2017-10-20","1",24,822523,37
"6186","베이비 드라이버","2017-10-21","2",70,822593,38
"6187","베이비 드라이버","2017-10-22","2",32,822625,39
"6188","베이비 드라이버","2017-10-23","1",11,822636,40
"6189","베이비 드라이버","2017-10-24","1",5,822641,41
"6190","베이비 드라이버","2017-10-25","1",2,822643,42
"6191","베이비 드라이버","2017-10-26","1",13,822656,43
"6192","베이비 드라이버","2017-12-16","1",55,822711,44
"6193","베이비 드라이버","2017-12-23","1",58,822769,45
"6194","베이비 드라이버","2018-02-08","3",68,822837,46
"6195","베이비 드라이버","2018-02-09","1",38,822875,47
"6196","베이비 드라이버","2018-02-10","3",75,822950,48
"6197","베이비 드라이버","2018-02-11","3",119,823069,49
"6198","베이비 드라이버","2018-02-13","1",46,823115,50
"6199","베이비 드라이버","2018-02-14","4",52,823167,51
"6200","베이비 드라이버","2018-02-16","2",41,823208,52
"6201","베이비 드라이버","2018-02-17","4",109,823317,53
"6202","베이비 드라이버","2018-02-18","3",79,823396,54
"6203","베이비 드라이버","2018-02-19","1",36,823432,55
"6204","베이비 드라이버","2018-02-23","3",59,823491,56
"6205","베이비 드라이버","2018-02-27","1",21,823512,57
"6206","베이비 드라이버","2018-02-28","3",32,823544,58
"6207","베이비 드라이버","2018-03-04","3",80,823624,59
"6208","위대한 쇼맨","2017-12-11","3",1016,1016,0
"6209","위대한 쇼맨","2017-12-14","1",406,1422,0
"6210","위대한 쇼맨","2017-12-15","5",999,2421,0
"6211","위대한 쇼맨","2017-12-18","5",1004,3425,0
"6212","위대한 쇼맨","2017-12-19","1",158,3583,0
"6213","위대한 쇼맨","2017-12-20","649",40995,44578,1
"6214","위대한 쇼맨","2017-12-21","661",44826,89404,2
"6215","위대한 쇼맨","2017-12-22","702",56303,145707,3
"6216","위대한 쇼맨","2017-12-23","658",98073,243780,4
"6217","위대한 쇼맨","2017-12-24","642",148266,392046,5
"6218","위대한 쇼맨","2017-12-25","638",155795,547841,6
"6219","위대한 쇼맨","2017-12-26","658",53836,601677,7
"6220","위대한 쇼맨","2017-12-27","424",36053,637730,8
"6221","위대한 쇼맨","2017-12-28","409",29446,667176,9
"6222","위대한 쇼맨","2017-12-29","411",39483,706659,10
"6223","위대한 쇼맨","2017-12-30","407",50258,756917,11
"6224","위대한 쇼맨","2017-12-31","412",57668,814585,12
"6225","위대한 쇼맨","2018-01-01","432",60070,874655,13
"6226","위대한 쇼맨","2018-01-02","444",35177,909832,14
"6227","위대한 쇼맨","2018-01-03","366",25851,935683,15
"6228","위대한 쇼맨","2018-01-04","348",24109,959792,16
"6229","위대한 쇼맨","2018-01-05","346",28042,987834,17
"6230","위대한 쇼맨","2018-01-06","353",43965,1031799,18
"6231","위대한 쇼맨","2018-01-07","352",40085,1071884,19
"6232","위대한 쇼맨","2018-01-08","368",21194,1093078,20
"6233","위대한 쇼맨","2018-01-09","371",21217,1114295,21
"6234","위대한 쇼맨","2018-01-10","377",22621,1136916,22
"6235","위대한 쇼맨","2018-01-11","203",11648,1148564,23
"6236","위대한 쇼맨","2018-01-12","224",15055,1163619,24
"6237","위대한 쇼맨","2018-01-13","222",24602,1188221,25
"6238","위대한 쇼맨","2018-01-14","232",23253,1211474,26
"6239","위대한 쇼맨","2018-01-15","237",13580,1225054,27
"6240","위대한 쇼맨","2018-01-16","234",14645,1239699,28
"6241","위대한 쇼맨","2018-01-17","108",6509,1246208,29
"6242","위대한 쇼맨","2018-01-18","108",5824,1252032,30
"6243","위대한 쇼맨","2018-01-19","113",7073,1259105,31
"6244","위대한 쇼맨","2018-01-20","121",10982,1270087,32
"6245","위대한 쇼맨","2018-01-21","121",10385,1280472,33
"6246","위대한 쇼맨","2018-01-22","135",5826,1286298,34
"6247","위대한 쇼맨","2018-01-23","144",5879,1292177,35
"6248","위대한 쇼맨","2018-01-24","106",4131,1296308,36
"6249","위대한 쇼맨","2018-01-25","104",3722,1300030,37
"6250","위대한 쇼맨","2018-01-26","111",4590,1304620,38
"6251","위대한 쇼맨","2018-01-27","103",7589,1312209,39
"6252","위대한 쇼맨","2018-01-28","101",7070,1319279,40
"6253","위대한 쇼맨","2018-01-29","113",4118,1323397,41
"6254","위대한 쇼맨","2018-01-30","110",4286,1327683,42
"6255","위대한 쇼맨","2018-01-31","62",3442,1331125,43
"6256","위대한 쇼맨","2018-02-01","61",2556,1333681,44
"6257","위대한 쇼맨","2018-02-02","65",2621,1336302,45
"6258","위대한 쇼맨","2018-02-03","78",5365,1341667,46
"6259","위대한 쇼맨","2018-02-04","72",4952,1346619,47
"6260","위대한 쇼맨","2018-02-05","73",2575,1349194,48
"6261","위대한 쇼맨","2018-02-06","77",2575,1351769,49
"6262","위대한 쇼맨","2018-02-07","82",2847,1354616,50
"6263","위대한 쇼맨","2018-02-08","53",1768,1356384,51
"6264","위대한 쇼맨","2018-02-09","58",2421,1358805,52
"6265","위대한 쇼맨","2018-02-10","66",4602,1363407,53
"6266","위대한 쇼맨","2018-02-11","78",4894,1368301,54
"6267","위대한 쇼맨","2018-02-12","65",2396,1370697,55
"6268","위대한 쇼맨","2018-02-13","65",2353,1373050,56
"6269","위대한 쇼맨","2018-02-14","40",1371,1374421,57
"6270","위대한 쇼맨","2018-02-15","36",1677,1376098,58
"6271","위대한 쇼맨","2018-02-16","42",2247,1378345,59
"6272","위대한 쇼맨","2018-02-17","51",3204,1381549,60
"6273","위대한 쇼맨","2018-02-18","49",2656,1384205,61
"6274","위대한 쇼맨","2018-02-19","42",1216,1385421,62
"6275","위대한 쇼맨","2018-02-20","45",1311,1386732,63
"6276","위대한 쇼맨","2018-02-21","40",1120,1387852,64
"6277","위대한 쇼맨","2018-02-22","32",943,1388795,65
"6278","위대한 쇼맨","2018-02-23","27",855,1389650,66
"6279","위대한 쇼맨","2018-02-24","27",1416,1391066,67
"6280","위대한 쇼맨","2018-02-25","29",1460,1392526,68
"6281","위대한 쇼맨","2018-02-26","30",1025,1393551,69
"6282","위대한 쇼맨","2018-02-27","26",954,1394505,70
"6283","위대한 쇼맨","2018-02-28","11",279,1394784,71
"6284","위대한 쇼맨","2018-03-01","12",603,1395387,72
"6285","위대한 쇼맨","2018-03-02","16",253,1395640,73
"6286","위대한 쇼맨","2018-03-03","14",538,1396178,74
"6287","위대한 쇼맨","2018-03-04","14",487,1396665,75
"6288","위대한 쇼맨","2018-03-05","13",197,1396862,76
"6289","위대한 쇼맨","2018-03-06","12",187,1397049,77
"6290","위대한 쇼맨","2018-03-07","7",103,1397152,78
"6291","위대한 쇼맨","2018-03-08","6",76,1397228,79
"6292","위대한 쇼맨","2018-03-09","11",221,1397449,80
"6293","위대한 쇼맨","2018-03-10","11",462,1397911,81
"6294","위대한 쇼맨","2018-03-11","8",324,1398235,82
"6295","위대한 쇼맨","2018-03-12","9",127,1398362,83
"6296","위대한 쇼맨","2018-03-13","10",109,1398471,84
"6297","위대한 쇼맨","2018-03-14","6",108,1398579,85
"6298","위대한 쇼맨","2018-03-15","6",60,1398639,86
"6299","위대한 쇼맨","2018-03-16","7",126,1398765,87
"6300","위대한 쇼맨","2018-03-17","6",261,1399026,88
"6301","위대한 쇼맨","2018-03-18","6",234,1399260,89
"6302","위대한 쇼맨","2018-03-19","4",76,1399336,90
"6303","위대한 쇼맨","2018-03-20","5",84,1399420,91
"6304","위대한 쇼맨","2018-03-21","4",60,1399480,92
"6305","위대한 쇼맨","2018-03-22","3",45,1399525,93
"6306","위대한 쇼맨","2018-03-23","4",78,1399603,94
"6307","위대한 쇼맨","2018-03-24","4",179,1399782,95
"6308","위대한 쇼맨","2018-03-25","4",182,1399964,96
"6309","위대한 쇼맨","2018-03-26","3",61,1400025,97
"6310","위대한 쇼맨","2018-03-27","4",100,1400125,98
"6311","위대한 쇼맨","2018-03-28","3",49,1400174,99
"6312","위대한 쇼맨","2018-03-29","1",28,1400202,100
"6313","위대한 쇼맨","2018-03-30","1",17,1400219,101
"6314","위대한 쇼맨","2018-03-31","3",120,1400339,102
"6315","위대한 쇼맨","2018-04-01","2",83,1400422,103
"6316","위대한 쇼맨","2018-04-02","2",28,1400450,104
"6317","위대한 쇼맨","2018-04-03","3",30,1400480,105
"6318","위대한 쇼맨","2018-04-04","2",20,1400500,106
"6319","위대한 쇼맨","2018-04-05","1",19,1400519,107
"6320","위대한 쇼맨","2018-04-06","1",31,1400550,108
"6321","위대한 쇼맨","2018-04-07","2",56,1400606,109
"6322","위대한 쇼맨","2018-04-08","1",63,1400669,110
"6323","위대한 쇼맨","2018-04-09","1",43,1400712,111
"6324","위대한 쇼맨","2018-04-10","1",20,1400732,112
"6325","위대한 쇼맨","2018-04-11","1",32,1400764,113
"6326","위대한 쇼맨","2018-04-12","1",30,1400794,114
"6327","위대한 쇼맨","2018-04-13","2",16,1400810,115
"6328","위대한 쇼맨","2018-04-14","1",63,1400873,116
"6329","위대한 쇼맨","2018-04-15","1",18,1400891,117
"6330","위대한 쇼맨","2018-04-16","1",54,1400945,118
"6331","위대한 쇼맨","2018-04-17","1",20,1400965,119
"6332","위대한 쇼맨","2018-04-18","1",19,1400984,120
"6333","위대한 쇼맨","2018-04-19","1",26,1401010,121
"6334","위대한 쇼맨","2018-04-20","1",36,1401046,122
"6335","위대한 쇼맨","2018-04-21","1",30,1401076,123
"6336","위대한 쇼맨","2018-04-22","1",65,1401141,124
"6337","위대한 쇼맨","2018-04-23","1",26,1401167,125
"6338","위대한 쇼맨","2018-04-24","1",28,1401195,126
"6339","위대한 쇼맨","2018-04-25","1",17,1401212,127
"6340","위대한 쇼맨","2018-04-26","1",24,1401236,128
"6341","위대한 쇼맨","2018-04-27","1",49,1401285,129
"6342","위대한 쇼맨","2018-04-28","1",25,1401310,130
"6343","위대한 쇼맨","2018-04-29","1",26,1401336,131
"6344","위대한 쇼맨","2018-04-30","1",29,1401365,132
"6345","위대한 쇼맨","2018-05-01","1",36,1401401,133
"6346","위대한 쇼맨","2018-05-02","1",11,1401412,134
"6347","위대한 쇼맨","2018-05-03","1",33,1401445,135
"6348","위대한 쇼맨","2018-05-04","1",39,1401484,136
"6349","위대한 쇼맨","2018-05-05","2",48,1401532,137
"6350","위대한 쇼맨","2018-05-06","2",60,1401592,138
"6351","위대한 쇼맨","2018-05-07","2",105,1401697,139
"6352","위대한 쇼맨","2018-05-08","1",11,1401708,140
"6353","위대한 쇼맨","2018-05-09","1",29,1401737,141
"6354","위대한 쇼맨","2018-05-10","1",24,1401761,142
"6355","위대한 쇼맨","2018-05-11","1",57,1401818,143
"6356","위대한 쇼맨","2018-05-12","3",18,1401836,144
"6357","위대한 쇼맨","2018-05-13","3",54,1401890,145
"6358","위대한 쇼맨","2018-05-14","2",38,1401928,146
"6359","위대한 쇼맨","2018-05-15","3",61,1401989,147
"6360","위대한 쇼맨","2018-05-16","2",19,1402008,148
"6361","위대한 쇼맨","2018-05-17","2",32,1402040,149
"6362","위대한 쇼맨","2018-05-18","2",56,1402096,150
"6363","위대한 쇼맨","2018-05-19","1",43,1402139,151
"6364","위대한 쇼맨","2018-05-20","1",47,1402186,152
"6365","위대한 쇼맨","2018-05-21","1",40,1402226,153
"6366","위대한 쇼맨","2018-05-22","1",45,1402271,154
"6367","위대한 쇼맨","2018-05-23","1",13,1402284,155
"6368","위대한 쇼맨","2018-05-24","1",8,1402292,156
"6369","위대한 쇼맨","2018-05-25","1",8,1402300,157
"6370","위대한 쇼맨","2018-05-26","2",40,1402340,158
"6371","위대한 쇼맨","2018-05-27","2",51,1402391,159
"6372","위대한 쇼맨","2018-05-28","1",14,1402405,160
"6373","위대한 쇼맨","2018-05-29","1",17,1402422,161
"6374","위대한 쇼맨","2018-05-30","1",31,1402453,162
"6375","위대한 쇼맨","2018-05-31","1",12,1402465,163
"6376","위대한 쇼맨","2018-06-01","1",20,1402485,164
"6377","위대한 쇼맨","2018-06-02","1",31,1402516,165
"6378","위대한 쇼맨","2018-06-03","1",48,1402564,166
"6379","위대한 쇼맨","2018-06-04","1",10,1402574,167
"6380","위대한 쇼맨","2018-06-05","1",14,1402588,168
"6381","위대한 쇼맨","2018-06-06","1",22,1402610,169
"6382","위대한 쇼맨","2018-06-07","1",14,1402624,170
"6383","위대한 쇼맨","2018-06-08","1",24,1402648,171
"6384","위대한 쇼맨","2018-06-09","1",7,1402655,172
"6385","위대한 쇼맨","2018-06-10","1",10,1402665,173
"6386","위대한 쇼맨","2018-06-11","1",7,1402672,174
"6387","위대한 쇼맨","2018-06-12","1",5,1402677,175
"6388","위대한 쇼맨","2018-06-14","1",9,1402686,176
"6389","위대한 쇼맨","2018-06-15","1",10,1402696,177
"6390","위대한 쇼맨","2018-06-16","1",15,1402711,178
"6391","위대한 쇼맨","2018-06-17","1",13,1402724,179
"6392","위대한 쇼맨","2018-06-18","1",4,1402728,180
"6393","위대한 쇼맨","2018-06-19","1",7,1402735,181
"6394","위대한 쇼맨","2018-06-20","1",12,1402747,182
"6395","위대한 쇼맨","2018-06-21","1",2,1402749,183
"6396","위대한 쇼맨","2018-06-22","1",5,1402754,184
"6397","위대한 쇼맨","2018-06-23","1",8,1402762,185
"6398","위대한 쇼맨","2018-06-24","1",13,1402775,186
"6399","위대한 쇼맨","2018-06-25","1",9,1402784,187
"6400","위대한 쇼맨","2018-06-26","1",9,1402793,188
"6401","위대한 쇼맨","2018-06-27","1",3,1402796,189
"6402","위대한 쇼맨","2018-06-28","1",4,1402800,190
"6403","위대한 쇼맨","2018-06-29","1",7,1402807,191
"6404","위대한 쇼맨","2018-11-02","1",80,1402887,192
"6405","위대한 쇼맨","2018-11-24","1",132,1403019,193
"6406","레지던트 이블: 파멸의 날","2017-01-19","1",401,401,0
"6407","레지던트 이블: 파멸의 날","2017-01-25","545",71038,71439,1
"6408","레지던트 이블: 파멸의 날","2017-01-26","546",72754,144193,2
"6409","레지던트 이블: 파멸의 날","2017-01-27","578",78851,223044,3
"6410","레지던트 이블: 파멸의 날","2017-01-28","585",83047,306091,4
"6411","레지던트 이블: 파멸의 날","2017-01-29","599",103452,409543,5
"6412","레지던트 이블: 파멸의 날","2017-01-30","576",90436,499979,6
"6413","레지던트 이블: 파멸의 날","2017-01-31","541",47201,547180,7
"6414","레지던트 이블: 파멸의 날","2017-02-01","497",29001,576181,8
"6415","레지던트 이블: 파멸의 날","2017-02-02","446",21561,597742,9
"6416","레지던트 이블: 파멸의 날","2017-02-03","468",25268,623010,10
"6417","레지던트 이블: 파멸의 날","2017-02-04","486",46339,669349,11
"6418","레지던트 이블: 파멸의 날","2017-02-05","473",38653,708002,12
"6419","레지던트 이블: 파멸의 날","2017-02-06","465",15899,723901,13
"6420","레지던트 이블: 파멸의 날","2017-02-07","462",14727,738628,14
"6421","레지던트 이블: 파멸의 날","2017-02-08","348",9824,748452,15
"6422","레지던트 이블: 파멸의 날","2017-02-09","108",2250,750702,16
"6423","레지던트 이블: 파멸의 날","2017-02-10","112",2635,753337,17
"6424","레지던트 이블: 파멸의 날","2017-02-11","101",4265,757602,18
"6425","레지던트 이블: 파멸의 날","2017-02-12","101",3572,761174,19
"6426","레지던트 이블: 파멸의 날","2017-02-13","105",1697,762871,20
"6427","레지던트 이블: 파멸의 날","2017-02-14","102",1802,764673,21
"6428","레지던트 이블: 파멸의 날","2017-02-15","4",90,764763,22
"6429","레지던트 이블: 파멸의 날","2017-02-16","1",21,764784,23
"6430","레지던트 이블: 파멸의 날","2017-02-17","1",128,764912,24
"6431","레지던트 이블: 파멸의 날","2017-02-18","1",125,765037,25
"6432","레지던트 이블: 파멸의 날","2017-02-19","2",98,765135,26
"6433","레지던트 이블: 파멸의 날","2017-02-20","1",31,765166,27
"6434","레지던트 이블: 파멸의 날","2017-02-21","1",93,765259,28
"6435","공각기동대 : 고스트 인 더 쉘","2017-03-27","1",401,401,0
"6436","공각기동대 : 고스트 인 더 쉘","2017-03-28","3",782,1183,0
"6437","공각기동대 : 고스트 인 더 쉘","2017-03-29","763",114618,115801,1
"6438","공각기동대 : 고스트 인 더 쉘","2017-03-30","752",61598,177399,2
"6439","공각기동대 : 고스트 인 더 쉘","2017-03-31","761",85348,262747,3
"6440","공각기동대 : 고스트 인 더 쉘","2017-04-01","807",177091,439838,4
"6441","공각기동대 : 고스트 인 더 쉘","2017-04-02","759",129863,569701,5
"6442","공각기동대 : 고스트 인 더 쉘","2017-04-03","736",33326,603027,6
"6443","공각기동대 : 고스트 인 더 쉘","2017-04-04","732",29398,632425,7
"6444","공각기동대 : 고스트 인 더 쉘","2017-04-05","482",19047,651472,8
"6445","공각기동대 : 고스트 인 더 쉘","2017-04-06","454",15135,666607,9
"6446","공각기동대 : 고스트 인 더 쉘","2017-04-07","474",16857,683464,10
"6447","공각기동대 : 고스트 인 더 쉘","2017-04-08","483",28396,711860,11
"6448","공각기동대 : 고스트 인 더 쉘","2017-04-09","482",23476,735336,12
"6449","공각기동대 : 고스트 인 더 쉘","2017-04-10","437",7628,742964,13
"6450","공각기동대 : 고스트 인 더 쉘","2017-04-11","438",7082,750046,14
"6451","공각기동대 : 고스트 인 더 쉘","2017-04-12","151",1533,751579,15
"6452","공각기동대 : 고스트 인 더 쉘","2017-04-13","136",969,752548,16
"6453","공각기동대 : 고스트 인 더 쉘","2017-04-14","135",1405,753953,17
"6454","공각기동대 : 고스트 인 더 쉘","2017-04-15","119",1952,755905,18
"6455","공각기동대 : 고스트 인 더 쉘","2017-04-16","114",1689,757594,19
"6456","공각기동대 : 고스트 인 더 쉘","2017-04-17","120",901,758495,20
"6457","공각기동대 : 고스트 인 더 쉘","2017-04-18","109",637,759132,21
"6458","공각기동대 : 고스트 인 더 쉘","2017-04-19","109",650,759782,22
"6459","공각기동대 : 고스트 인 더 쉘","2017-04-20","4",135,759917,23
"6460","공각기동대 : 고스트 인 더 쉘","2017-04-21","4",32,759949,24
"6461","공각기동대 : 고스트 인 더 쉘","2017-04-22","6",150,760099,25
"6462","공각기동대 : 고스트 인 더 쉘","2017-04-23","7",91,760190,26
"6463","공각기동대 : 고스트 인 더 쉘","2017-04-24","6",50,760240,27
"6464","공각기동대 : 고스트 인 더 쉘","2017-04-25","5",47,760287,28
"6465","공각기동대 : 고스트 인 더 쉘","2017-04-29","2",38,760325,29
"6466","공각기동대 : 고스트 인 더 쉘","2017-04-30","1",24,760349,30
"6467","공각기동대 : 고스트 인 더 쉘","2017-05-01","5",540,760889,31
"6468","공각기동대 : 고스트 인 더 쉘","2017-05-02","5",516,761405,32
"6469","공각기동대 : 고스트 인 더 쉘","2017-05-03","2",213,761618,33
"6470","공각기동대 : 고스트 인 더 쉘","2017-05-04","2",208,761826,34
"6471","공각기동대 : 고스트 인 더 쉘","2017-05-05","2",210,762036,35
"6472","공각기동대 : 고스트 인 더 쉘","2017-05-06","2",207,762243,36
"6473","공각기동대 : 고스트 인 더 쉘","2017-05-07","2",205,762448,37
"6474","공각기동대 : 고스트 인 더 쉘","2017-05-08","2",205,762653,38
"6475","공각기동대 : 고스트 인 더 쉘","2017-05-09","2",203,762856,39
"6476","공각기동대 : 고스트 인 더 쉘","2017-05-10","2",200,763056,40
"6477","공각기동대 : 고스트 인 더 쉘","2017-05-11","2",200,763256,41
"6478","공각기동대 : 고스트 인 더 쉘","2017-05-12","2",201,763457,42
"6479","공각기동대 : 고스트 인 더 쉘","2017-05-13","2",207,763664,43
"6480","공각기동대 : 고스트 인 더 쉘","2017-05-14","2",202,763866,44
"6481","공각기동대 : 고스트 인 더 쉘","2017-05-15","2",206,764072,45
"6482","트롤","2017-02-08","5",1011,1011,0
"6483","트롤","2017-02-09","2",364,1375,0
"6484","트롤","2017-02-10","3",603,1978,0
"6485","트롤","2017-02-16","507",29500,31478,1
"6486","트롤","2017-02-17","529",31417,62895,2
"6487","트롤","2017-02-18","592",76759,139654,3
"6488","트롤","2017-02-19","622",76052,215706,4
"6489","트롤","2017-02-20","518",25368,241074,5
"6490","트롤","2017-02-21","520",31739,272813,6
"6491","트롤","2017-02-22","415",28695,301508,7
"6492","트롤","2017-02-23","406",33028,334536,8
"6493","트롤","2017-02-24","443",33390,367926,9
"6494","트롤","2017-02-25","536",50733,418659,10
"6495","트롤","2017-02-26","519",48393,467052,11
"6496","트롤","2017-02-27","426",31281,498333,12
"6497","트롤","2017-02-28","411",35276,533609,13
"6498","트롤","2017-03-01","383",55644,589253,14
"6499","트롤","2017-03-02","250",5369,594622,15
"6500","트롤","2017-03-03","233",2958,597580,16
"6501","트롤","2017-03-04","395",22276,619856,17
"6502","트롤","2017-03-05","389",22796,642652,18
"6503","트롤","2017-03-06","181",1025,643677,19
"6504","트롤","2017-03-07","189",964,644641,20
"6505","트롤","2017-03-08","113",679,645320,21
"6506","트롤","2017-03-09","82",491,645811,22
"6507","트롤","2017-03-10","93",709,646520,23
"6508","트롤","2017-03-11","254",10297,656817,24
"6509","트롤","2017-03-12","263",12445,669262,25
"6510","트롤","2017-03-13","81",443,669705,26
"6511","트롤","2017-03-14","77",447,670152,27
"6512","트롤","2017-03-15","93",573,670725,28
"6513","트롤","2017-03-16","11",58,670783,29
"6514","트롤","2017-03-17","14",55,670838,30
"6515","트롤","2017-03-18","70",2019,672857,31
"6516","트롤","2017-03-19","67",1839,674696,32
"6517","트롤","2017-03-20","12",40,674736,33
"6518","트롤","2017-03-21","12",124,674860,34
"6519","트롤","2017-03-22","4",12,674872,35
"6520","트롤","2017-03-23","2",17,674889,36
"6521","트롤","2017-03-24","2",87,674976,37
"6522","트롤","2017-03-25","9",229,675205,38
"6523","트롤","2017-03-26","8",128,675333,39
"6524","트롤","2017-03-27","1",5,675338,40
"6525","트롤","2017-03-28","1",2,675340,41
"6526","트롤","2017-03-29","1",26,675366,42
"6527","트롤","2017-03-31","4",120,675486,43
"6528","트롤","2017-04-01","5",150,675636,44
"6529","트롤","2017-04-02","5",150,675786,45
"6530","트롤","2017-04-03","5",150,675936,46
"6531","트롤","2017-04-04","1",30,675966,47
"6532","패신저스","2016-12-26","1",401,401,0
"6533","패신저스","2017-01-04","524",85044,85445,1
"6534","패신저스","2017-01-05","530",67929,153374,2
"6535","패신저스","2017-01-06","567",72707,226081,3
"6536","패신저스","2017-01-07","603",148502,374583,4
"6537","패신저스","2017-01-08","608",129810,504393,5
"6538","패신저스","2017-01-09","549",36992,541385,6
"6539","패신저스","2017-01-10","550",33095,574480,7
"6540","패신저스","2017-01-11","436",17473,591953,8
"6541","패신저스","2017-01-12","397",11093,603046,9
"6542","패신저스","2017-01-13","394",12752,615798,10
"6543","패신저스","2017-01-14","368",21708,637506,11
"6544","패신저스","2017-01-15","355",17377,654883,12
"6545","패신저스","2017-01-16","345",5778,660661,13
"6546","패신저스","2017-01-17","333",5624,666285,14
"6547","패신저스","2017-01-18","11",138,666423,15
"6548","패신저스","2017-01-19","5",29,666452,16
"6549","패신저스","2017-01-20","7",116,666568,17
"6550","패신저스","2017-01-21","7",518,667086,18
"6551","패신저스","2017-01-22","4",80,667166,19
"6552","패신저스","2017-01-23","7",242,667408,20
"6553","패신저스","2017-01-24","6",113,667521,21
"6554","패신저스","2017-02-02","2",104,667625,22
"6555","패신저스","2017-02-03","2",104,667729,23
"6556","패신저스","2017-02-04","2",104,667833,24
"6557","패신저스","2017-02-05","2",104,667937,25
"6558","패신저스","2017-02-06","2",104,668041,26
"6559","패신저스","2017-02-07","2",104,668145,27
"6560","패신저스","2017-02-08","2",104,668249,28
"6561","패신저스","2017-02-09","2",104,668353,29
"6562","패신저스","2017-02-10","2",104,668457,30
"6563","패신저스","2017-02-11","2",104,668561,31
"6564","패신저스","2017-02-12","2",104,668665,32
"6565","패신저스","2017-02-13","2",104,668769,33
"6566","패신저스","2017-02-14","2",104,668873,34
"6567","패신저스","2017-02-15","2",104,668977,35
"6568","씽","2016-11-24","2",1262,1262,0
"6569","씽","2016-12-13","9",2397,3659,0
"6570","씽","2016-12-15","7",1560,5219,0
"6571","씽","2016-12-20","3",678,5897,0
"6572","씽","2016-12-21","555",30628,36525,1
"6573","씽","2016-12-22","566",32889,69414,2
"6574","씽","2016-12-23","564",43413,112827,3
"6575","씽","2016-12-24","771",214990,327817,4
"6576","씽","2016-12-25","795",239197,567014,5
"6577","씽","2016-12-26","597",52504,619518,6
"6578","씽","2016-12-27","644",61927,681445,7
"6579","씽","2016-12-28","581",69659,751104,8
"6580","씽","2016-12-29","585",78378,829482,9
"6581","씽","2016-12-30","631",100025,929507,10
"6582","씽","2016-12-31","690",133668,1063175,11
"6583","씽","2017-01-01","721",115152,1178327,12
"6584","씽","2017-01-02","647",70667,1248994,13
"6585","씽","2017-01-03","681",70773,1319767,14
"6586","씽","2017-01-04","533",44224,1363991,15
"6587","씽","2017-01-05","553",41738,1405729,16
"6588","씽","2017-01-06","566",40419,1446148,17
"6589","씽","2017-01-07","573",74686,1520834,18
"6590","씽","2017-01-08","575",68237,1589071,19
"6591","씽","2017-01-09","494",21302,1610373,20
"6592","씽","2017-01-10","500",25162,1635535,21
"6593","씽","2017-01-11","381",19209,1654744,22
"6594","씽","2017-01-12","279",9271,1664015,23
"6595","씽","2017-01-13","273",8708,1672723,24
"6596","씽","2017-01-14","286",19241,1691964,25
"6597","씽","2017-01-15","280",18093,1710057,26
"6598","씽","2017-01-16","254",4431,1714488,27
"6599","씽","2017-01-17","260",6390,1720878,28
"6600","씽","2017-01-18","43",1453,1722331,29
"6601","씽","2017-01-19","42",1296,1723627,30
"6602","씽","2017-01-20","36",783,1724410,31
"6603","씽","2017-01-21","42",2046,1726456,32
"6604","씽","2017-01-22","39",1793,1728249,33
"6605","씽","2017-01-23","28",427,1728676,34
"6606","씽","2017-01-24","32",983,1729659,35
"6607","씽","2017-01-25","3",56,1729715,36
"6608","씽","2017-01-26","5",149,1729864,37
"6609","씽","2017-01-27","2",98,1729962,38
"6610","씽","2017-01-28","2",67,1730029,39
"6611","씽","2017-01-29","3",98,1730127,40
"6612","씽","2017-01-30","3",132,1730259,41
"6613","씽","2017-01-31","2",39,1730298,42
"6614","씽","2017-02-01","1",87,1730385,43
"6615","씽","2017-02-02","1",103,1730488,44
"6616","씽","2017-02-03","1",50,1730538,45
"6617","씽","2017-02-04","1",18,1730556,46
"6618","씽","2017-02-05","1",27,1730583,47
"6619","씽","2017-02-09","2",97,1730680,48
"6620","씽","2017-02-15","1",1,1730681,49
"6621","씽","2017-02-28","1",7,1730688,50
"6622","씽","2017-07-26","1",43,1730731,51
"6623","씽","2017-10-12","1",4,1730735,52
"6624","씽","2017-10-13","1",1,1730736,53
"6625","씽","2017-10-14","1",6,1730742,54
"6626","씽","2017-10-15","1",19,1730761,55
"6627","씽","2017-10-16","1",3,1730764,56
"6628","씽","2017-10-17","1",5,1730769,57
"6629","씽","2017-10-18","1",4,1730773,58
"6630","컨택트","2017-01-17","8",2491,2491,0
"6631","컨택트","2017-01-26","1",326,2817,0
"6632","컨택트","2017-01-31","18",2011,4828,0
"6633","컨택트","2017-02-01","1",2,4830,0
"6634","컨택트","2017-02-02","509",54584,59414,1
"6635","컨택트","2017-02-03","558",61006,120420,2
"6636","컨택트","2017-02-04","605",126370,246790,3
"6637","컨택트","2017-02-05","598",111552,358342,4
"6638","컨택트","2017-02-06","546",36897,395239,5
"6639","컨택트","2017-02-07","558",34217,429456,6
"6640","컨택트","2017-02-08","483",28406,457862,7
"6641","컨택트","2017-02-09","399",16178,474040,8
"6642","컨택트","2017-02-10","416",19578,493618,9
"6643","컨택트","2017-02-11","422",37935,531553,10
"6644","컨택트","2017-02-12","417",32438,563991,11
"6645","컨택트","2017-02-13","390",11734,575725,12
"6646","컨택트","2017-02-14","395",12914,588639,13
"6647","컨택트","2017-02-15","93",3032,591671,14
"6648","컨택트","2017-02-16","82",3155,594826,15
"6649","컨택트","2017-02-17","77",3682,598508,16
"6650","컨택트","2017-02-18","81",6923,605431,17
"6651","컨택트","2017-02-19","86",6181,611612,18
"6652","컨택트","2017-02-20","76",2919,614531,19
"6653","컨택트","2017-02-21","82",2716,617247,20
"6654","컨택트","2017-02-22","40",1734,618981,21
"6655","컨택트","2017-02-23","38",1122,620103,22
"6656","컨택트","2017-02-24","40",1180,621283,23
"6657","컨택트","2017-02-25","43",2717,624000,24
"6658","컨택트","2017-02-26","39",2319,626319,25
"6659","컨택트","2017-02-27","39",1234,627553,26
"6660","컨택트","2017-02-28","32",1142,628695,27
"6661","컨택트","2017-03-01","16",1076,629771,28
"6662","컨택트","2017-03-02","12",341,630112,29
"6663","컨택트","2017-03-03","10",326,630438,30
"6664","컨택트","2017-03-04","10",537,630975,31
"6665","컨택트","2017-03-05","12",400,631375,32
"6666","컨택트","2017-03-06","13",361,631736,33
"6667","컨택트","2017-03-07","12",261,631997,34
"6668","컨택트","2017-03-08","9",138,632135,35
"6669","컨택트","2017-03-09","10",188,632323,36
"6670","컨택트","2017-03-10","5",153,632476,37
"6671","컨택트","2017-03-11","7",346,632822,38
"6672","컨택트","2017-03-12","7",300,633122,39
"6673","컨택트","2017-03-13","7",125,633247,40
"6674","컨택트","2017-03-14","6",128,633375,41
"6675","컨택트","2017-03-15","8",189,633564,42
"6676","컨택트","2017-03-16","5",43,633607,43
"6677","컨택트","2017-03-17","3",79,633686,44
"6678","컨택트","2017-03-18","5",142,633828,45
"6679","컨택트","2017-03-19","5",127,633955,46
"6680","컨택트","2017-03-20","4",42,633997,47
"6681","컨택트","2017-03-21","5",63,634060,48
"6682","컨택트","2017-03-22","4",48,634108,49
"6683","컨택트","2017-03-24","1",10,634118,50
"6684","컨택트","2017-03-25","1",8,634126,51
"6685","컨택트","2017-03-26","1",2,634128,52
"6686","컨택트","2017-03-27","1",2,634130,53
"6687","컨택트","2017-03-28","2",12,634142,54
"6688","컨택트","2017-03-30","1",8,634150,55
"6689","47 미터","2017-07-12","1",218,218,0
"6690","47 미터","2017-07-13","3",1147,1365,0
"6691","47 미터","2017-07-14","3",681,2046,0
"6692","47 미터","2017-07-17","5",1011,3057,0
"6693","47 미터","2017-07-18","2",430,3487,0
"6694","47 미터","2017-07-19","542",72116,75603,1
"6695","47 미터","2017-07-20","605",62644,138247,2
"6696","47 미터","2017-07-21","701",77370,215617,3
"6697","47 미터","2017-07-22","733",116795,332412,4
"6698","47 미터","2017-07-23","711",107567,439979,5
"6699","47 미터","2017-07-24","622",43729,483708,6
"6700","47 미터","2017-07-25","633",39636,523344,7
"6701","47 미터","2017-07-26","364",13314,536658,8
"6702","47 미터","2017-07-27","355",8153,544811,9
"6703","47 미터","2017-07-28","339",8849,553660,10
"6704","47 미터","2017-07-29","308",9800,563460,11
"6705","47 미터","2017-07-30","318",9441,572901,12
"6706","47 미터","2017-07-31","318",7760,580661,13
"6707","47 미터","2017-08-01","323",7384,588045,14
"6708","47 미터","2017-08-02","29",331,588376,15
"6709","47 미터","2017-08-03","18",235,588611,16
"6710","47 미터","2017-08-04","30",268,588879,17
"6711","47 미터","2017-08-05","32",333,589212,18
"6712","47 미터","2017-08-06","28",239,589451,19
"6713","47 미터","2017-08-07","23",161,589612,20
"6714","47 미터","2017-08-08","17",154,589766,21
"6715","47 미터","2017-08-09","5",42,589808,22
"6716","47 미터","2017-08-10","4",29,589837,23
"6717","47 미터","2017-08-11","2",19,589856,24
"6718","47 미터","2017-08-12","2",19,589875,25
"6719","47 미터","2017-08-13","2",32,589907,26
"6720","47 미터","2017-08-14","2",19,589926,27
"6721","47 미터","2017-08-15","1",5,589931,28
"6722","47 미터","2017-08-17","18",75,590006,29
"6723","47 미터","2017-08-18","1",1,590007,30
"6724","47 미터","2017-08-25","5",5,590012,31
"6725","47 미터","2017-08-26","5",5,590017,32
"6726","47 미터","2017-08-27","4",4,590021,33
"6727","47 미터","2017-08-28","5",5,590026,34
"6728","47 미터","2017-08-29","5",5,590031,35
"6729","47 미터","2017-08-30","5",5,590036,36
"6730","47 미터","2017-11-18","1",4,590040,37
"6731","47 미터","2017-11-19","1",1,590041,38
"6732","47 미터","2017-11-21","1",4,590045,39
"6733","메리와 마녀의 꽃","2017-11-28","1",247,247,0
"6734","메리와 마녀의 꽃","2017-12-05","8",1395,1642,0
"6735","메리와 마녀의 꽃","2017-12-06","3",575,2217,0
"6736","메리와 마녀의 꽃","2017-12-07","562",40101,42318,1
"6737","메리와 마녀의 꽃","2017-12-08","605",45209,87527,2
"6738","메리와 마녀의 꽃","2017-12-09","751",117124,204651,3
"6739","메리와 마녀의 꽃","2017-12-10","743",105338,309989,4
"6740","메리와 마녀의 꽃","2017-12-11","615",25099,335088,5
"6741","메리와 마녀의 꽃","2017-12-12","598",21252,356340,6
"6742","메리와 마녀의 꽃","2017-12-13","581",24937,381277,7
"6743","메리와 마녀의 꽃","2017-12-14","416",13500,394777,8
"6744","메리와 마녀의 꽃","2017-12-15","427",17323,412100,9
"6745","메리와 마녀의 꽃","2017-12-16","506",41468,453568,10
"6746","메리와 마녀의 꽃","2017-12-17","512",39865,493433,11
"6747","메리와 마녀의 꽃","2017-12-18","404",7968,501401,12
"6748","메리와 마녀의 꽃","2017-12-19","403",8705,510106,13
"6749","메리와 마녀의 꽃","2017-12-20","171",3800,513906,14
"6750","메리와 마녀의 꽃","2017-12-21","78",2284,516190,15
"6751","메리와 마녀의 꽃","2017-12-22","71",1821,518011,16
"6752","메리와 마녀의 꽃","2017-12-23","101",3809,521820,17
"6753","메리와 마녀의 꽃","2017-12-24","97",5195,527015,18
"6754","메리와 마녀의 꽃","2017-12-25","91",5449,532464,19
"6755","메리와 마녀의 꽃","2017-12-26","66",1135,533599,20
"6756","메리와 마녀의 꽃","2017-12-27","10",609,534208,21
"6757","메리와 마녀의 꽃","2017-12-28","10",367,534575,22
"6758","메리와 마녀의 꽃","2017-12-29","6",346,534921,23
"6759","메리와 마녀의 꽃","2017-12-30","8",272,535193,24
"6760","메리와 마녀의 꽃","2017-12-31","8",138,535331,25
"6761","메리와 마녀의 꽃","2018-01-01","5",73,535404,26
"6762","메리와 마녀의 꽃","2018-01-02","4",72,535476,27
"6763","메리와 마녀의 꽃","2018-01-03","2",17,535493,28
"6764","메리와 마녀의 꽃","2018-01-04","2",46,535539,29
"6765","메리와 마녀의 꽃","2018-01-05","1",52,535591,30
"6766","메리와 마녀의 꽃","2018-01-06","1",2,535593,31
"6767","메리와 마녀의 꽃","2018-01-08","1",8,535601,32
"6768","메리와 마녀의 꽃","2018-02-21","1",10,535611,33
"6769","메리와 마녀의 꽃","2018-02-22","1",12,535623,34
"6770","메리와 마녀의 꽃","2018-02-23","1",16,535639,35
"6771","메리와 마녀의 꽃","2018-02-24","1",9,535648,36
"6772","메리와 마녀의 꽃","2018-02-25","1",21,535669,37
"6773","얼라이드","2016-12-20","1",268,268,0
"6774","얼라이드","2016-12-28","1",401,669,0
"6775","얼라이드","2016-12-29","3",893,1562,0
"6776","얼라이드","2017-01-03","2",617,2179,0
"6777","얼라이드","2017-01-04","7",1059,3238,0
"6778","얼라이드","2017-01-06","2",492,3730,0
"6779","얼라이드","2017-01-09","1",218,3948,0
"6780","얼라이드","2017-01-11","488",43776,47724,1
"6781","얼라이드","2017-01-12","496",43512,91236,2
"6782","얼라이드","2017-01-13","528",51445,142681,3
"6783","얼라이드","2017-01-14","540",101641,244322,4
"6784","얼라이드","2017-01-15","546",93567,337889,5
"6785","얼라이드","2017-01-16","521",36848,374737,6
"6786","얼라이드","2017-01-17","520",34506,409243,7
"6787","얼라이드","2017-01-18","334",8918,418161,8
"6788","얼라이드","2017-01-19","338",8125,426286,9
"6789","얼라이드","2017-01-20","329",9058,435344,10
"6790","얼라이드","2017-01-21","300",14237,449581,11
"6791","얼라이드","2017-01-22","289",12089,461670,12
"6792","얼라이드","2017-01-23","297",6012,467682,13
"6793","얼라이드","2017-01-24","311",6427,474109,14
"6794","얼라이드","2017-01-25","151",3858,477967,15
"6795","얼라이드","2017-01-26","144",3764,481731,16
"6796","얼라이드","2017-01-27","128",4794,486525,17
"6797","얼라이드","2017-01-28","134",6335,492860,18
"6798","얼라이드","2017-01-29","133",6818,499678,19
"6799","얼라이드","2017-01-30","137",6706,506384,20
"6800","얼라이드","2017-01-31","140",3023,509407,21
"6801","얼라이드","2017-02-01","83",1730,511137,22
"6802","얼라이드","2017-02-02","42",1000,512137,23
"6803","얼라이드","2017-02-03","39",1012,513149,24
"6804","얼라이드","2017-02-04","35",1682,514831,25
"6805","얼라이드","2017-02-05","36",1472,516303,26
"6806","얼라이드","2017-02-06","36",819,517122,27
"6807","얼라이드","2017-02-07","42",669,517791,28
"6808","얼라이드","2017-02-08","24",395,518186,29
"6809","얼라이드","2017-02-09","9",311,518497,30
"6810","얼라이드","2017-02-10","10",595,519092,31
"6811","얼라이드","2017-02-11","5",179,519271,32
"6812","얼라이드","2017-02-12","5",85,519356,33
"6813","얼라이드","2017-02-13","5",171,519527,34
"6814","얼라이드","2017-02-14","4",112,519639,35
"6815","얼라이드","2017-02-15","3",103,519742,36
"6816","얼라이드","2017-02-16","3",112,519854,37
"6817","얼라이드","2017-02-17","2",157,520011,38
"6818","얼라이드","2017-02-18","3",141,520152,39
"6819","얼라이드","2017-02-19","2",69,520221,40
"6820","얼라이드","2017-02-20","2",72,520293,41
"6821","얼라이드","2017-02-21","2",85,520378,42
"6822","얼라이드","2017-02-22","2",70,520448,43
"6823","얼라이드","2017-03-16","1",0,520448,44
"6824","얼라이드","2017-04-25","1",0,520448,45
"6825","얼라이드","2017-04-28","1",0,520448,46
"6826","발레리안: 천 개 행성의 도시","2017-08-11","1",166,166,0
"6827","발레리안: 천 개 행성의 도시","2017-08-22","7",2526,2692,0
"6828","발레리안: 천 개 행성의 도시","2017-08-23","3",794,3486,0
"6829","발레리안: 천 개 행성의 도시","2017-08-24","6",808,4294,0
"6830","발레리안: 천 개 행성의 도시","2017-08-25","2",430,4724,0
"6831","발레리안: 천 개 행성의 도시","2017-08-26","41",1627,6351,0
"6832","발레리안: 천 개 행성의 도시","2017-08-27","40",1967,8318,0
"6833","발레리안: 천 개 행성의 도시","2017-08-28","7",903,9221,0
"6834","발레리안: 천 개 행성의 도시","2017-08-29","5",500,9721,0
"6835","발레리안: 천 개 행성의 도시","2017-08-30","614",70846,80567,1
"6836","발레리안: 천 개 행성의 도시","2017-08-31","593",40080,120647,2
"6837","발레리안: 천 개 행성의 도시","2017-09-01","583",46692,167339,3
"6838","발레리안: 천 개 행성의 도시","2017-09-02","629",108271,275610,4
"6839","발레리안: 천 개 행성의 도시","2017-09-03","622",94528,370138,5
"6840","발레리안: 천 개 행성의 도시","2017-09-04","559",23001,393139,6
"6841","발레리안: 천 개 행성의 도시","2017-09-05","570",20730,413869,7
"6842","발레리안: 천 개 행성의 도시","2017-09-06","419",10640,424509,8
"6843","발레리안: 천 개 행성의 도시","2017-09-07","401",8707,433216,9
"6844","발레리안: 천 개 행성의 도시","2017-09-08","411",10886,444102,10
"6845","발레리안: 천 개 행성의 도시","2017-09-09","411",25559,469661,11
"6846","발레리안: 천 개 행성의 도시","2017-09-10","405",21660,491321,12
"6847","발레리안: 천 개 행성의 도시","2017-09-11","386",5954,497275,13
"6848","발레리안: 천 개 행성의 도시","2017-09-12","375",4946,502221,14
"6849","발레리안: 천 개 행성의 도시","2017-09-13","333",3828,506049,15
"6850","발레리안: 천 개 행성의 도시","2017-09-14","34",378,506427,16
"6851","발레리안: 천 개 행성의 도시","2017-09-15","39",640,507067,17
"6852","발레리안: 천 개 행성의 도시","2017-09-16","39",1113,508180,18
"6853","발레리안: 천 개 행성의 도시","2017-09-17","34",1023,509203,19
"6854","발레리안: 천 개 행성의 도시","2017-09-18","34",318,509521,20
"6855","발레리안: 천 개 행성의 도시","2017-09-19","31",294,509815,21
"6856","발레리안: 천 개 행성의 도시","2017-09-20","31",299,510114,22
"6857","발레리안: 천 개 행성의 도시","2017-09-21","1",1,510115,23
"6858","발레리안: 천 개 행성의 도시","2017-09-22","1",1,510116,24
"6859","발레리안: 천 개 행성의 도시","2017-09-23","1",5,510121,25
"6860","발레리안: 천 개 행성의 도시","2017-09-24","2",106,510227,26
"6861","발레리안: 천 개 행성의 도시","2017-09-25","2",2,510229,27
"6862","발레리안: 천 개 행성의 도시","2017-09-26","1",4,510233,28
"6863","발레리안: 천 개 행성의 도시","2017-09-27","2",3,510236,29
"6864","발레리안: 천 개 행성의 도시","2017-09-28","2",2,510238,30
"6865","발레리안: 천 개 행성의 도시","2017-09-29","3",107,510345,31
"6866","발레리안: 천 개 행성의 도시","2017-09-30","1",2,510347,32
"6867","발레리안: 천 개 행성의 도시","2017-10-02","2",5,510352,33
"6868","발레리안: 천 개 행성의 도시","2017-10-03","1",1,510353,34
"6869","발레리안: 천 개 행성의 도시","2017-10-04","1",1,510354,35
"6870","발레리안: 천 개 행성의 도시","2017-10-05","1",1,510355,36
"6871","발레리안: 천 개 행성의 도시","2017-10-06","1",1,510356,37
"6872","발레리안: 천 개 행성의 도시","2017-10-09","1",1,510357,38
"6873","발레리안: 천 개 행성의 도시","2017-10-10","1",1,510358,39
"6874","발레리안: 천 개 행성의 도시","2017-10-11","1",1,510359,40
"6875","발레리안: 천 개 행성의 도시","2017-10-12","1",1,510360,41
"6876","발레리안: 천 개 행성의 도시","2017-10-13","1",1,510361,42
"6877","발레리안: 천 개 행성의 도시","2017-10-16","1",1,510362,43
"6878","발레리안: 천 개 행성의 도시","2017-10-17","20",1406,511768,44
"6879","발레리안: 천 개 행성의 도시","2017-10-18","6",105,511873,45
"6880","발레리안: 천 개 행성의 도시","2017-10-19","5",5,511878,46
"6881","발레리안: 천 개 행성의 도시","2017-10-20","5",5,511883,47
"6882","발레리안: 천 개 행성의 도시","2017-10-21","5",5,511888,48
"6883","발레리안: 천 개 행성의 도시","2017-10-22","5",5,511893,49
"6884","발레리안: 천 개 행성의 도시","2017-10-23","5",5,511898,50
"6885","발레리안: 천 개 행성의 도시","2017-10-24","5",5,511903,51
"6886","발레리안: 천 개 행성의 도시","2017-10-25","5",5,511908,52
"6887","발레리안: 천 개 행성의 도시","2017-10-26","5",5,511913,53
"6888","발레리안: 천 개 행성의 도시","2017-10-27","5",5,511918,54
"6889","발레리안: 천 개 행성의 도시","2017-10-28","4",4,511922,55
"6890","발레리안: 천 개 행성의 도시","2017-10-29","5",5,511927,56
"6891","발레리안: 천 개 행성의 도시","2017-10-30","4",4,511931,57
"6892","발레리안: 천 개 행성의 도시","2017-12-21","1",0,511931,58
"6893","그레이트 월","2017-01-17","1",200,200,0
"6894","그레이트 월","2017-02-14","8",1898,2098,0
"6895","그레이트 월","2017-02-15","593",46451,48549,1
"6896","그레이트 월","2017-02-16","598",49801,98350,2
"6897","그레이트 월","2017-02-17","569",58707,157057,3
"6898","그레이트 월","2017-02-18","583",112413,269470,4
"6899","그레이트 월","2017-02-19","585",101656,371126,5
"6900","그레이트 월","2017-02-20","547",31741,402867,6
"6901","그레이트 월","2017-02-21","545",26100,428967,7
"6902","그레이트 월","2017-02-22","367",15833,444800,8
"6903","그레이트 월","2017-02-23","345",9197,453997,9
"6904","그레이트 월","2017-02-24","334",7972,461969,10
"6905","그레이트 월","2017-02-25","312",13905,475874,11
"6906","그레이트 월","2017-02-26","311",12809,488683,12
"6907","그레이트 월","2017-02-27","296",4618,493301,13
"6908","그레이트 월","2017-02-28","217",3249,496550,14
"6909","그레이트 월","2017-03-01","10",407,496957,15
"6910","그레이트 월","2017-03-02","6",76,497033,16
"6911","그레이트 월","2017-03-03","9",165,497198,17
"6912","그레이트 월","2017-03-04","10",243,497441,18
"6913","그레이트 월","2017-03-05","12",172,497613,19
"6914","그레이트 월","2017-03-06","6",31,497644,20
"6915","그레이트 월","2017-03-07","6",38,497682,21
"6916","그레이트 월","2017-03-08","6",266,497948,22
"6917","그레이트 월","2017-03-09","6",268,498216,23
"6918","그레이트 월","2017-03-10","6",268,498484,24
"6919","그레이트 월","2017-03-11","6",278,498762,25
"6920","그레이트 월","2017-03-12","6",274,499036,26
"6921","그레이트 월","2017-03-13","5",263,499299,27
"6922","그레이트 월","2017-03-14","7",305,499604,28
"6923","그레이트 월","2017-03-15","6",254,499858,29
"6924","그레이트 월","2017-03-16","5",262,500120,30
"6925","그레이트 월","2017-03-17","6",259,500379,31
"6926","그레이트 월","2017-03-18","6",284,500663,32
"6927","그레이트 월","2017-03-19","6",277,500940,33
"6928","그레이트 월","2017-03-20","6",255,501195,34
"6929","그레이트 월","2017-03-21","6",259,501454,35
"6930","그레이트 월","2017-03-22","1",4,501458,36
"6931","그레이트 월","2017-03-25","1",9,501467,37
"6932","그레이트 월","2017-03-26","1",4,501471,38
"6933","그레이트 월","2017-03-27","1",6,501477,39
"6934","그레이트 월","2017-03-30","1",3,501480,40
"6935","그레이트 월","2017-03-31","1",6,501486,41
"6936","카3: 새로운 도전","2017-07-06","2",724,724,0
"6937","카3: 새로운 도전","2017-07-07","2",696,1420,0
"6938","카3: 새로운 도전","2017-07-08","11",3344,4764,0
"6939","카3: 새로운 도전","2017-07-13","530",17037,21801,1
"6940","카3: 새로운 도전","2017-07-14","553",18730,40531,2
"6941","카3: 새로운 도전","2017-07-15","800",126361,166892,3
"6942","카3: 새로운 도전","2017-07-16","798",121870,288762,4
"6943","카3: 새로운 도전","2017-07-17","488",9753,298515,5
"6944","카3: 새로운 도전","2017-07-18","504",10271,308786,6
"6945","카3: 새로운 도전","2017-07-19","441",9795,318581,7
"6946","카3: 새로운 도전","2017-07-20","312",6815,325396,8
"6947","카3: 새로운 도전","2017-07-21","354",9187,334583,9
"6948","카3: 새로운 도전","2017-07-22","538",47606,382189,10
"6949","카3: 새로운 도전","2017-07-23","525",50155,432344,11
"6950","카3: 새로운 도전","2017-07-24","381",10893,443237,12
"6951","카3: 새로운 도전","2017-07-25","394",11929,455166,13
"6952","카3: 새로운 도전","2017-07-26","82",3111,458277,14
"6953","카3: 새로운 도전","2017-07-27","70",2468,460745,15
"6954","카3: 새로운 도전","2017-07-28","67",2634,463379,16
"6955","카3: 새로운 도전","2017-07-29","77",4993,468372,17
"6956","카3: 새로운 도전","2017-07-30","72",4340,472712,18
"6957","카3: 새로운 도전","2017-07-31","70",3708,476420,19
"6958","카3: 새로운 도전","2017-08-01","74",3893,480313,20
"6959","카3: 새로운 도전","2017-08-02","15",891,481204,21
"6960","카3: 새로운 도전","2017-08-03","13",738,481942,22
"6961","카3: 새로운 도전","2017-08-04","19",859,482801,23
"6962","카3: 새로운 도전","2017-08-05","24",1158,483959,24
"6963","카3: 새로운 도전","2017-08-06","24",1229,485188,25
"6964","카3: 새로운 도전","2017-08-07","22",549,485737,26
"6965","카3: 새로운 도전","2017-08-08","18",529,486266,27
"6966","카3: 새로운 도전","2017-08-09","3",122,486388,28
"6967","카3: 새로운 도전","2017-08-10","3",63,486451,29
"6968","카3: 새로운 도전","2017-08-11","4",43,486494,30
"6969","카3: 새로운 도전","2017-08-12","6",184,486678,31
"6970","카3: 새로운 도전","2017-08-13","5",240,486918,32
"6971","카3: 새로운 도전","2017-08-14","3",70,486988,33
"6972","카3: 새로운 도전","2017-08-15","5",237,487225,34
"6973","카3: 새로운 도전","2017-08-16","3",113,487338,35
"6974","카3: 새로운 도전","2017-08-17","2",100,487438,36
"6975","카3: 새로운 도전","2017-08-18","1",32,487470,37
"6976","카3: 새로운 도전","2017-08-19","2",80,487550,38
"6977","카3: 새로운 도전","2017-08-20","2",117,487667,39
"6978","카3: 새로운 도전","2017-08-21","1",11,487678,40
"6979","카3: 새로운 도전","2017-08-22","2",42,487720,41
"6980","카3: 새로운 도전","2017-08-23","1",40,487760,42
"6981","카3: 새로운 도전","2017-08-24","1",32,487792,43
"6982","카3: 새로운 도전","2017-08-29","1",28,487820,44
"6983","카3: 새로운 도전","2017-08-31","1",79,487899,45
"6984","카3: 새로운 도전","2017-09-07","1",17,487916,46
"6985","트리플 엑스 리턴즈","2017-02-03","3",1010,1010,0
"6986","트리플 엑스 리턴즈","2017-02-08","581",68598,69608,1
"6987","트리플 엑스 리턴즈","2017-02-09","541",43816,113424,2
"6988","트리플 엑스 리턴즈","2017-02-10","554",49555,162979,3
"6989","트리플 엑스 리턴즈","2017-02-11","590",104170,267149,4
"6990","트리플 엑스 리턴즈","2017-02-12","580",101190,368339,5
"6991","트리플 엑스 리턴즈","2017-02-13","542",29366,397705,6
"6992","트리플 엑스 리턴즈","2017-02-14","546",30333,428038,7
"6993","트리플 엑스 리턴즈","2017-02-15","311",6815,434853,8
"6994","트리플 엑스 리턴즈","2017-02-16","275",5193,440046,9
"6995","트리플 엑스 리턴즈","2017-02-17","285",6054,446100,10
"6996","트리플 엑스 리턴즈","2017-02-18","272",10425,456525,11
"6997","트리플 엑스 리턴즈","2017-02-19","275",8748,465273,12
"6998","트리플 엑스 리턴즈","2017-02-20","259",3770,469043,13
"6999","트리플 엑스 리턴즈","2017-02-21","250",3432,472475,14
"7000","트리플 엑스 리턴즈","2017-02-22","16",498,472973,15
"7001","트리플 엑스 리턴즈","2017-02-23","10",104,473077,16
"7002","트리플 엑스 리턴즈","2017-02-24","10",175,473252,17
"7003","트리플 엑스 리턴즈","2017-02-25","9",249,473501,18
"7004","트리플 엑스 리턴즈","2017-02-26","10",139,473640,19
"7005","트리플 엑스 리턴즈","2017-02-27","9",72,473712,20
"7006","트리플 엑스 리턴즈","2017-02-28","6",79,473791,21
"7007","트리플 엑스 리턴즈","2017-03-09","5",157,473948,22
"7008","트리플 엑스 리턴즈","2017-03-10","5",365,474313,23
"7009","트리플 엑스 리턴즈","2017-03-11","2",145,474458,24
"7010","트리플 엑스 리턴즈","2017-03-12","2",65,474523,25
"7011","트리플 엑스 리턴즈","2017-03-13","2",61,474584,26
"7012","트리플 엑스 리턴즈","2017-03-14","2",60,474644,27
"7013","트리플 엑스 리턴즈","2017-03-15","2",64,474708,28
"7014","트리플 엑스 리턴즈","2017-03-16","2",60,474768,29
"7015","트리플 엑스 리턴즈","2017-03-17","2",142,474910,30
"7016","트리플 엑스 리턴즈","2017-03-18","2",148,475058,31
"7017","트리플 엑스 리턴즈","2017-03-19","2",62,475120,32
"7018","트리플 엑스 리턴즈","2017-03-20","2",62,475182,33
"7019","트리플 엑스 리턴즈","2017-03-21","2",61,475243,34
"7020","트리플 엑스 리턴즈","2017-03-22","2",64,475307,35
"7021","트리플 엑스 리턴즈","2017-03-31","1",2,475309,36
"7022","너의 췌장을 먹고 싶어","2017-10-18","1",204,204,0
"7023","너의 췌장을 먹고 싶어","2017-10-19","3",530,734,0
"7024","너의 췌장을 먹고 싶어","2017-10-21","1",150,884,0
"7025","너의 췌장을 먹고 싶어","2017-10-23","6",1695,2579,0
"7026","너의 췌장을 먹고 싶어","2017-10-24","26",2662,5241,0
"7027","너의 췌장을 먹고 싶어","2017-10-25","196",38923,44164,1
"7028","너의 췌장을 먹고 싶어","2017-10-26","201",19506,63670,2
"7029","너의 췌장을 먹고 싶어","2017-10-27","218",29630,93300,3
"7030","너의 췌장을 먹고 싶어","2017-10-28","213",52788,146088,4
"7031","너의 췌장을 먹고 싶어","2017-10-29","218",52875,198963,5
"7032","너의 췌장을 먹고 싶어","2017-10-30","196",19389,218352,6
"7033","너의 췌장을 먹고 싶어","2017-10-31","200",20128,238480,7
"7034","너의 췌장을 먹고 싶어","2017-11-01","189",21004,259484,8
"7035","너의 췌장을 먹고 싶어","2017-11-02","182",11352,270836,9
"7036","너의 췌장을 먹고 싶어","2017-11-03","187",16539,287375,10
"7037","너의 췌장을 먹고 싶어","2017-11-04","196",30180,317555,11
"7038","너의 췌장을 먹고 싶어","2017-11-05","207",27992,345547,12
"7039","너의 췌장을 먹고 싶어","2017-11-06","177",8995,354542,13
"7040","너의 췌장을 먹고 싶어","2017-11-07","178",8058,362600,14
"7041","너의 췌장을 먹고 싶어","2017-11-08","174",8197,370797,15
"7042","너의 췌장을 먹고 싶어","2017-11-09","147",5087,375884,16
"7043","너의 췌장을 먹고 싶어","2017-11-10","149",6877,382761,17
"7044","너의 췌장을 먹고 싶어","2017-11-11","157",15570,398331,18
"7045","너의 췌장을 먹고 싶어","2017-11-12","159",12810,411141,19
"7046","너의 췌장을 먹고 싶어","2017-11-13","153",3938,415079,20
"7047","너의 췌장을 먹고 싶어","2017-11-14","155",3525,418604,21
"7048","너의 췌장을 먹고 싶어","2017-11-15","163",4575,423179,22
"7049","너의 췌장을 먹고 싶어","2017-11-16","134",6257,429436,23
"7050","너의 췌장을 먹고 싶어","2017-11-17","133",2968,432404,24
"7051","너의 췌장을 먹고 싶어","2017-11-18","129",5718,438122,25
"7052","너의 췌장을 먹고 싶어","2017-11-19","129",5712,443834,26
"7053","너의 췌장을 먹고 싶어","2017-11-20","116",1723,445557,27
"7054","너의 췌장을 먹고 싶어","2017-11-21","120",1780,447337,28
"7055","너의 췌장을 먹고 싶어","2017-11-22","96",1404,448741,29
"7056","너의 췌장을 먹고 싶어","2017-11-23","107",1667,450408,30
"7057","너의 췌장을 먹고 싶어","2017-11-24","101",1533,451941,31
"7058","너의 췌장을 먹고 싶어","2017-11-25","93",2521,454462,32
"7059","너의 췌장을 먹고 싶어","2017-11-26","94",2673,457135,33
"7060","너의 췌장을 먹고 싶어","2017-11-27","98",1264,458399,34
"7061","너의 췌장을 먹고 싶어","2017-11-28","96",1316,459715,35
"7062","너의 췌장을 먹고 싶어","2017-11-29","43",626,460341,36
"7063","너의 췌장을 먹고 싶어","2017-11-30","39",527,460868,37
"7064","너의 췌장을 먹고 싶어","2017-12-01","38",446,461314,38
"7065","너의 췌장을 먹고 싶어","2017-12-02","38",667,461981,39
"7066","너의 췌장을 먹고 싶어","2017-12-03","40",694,462675,40
"7067","너의 췌장을 먹고 싶어","2017-12-04","38",555,463230,41
"7068","너의 췌장을 먹고 싶어","2017-12-05","35",359,463589,42
"7069","너의 췌장을 먹고 싶어","2017-12-06","37",365,463954,43
"7070","너의 췌장을 먹고 싶어","2017-12-07","11",96,464050,44
"7071","너의 췌장을 먹고 싶어","2017-12-08","11",91,464141,45
"7072","너의 췌장을 먹고 싶어","2017-12-09","7",129,464270,46
"7073","너의 췌장을 먹고 싶어","2017-12-10","7",121,464391,47
"7074","너의 췌장을 먹고 싶어","2017-12-11","10",116,464507,48
"7075","너의 췌장을 먹고 싶어","2017-12-12","7",68,464575,49
"7076","너의 췌장을 먹고 싶어","2017-12-13","10",102,464677,50
"7077","너의 췌장을 먹고 싶어","2017-12-16","1",7,464684,51
"7078","너의 췌장을 먹고 싶어","2017-12-17","1",7,464691,52
"7079","너의 췌장을 먹고 싶어","2017-12-18","1",4,464695,53
"7080","너의 췌장을 먹고 싶어","2017-12-19","1",12,464707,54
"7081","너의 췌장을 먹고 싶어","2017-12-21","1",1,464708,55
"7082","너의 췌장을 먹고 싶어","2017-12-22","1",3,464711,56
"7083","너의 췌장을 먹고 싶어","2017-12-23","1",8,464719,57
"7084","너의 췌장을 먹고 싶어","2017-12-24","1",19,464738,58
"7085","너의 췌장을 먹고 싶어","2017-12-25","1",4,464742,59
"7086","너의 췌장을 먹고 싶어","2017-12-26","1",1,464743,60
"7087","너의 췌장을 먹고 싶어","2017-12-27","1",2,464745,61
"7088","너의 췌장을 먹고 싶어","2017-12-28","6",251,464996,62
"7089","너의 췌장을 먹고 싶어","2017-12-29","2",51,465047,63
"7090","너의 췌장을 먹고 싶어","2017-12-30","1",5,465052,64
"7091","너의 췌장을 먹고 싶어","2017-12-31","3",213,465265,65
"7092","너의 췌장을 먹고 싶어","2018-01-01","1",6,465271,66
"7093","너의 췌장을 먹고 싶어","2018-01-04","2",116,465387,67
"7094","너의 췌장을 먹고 싶어","2018-01-05","1",2,465389,68
"7095","너의 췌장을 먹고 싶어","2018-01-06","1",7,465396,69
"7096","너의 췌장을 먹고 싶어","2018-01-07","1",6,465402,70
"7097","너의 췌장을 먹고 싶어","2018-01-08","1",2,465404,71
"7098","너의 췌장을 먹고 싶어","2018-01-09","1",4,465408,72
"7099","너의 췌장을 먹고 싶어","2018-01-10","1",1,465409,73
"7100","너의 췌장을 먹고 싶어","2018-01-11","1",1,465410,74
"7101","너의 췌장을 먹고 싶어","2018-01-12","1",5,465415,75
"7102","너의 췌장을 먹고 싶어","2018-01-13","1",7,465422,76
"7103","너의 췌장을 먹고 싶어","2018-01-14","1",9,465431,77
"7104","너의 췌장을 먹고 싶어","2018-01-15","1",3,465434,78
"7105","너의 췌장을 먹고 싶어","2018-01-16","1",1,465435,79
"7106","너의 췌장을 먹고 싶어","2018-01-17","3",3,465438,80
"7107","너의 췌장을 먹고 싶어","2018-01-18","1",1,465439,81
"7108","너의 췌장을 먹고 싶어","2018-01-19","2",2,465441,82
"7109","너의 췌장을 먹고 싶어","2018-01-20","1",1,465442,83
"7110","너의 췌장을 먹고 싶어","2018-01-21","2",5,465447,84
"7111","너의 췌장을 먹고 싶어","2018-01-22","2",3,465450,85
"7112","너의 췌장을 먹고 싶어","2018-01-23","1",1,465451,86
"7113","너의 췌장을 먹고 싶어","2018-01-24","1",1,465452,87
"7114","너의 췌장을 먹고 싶어","2018-01-25","1",1,465453,88
"7115","너의 췌장을 먹고 싶어","2018-01-26","1",1,465454,89
"7116","너의 췌장을 먹고 싶어","2018-01-27","2",5,465459,90
"7117","너의 췌장을 먹고 싶어","2018-01-28","2",7,465466,91
"7118","너의 췌장을 먹고 싶어","2018-01-29","1",1,465467,92
"7119","너의 췌장을 먹고 싶어","2018-01-30","1",1,465468,93
"7120","너의 췌장을 먹고 싶어","2018-01-31","1",1,465469,94
"7121","너의 췌장을 먹고 싶어","2018-02-04","1",10,465479,95
"7122","너의 췌장을 먹고 싶어","2018-02-10","1",5,465484,96
"7123","너의 췌장을 먹고 싶어","2018-02-11","1",5,465489,97
"7124","너의 췌장을 먹고 싶어","2018-02-17","1",6,465495,98
"7125","너의 췌장을 먹고 싶어","2018-11-02","1",50,465545,99
"7126","너의 췌장을 먹고 싶어","2018-11-17","2",22,465567,100
"7127","너의 췌장을 먹고 싶어","2019-03-18","1",2,465569,101
"7128","라이프","2017-03-27","1",100,100,0
"7129","라이프","2017-03-29","1",303,403,0
"7130","라이프","2017-03-31","1",160,563,0
"7131","라이프","2017-04-01","33",884,1447,0
"7132","라이프","2017-04-03","341",5420,6867,0
"7133","라이프","2017-04-04","351",7348,14215,0
"7134","라이프","2017-04-05","533",42630,56845,1
"7135","라이프","2017-04-06","529",39646,96491,2
"7136","라이프","2017-04-07","563",50620,147111,3
"7137","라이프","2017-04-08","643",98099,245210,4
"7138","라이프","2017-04-09","647",85946,331156,5
"7139","라이프","2017-04-10","561",24592,355748,6
"7140","라이프","2017-04-11","572",22231,377979,7
"7141","라이프","2017-04-12","460",9312,387291,8
"7142","라이프","2017-04-13","425",7526,394817,9
"7143","라이프","2017-04-14","457",11584,406401,10
"7144","라이프","2017-04-15","429",15973,422374,11
"7145","라이프","2017-04-16","416",12784,435158,12
"7146","라이프","2017-04-17","419",6018,441176,13
"7147","라이프","2017-04-18","405",5030,446206,14
"7148","라이프","2017-04-19","404",4892,451098,15
"7149","라이프","2017-04-20","60",729,451827,16
"7150","라이프","2017-04-21","74",1396,453223,17
"7151","라이프","2017-04-22","79",2503,455726,18
"7152","라이프","2017-04-23","79",1813,457539,19
"7153","라이프","2017-04-24","68",609,458148,20
"7154","라이프","2017-04-25","73",982,459130,21
"7155","라이프","2017-04-26","8",131,459261,22
"7156","라이프","2017-04-27","4",21,459282,23
"7157","라이프","2017-04-28","5",116,459398,24
"7158","라이프","2017-04-29","3",187,459585,25
"7159","라이프","2017-04-30","2",40,459625,26
"7160","라이프","2017-05-01","2",125,459750,27
"7161","라이프","2017-05-02","1",26,459776,28
"7162","라이프","2017-05-03","2",104,459880,29
"7163","라이프","2017-05-04","2",104,459984,30
"7164","명탐정 코난:진홍의 연가","2017-07-24","4",864,864,0
"7165","명탐정 코난:진홍의 연가","2017-07-25","2",798,1662,0
"7166","명탐정 코난:진홍의 연가","2017-08-01","9",1056,2718,0
"7167","명탐정 코난:진홍의 연가","2017-08-02","546",94241,96959,1
"7168","명탐정 코난:진홍의 연가","2017-08-03","582",54243,151202,2
"7169","명탐정 코난:진홍의 연가","2017-08-04","557",42806,194008,3
"7170","명탐정 코난:진홍의 연가","2017-08-05","521",62418,256426,4
"7171","명탐정 코난:진홍의 연가","2017-08-06","510",55506,311932,5
"7172","명탐정 코난:진홍의 연가","2017-08-07","445",24919,336851,6
"7173","명탐정 코난:진홍의 연가","2017-08-08","456",24796,361647,7
"7174","명탐정 코난:진홍의 연가","2017-08-09","246",12704,374351,8
"7175","명탐정 코난:진홍의 연가","2017-08-10","166",8329,382680,9
"7176","명탐정 코난:진홍의 연가","2017-08-11","166",7633,390313,10
"7177","명탐정 코난:진홍의 연가","2017-08-12","169",12054,402367,11
"7178","명탐정 코난:진홍의 연가","2017-08-13","169",11789,414156,12
"7179","명탐정 코난:진홍의 연가","2017-08-14","168",7659,421815,13
"7180","명탐정 코난:진홍의 연가","2017-08-15","112",9392,431207,14
"7181","명탐정 코난:진홍의 연가","2017-08-16","104",2909,434116,15
"7182","명탐정 코난:진홍의 연가","2017-08-17","75",1986,436102,16
"7183","명탐정 코난:진홍의 연가","2017-08-18","79",1715,437817,17
"7184","명탐정 코난:진홍의 연가","2017-08-19","80",3622,441439,18
"7185","명탐정 코난:진홍의 연가","2017-08-20","78",3735,445174,19
"7186","명탐정 코난:진홍의 연가","2017-08-21","64",1032,446206,20
"7187","명탐정 코난:진홍의 연가","2017-08-22","62",977,447183,21
"7188","명탐정 코난:진홍의 연가","2017-08-23","18",315,447498,22
"7189","명탐정 코난:진홍의 연가","2017-08-24","8",273,447771,23
"7190","명탐정 코난:진홍의 연가","2017-08-25","9",196,447967,24
"7191","명탐정 코난:진홍의 연가","2017-08-26","13",476,448443,25
"7192","명탐정 코난:진홍의 연가","2017-08-27","11",583,449026,26
"7193","명탐정 코난:진홍의 연가","2017-08-28","10",159,449185,27
"7194","명탐정 코난:진홍의 연가","2017-08-29","9",154,449339,28
"7195","명탐정 코난:진홍의 연가","2017-08-30","6",89,449428,29
"7196","명탐정 코난:진홍의 연가","2017-08-31","6",92,449520,30
"7197","명탐정 코난:진홍의 연가","2017-09-01","6",148,449668,31
"7198","명탐정 코난:진홍의 연가","2017-09-02","6",185,449853,32
"7199","명탐정 코난:진홍의 연가","2017-09-03","6",166,450019,33
"7200","명탐정 코난:진홍의 연가","2017-09-04","2",9,450028,34
"7201","명탐정 코난:진홍의 연가","2017-09-05","2",8,450036,35
"7202","명탐정 코난:진홍의 연가","2017-09-08","1",2,450038,36
"7203","명탐정 코난:진홍의 연가","2017-09-09","1",4,450042,37
"7204","명탐정 코난:진홍의 연가","2017-09-14","1",1,450043,38
"7205","명탐정 코난:진홍의 연가","2018-08-24","1",222,450265,39
"7206","명탐정 코난:진홍의 연가","2018-08-25","1",217,450482,40
"7207","히든 피겨스","2017-01-23","1",72,72,0
"7208","히든 피겨스","2017-02-09","2",399,471,0
"7209","히든 피겨스","2017-02-16","1",124,595,0
"7210","히든 피겨스","2017-03-02","5",1585,2180,0
"7211","히든 피겨스","2017-03-03","5",874,3054,0
"7212","히든 피겨스","2017-03-04","1",76,3130,0
"7213","히든 피겨스","2017-03-05","17",1067,4197,0
"7214","히든 피겨스","2017-03-06","2",394,4591,0
"7215","히든 피겨스","2017-03-07","24",5080,9671,0
"7216","히든 피겨스","2017-03-08","8",1093,10764,0
"7217","히든 피겨스","2017-03-09","1",102,10866,0
"7218","히든 피겨스","2017-03-10","2",199,11065,0
"7219","히든 피겨스","2017-03-11","4",273,11338,0
"7220","히든 피겨스","2017-03-14","7",1173,12511,0
"7221","히든 피겨스","2017-03-15","4",717,13228,0
"7222","히든 피겨스","2017-03-17","4",626,13854,0
"7223","히든 피겨스","2017-03-18","2",151,14005,0
"7224","히든 피겨스","2017-03-19","1",145,14150,0
"7225","히든 피겨스","2017-03-21","2",715,14865,0
"7226","히든 피겨스","2017-03-22","2",377,15242,0
"7227","히든 피겨스","2017-03-23","419",15834,31076,1
"7228","히든 피겨스","2017-03-24","413",21300,52376,2
"7229","히든 피겨스","2017-03-25","436",44551,96927,3
"7230","히든 피겨스","2017-03-26","448",42356,139283,4
"7231","히든 피겨스","2017-03-27","424",18345,157628,5
"7232","히든 피겨스","2017-03-28","447",18363,175991,6
"7233","히든 피겨스","2017-03-29","356",20436,196427,7
"7234","히든 피겨스","2017-03-30","324",12382,208809,8
"7235","히든 피겨스","2017-03-31","351",18709,227518,9
"7236","히든 피겨스","2017-04-01","350",33452,260970,10
"7237","히든 피겨스","2017-04-02","340",26517,287487,11
"7238","히든 피겨스","2017-04-03","356",9860,297347,12
"7239","히든 피겨스","2017-04-04","360",9688,307035,13
"7240","히든 피겨스","2017-04-05","260",8802,315837,14
"7241","히든 피겨스","2017-04-06","244",7737,323574,15
"7242","히든 피겨스","2017-04-07","272",10255,333829,16
"7243","히든 피겨스","2017-04-08","249",17255,351084,17
"7244","히든 피겨스","2017-04-09","257",14972,366056,18
"7245","히든 피겨스","2017-04-10","247",5457,371513,19
"7246","히든 피겨스","2017-04-11","249",5702,377215,20
"7247","히든 피겨스","2017-04-12","164",3697,380912,21
"7248","히든 피겨스","2017-04-13","160",3334,384246,22
"7249","히든 피겨스","2017-04-14","168",5519,389765,23
"7250","히든 피겨스","2017-04-15","166",7544,397309,24
"7251","히든 피겨스","2017-04-16","157",6236,403545,25
"7252","히든 피겨스","2017-04-17","156",3237,406782,26
"7253","히든 피겨스","2017-04-18","163",3019,409801,27
"7254","히든 피겨스","2017-04-19","166",3395,413196,28
"7255","히든 피겨스","2017-04-20","103",2210,415406,29
"7256","히든 피겨스","2017-04-21","116",2828,418234,30
"7257","히든 피겨스","2017-04-22","114",5449,423683,31
"7258","히든 피겨스","2017-04-23","111",4608,428291,32
"7259","히든 피겨스","2017-04-24","109",2007,430298,33
"7260","히든 피겨스","2017-04-25","116",2181,432479,34
"7261","히든 피겨스","2017-04-26","52",1729,434208,35
"7262","히든 피겨스","2017-04-27","43",926,435134,36
"7263","히든 피겨스","2017-04-28","42",1698,436832,37
"7264","히든 피겨스","2017-04-29","27",1324,438156,38
"7265","히든 피겨스","2017-04-30","28",1581,439737,39
"7266","히든 피겨스","2017-05-01","38",2284,442021,40
"7267","히든 피겨스","2017-05-02","30",960,442981,41
"7268","히든 피겨스","2017-05-03","9",475,443456,42
"7269","히든 피겨스","2017-05-04","9",440,443896,43
"7270","히든 피겨스","2017-05-05","12",760,444656,44
"7271","히든 피겨스","2017-05-06","8",577,445233,45
"7272","히든 피겨스","2017-05-07","9",511,445744,46
"7273","히든 피겨스","2017-05-08","9",217,445961,47
"7274","히든 피겨스","2017-05-09","5",417,446378,48
"7275","히든 피겨스","2017-05-10","5",179,446557,49
"7276","히든 피겨스","2017-05-11","10",678,447235,50
"7277","히든 피겨스","2017-05-12","6",334,447569,51
"7278","히든 피겨스","2017-05-13","4",121,447690,52
"7279","히든 피겨스","2017-05-14","5",189,447879,53
"7280","히든 피겨스","2017-05-15","4",112,447991,54
"7281","히든 피겨스","2017-05-16","4",144,448135,55
"7282","히든 피겨스","2017-05-17","4",180,448315,56
"7283","히든 피겨스","2017-05-18","4",199,448514,57
"7284","히든 피겨스","2017-05-19","1",5,448519,58
"7285","히든 피겨스","2017-05-20","1",45,448564,59
"7286","히든 피겨스","2017-05-21","2",55,448619,60
"7287","히든 피겨스","2017-05-22","2",56,448675,61
"7288","히든 피겨스","2017-05-23","1",12,448687,62
"7289","히든 피겨스","2017-05-24","1",22,448709,63
"7290","히든 피겨스","2017-05-26","1",167,448876,64
"7291","히든 피겨스","2017-05-28","1",16,448892,65
"7292","히든 피겨스","2017-05-30","5",317,449209,66
"7293","히든 피겨스","2017-05-31","2",97,449306,67
"7294","히든 피겨스","2017-06-02","1",14,449320,68
"7295","히든 피겨스","2017-06-04","1",13,449333,69
"7296","히든 피겨스","2017-06-06","1",13,449346,70
"7297","히든 피겨스","2017-06-07","1",23,449369,71
"7298","히든 피겨스","2017-06-09","2",11,449380,72
"7299","히든 피겨스","2017-06-10","1",28,449408,73
"7300","히든 피겨스","2017-06-14","1",13,449421,74
"7301","히든 피겨스","2017-07-06","1",97,449518,75
"7302","스머프: 비밀의 숲","2017-04-14","1",218,218,0
"7303","스머프: 비밀의 숲","2017-04-15","4",998,1216,0
"7304","스머프: 비밀의 숲","2017-04-25","1",0,1216,0
"7305","스머프: 비밀의 숲","2017-04-26","2",237,1453,0
"7306","스머프: 비밀의 숲","2017-04-27","1",103,1556,0
"7307","스머프: 비밀의 숲","2017-04-28","384",9077,10633,1
"7308","스머프: 비밀의 숲","2017-04-29","545",69137,79770,2
"7309","스머프: 비밀의 숲","2017-04-30","607",80084,159854,3
"7310","스머프: 비밀의 숲","2017-05-01","537",41692,201546,4
"7311","스머프: 비밀의 숲","2017-05-02","508",23224,224770,5
"7312","스머프: 비밀의 숲","2017-05-03","428",41381,266151,6
"7313","스머프: 비밀의 숲","2017-05-04","422",31826,297977,7
"7314","스머프: 비밀의 숲","2017-05-05","488",51877,349854,8
"7315","스머프: 비밀의 숲","2017-05-06","421",20561,370415,9
"7316","스머프: 비밀의 숲","2017-05-07","416",15744,386159,10
"7317","스머프: 비밀의 숲","2017-05-08","233",1501,387660,11
"7318","스머프: 비밀의 숲","2017-05-09","247",17896,405556,12
"7319","스머프: 비밀의 숲","2017-05-10","75",1033,406589,13
"7320","스머프: 비밀의 숲","2017-05-11","72",398,406987,14
"7321","스머프: 비밀의 숲","2017-05-12","65",559,407546,15
"7322","스머프: 비밀의 숲","2017-05-13","201",6475,414021,16
"7323","스머프: 비밀의 숲","2017-05-14","198",6594,420615,17
"7324","스머프: 비밀의 숲","2017-05-15","56",566,421181,18
"7325","스머프: 비밀의 숲","2017-05-16","59",422,421603,19
"7326","스머프: 비밀의 숲","2017-05-17","16",329,421932,20
"7327","스머프: 비밀의 숲","2017-05-18","10",234,422166,21
"7328","스머프: 비밀의 숲","2017-05-19","8",333,422499,22
"7329","스머프: 비밀의 숲","2017-05-20","27",893,423392,23
"7330","스머프: 비밀의 숲","2017-05-21","30",1282,424674,24
"7331","스머프: 비밀의 숲","2017-05-22","4",48,424722,25
"7332","스머프: 비밀의 숲","2017-05-23","6",72,424794,26
"7333","스머프: 비밀의 숲","2017-05-24","5",49,424843,27
"7334","스머프: 비밀의 숲","2017-05-25","3",149,424992,28
"7335","스머프: 비밀의 숲","2017-05-26","5",86,425078,29
"7336","스머프: 비밀의 숲","2017-05-27","11",279,425357,30
"7337","스머프: 비밀의 숲","2017-05-28","11",358,425715,31
"7338","스머프: 비밀의 숲","2017-05-29","2",14,425729,32
"7339","스머프: 비밀의 숲","2017-05-30","4",35,425764,33
"7340","스머프: 비밀의 숲","2017-05-31","3",26,425790,34
"7341","스머프: 비밀의 숲","2017-06-01","3",27,425817,35
"7342","스머프: 비밀의 숲","2017-06-02","4",29,425846,36
"7343","스머프: 비밀의 숲","2017-06-03","6",178,426024,37
"7344","스머프: 비밀의 숲","2017-06-04","6",183,426207,38
"7345","스머프: 비밀의 숲","2017-06-05","3",63,426270,39
"7346","스머프: 비밀의 숲","2017-06-06","2",80,426350,40
"7347","스머프: 비밀의 숲","2017-06-07","4",142,426492,41
"7348","스머프: 비밀의 숲","2017-06-08","3",11,426503,42
"7349","스머프: 비밀의 숲","2017-06-09","4",84,426587,43
"7350","스머프: 비밀의 숲","2017-06-10","3",172,426759,44
"7351","스머프: 비밀의 숲","2017-06-11","3",176,426935,45
"7352","스머프: 비밀의 숲","2017-06-12","2",136,427071,46
"7353","스머프: 비밀의 숲","2017-06-13","4",134,427205,47
"7354","스머프: 비밀의 숲","2017-06-14","3",19,427224,48
"7355","스머프: 비밀의 숲","2017-06-15","2",5,427229,49
"7356","스머프: 비밀의 숲","2017-06-16","3",12,427241,50
"7357","스머프: 비밀의 숲","2017-06-17","3",134,427375,51
"7358","스머프: 비밀의 숲","2017-06-18","3",133,427508,52
"7359","스머프: 비밀의 숲","2017-06-19","1",3,427511,53
"7360","스머프: 비밀의 숲","2017-06-20","2",8,427519,54
"7361","스머프: 비밀의 숲","2017-06-21","1",11,427530,55
"7362","스머프: 비밀의 숲","2017-06-22","1",14,427544,56
"7363","스머프: 비밀의 숲","2017-06-23","1",2,427546,57
"7364","스머프: 비밀의 숲","2017-06-24","1",127,427673,58
"7365","스머프: 비밀의 숲","2017-06-25","1",85,427758,59
"7366","스머프: 비밀의 숲","2017-06-27","1",6,427764,60
"7367","신과함께-인과 연","2018-07-18","2",406,406,0
"7368","신과함께-인과 연","2018-07-24","10",3644,4050,0
"7369","신과함께-인과 연","2018-07-26","42",7629,11679,0
"7370","신과함께-인과 연","2018-07-27","1",34,11713,0
"7371","신과함께-인과 연","2018-07-30","14",4005,15718,0
"7372","신과함께-인과 연","2018-07-31","22",6031,21749,0
"7373","신과함께-인과 연","2018-08-01","1,967",1246603,1268352,1
"7374","신과함께-인과 연","2018-08-02","2,054",1078012,2346364,2
"7375","신과함께-인과 연","2018-08-03","2,126",1078478,3424842,3
"7376","신과함께-인과 연","2018-08-04","2,235",1466225,4891067,4
"7377","신과함께-인과 연","2018-08-05","2,217",1302687,6193754,5
"7378","신과함께-인과 연","2018-08-06","2,087",629793,6823547,6
"7379","신과함께-인과 연","2018-08-07","2,097",515945,7339492,7
"7380","신과함께-인과 연","2018-08-08","1,457",395474,7734966,8
"7381","신과함께-인과 연","2018-08-09","1,418",325130,8060096,9
"7382","신과함께-인과 연","2018-08-10","1,380",356267,8416363,10
"7383","신과함께-인과 연","2018-08-11","1,373",644582,9060945,11
"7384","신과함께-인과 연","2018-08-12","1,341",570284,9631229,12
"7385","신과함께-인과 연","2018-08-13","1,252",228960,9860189,13
"7386","신과함께-인과 연","2018-08-14","1,266",261662,10121851,14
"7387","신과함께-인과 연","2018-08-15","1,108",417019,10538870,15
"7388","신과함께-인과 연","2018-08-16","1,031",140422,10679292,16
"7389","신과함께-인과 연","2018-08-17","1,000",141793,10821085,17
"7390","신과함께-인과 연","2018-08-18","999",268266,11089351,18
"7391","신과함께-인과 연","2018-08-19","992",230492,11319843,19
"7392","신과함께-인과 연","2018-08-20","942",82706,11402549,20
"7393","신과함께-인과 연","2018-08-21","956",77873,11480422,21
"7394","신과함께-인과 연","2018-08-22","737",62694,11543116,22
"7395","신과함께-인과 연","2018-08-23","704",48148,11591264,23
"7396","신과함께-인과 연","2018-08-24","718",64192,11655456,24
"7397","신과함께-인과 연","2018-08-25","735",118886,11774342,25
"7398","신과함께-인과 연","2018-08-26","726",107231,11881573,26
"7399","신과함께-인과 연","2018-08-27","688",37465,11919038,27
"7400","신과함께-인과 연","2018-08-28","697",34852,11953890,28
"7401","신과함께-인과 연","2018-08-29","551",36540,11990430,29
"7402","신과함께-인과 연","2018-08-30","550",23582,12014012,30
"7403","신과함께-인과 연","2018-08-31","536",29530,12043542,31
"7404","신과함께-인과 연","2018-09-01","534",41303,12084845,32
"7405","신과함께-인과 연","2018-09-02","527",43763,12128608,33
"7406","신과함께-인과 연","2018-09-03","532",15027,12143635,34
"7407","신과함께-인과 연","2018-09-04","534",13534,12157169,35
"7408","신과함께-인과 연","2018-09-05","521",12190,12169359,36
"7409","신과함께-인과 연","2018-09-06","421",8754,12178113,37
"7410","신과함께-인과 연","2018-09-07","418",10657,12188770,38
"7411","신과함께-인과 연","2018-09-08","449",19696,12208466,39
"7412","신과함께-인과 연","2018-09-09","446",22919,12231385,40
"7413","신과함께-인과 연","2018-09-10","432",6709,12238094,41
"7414","신과함께-인과 연","2018-09-11","414",6574,12244668,42
"7415","신과함께-인과 연","2018-09-12","213",2827,12247495,43
"7416","신과함께-인과 연","2018-09-13","206",2723,12250218,44
"7417","신과함께-인과 연","2018-09-14","208",3272,12253490,45
"7418","신과함께-인과 연","2018-09-15","220",5784,12259274,46
"7419","신과함께-인과 연","2018-09-16","223",5539,12264813,47
"7420","신과함께-인과 연","2018-09-17","213",2192,12267005,48
"7421","신과함께-인과 연","2018-09-18","217",2202,12269207,49
"7422","신과함께-인과 연","2018-09-19","10",220,12269427,50
"7423","신과함께-인과 연","2018-09-20","10",221,12269648,51
"7424","신과함께-인과 연","2018-09-21","12",327,12269975,52
"7425","신과함께-인과 연","2018-09-22","11",208,12270183,53
"7426","신과함께-인과 연","2018-09-23","11",249,12270432,54
"7427","신과함께-인과 연","2018-09-24","10",218,12270650,55
"7428","신과함께-인과 연","2018-09-25","11",307,12270957,56
"7429","신과함께-인과 연","2018-09-26","10",200,12271157,57
"7430","신과함께-인과 연","2018-09-27","27",244,12271401,58
"7431","신과함께-인과 연","2018-09-28","29",227,12271628,59
"7432","신과함께-인과 연","2018-09-29","25",268,12271896,60
"7433","신과함께-인과 연","2018-09-30","24",323,12272219,61
"7434","신과함께-인과 연","2018-10-01","17",93,12272312,62
"7435","신과함께-인과 연","2018-10-02","19",100,12272412,63
"7436","신과함께-인과 연","2018-10-03","1",23,12272435,64
"7437","신과함께-인과 연","2018-10-04","1",2,12272437,65
"7438","신과함께-인과 연","2018-10-05","1",26,12272463,66
"7439","신과함께-인과 연","2018-10-06","1",124,12272587,67
"7440","신과함께-인과 연","2018-10-10","3",151,12272738,68
"7441","신과함께-인과 연","2018-10-11","1",4,12272742,69
"7442","신과함께-인과 연","2018-10-12","1",1,12272743,70
"7443","신과함께-인과 연","2018-10-13","2",8,12272751,71
"7444","신과함께-인과 연","2018-10-14","2",4,12272755,72
"7445","신과함께-인과 연","2018-10-15","2",6,12272761,73
"7446","신과함께-인과 연","2018-10-16","2",4,12272765,74
"7447","신과함께-인과 연","2018-10-17","1",2,12272767,75
"7448","신과함께-인과 연","2018-10-18","1",0,12272767,76
"7449","신과함께-인과 연","2018-10-20","1",0,12272767,77
"7450","신과함께-인과 연","2018-10-21","1",6,12272773,78
"7451","신과함께-인과 연","2018-10-22","1",8,12272781,79
"7452","신과함께-인과 연","2018-10-23","1",3,12272784,80
"7453","신과함께-인과 연","2018-10-24","1",3,12272787,81
"7454","신과함께-인과 연","2018-10-26","2",151,12272938,82
"7455","신과함께-인과 연","2018-10-27","1",9,12272947,83
"7456","신과함께-인과 연","2018-10-28","2",23,12272970,84
"7457","신과함께-인과 연","2018-10-30","1",169,12273139,85
"7458","신과함께-인과 연","2018-10-31","1",168,12273307,86
"7459","신과함께-인과 연","2018-11-01","3",525,12273832,87
"7460","신과함께-인과 연","2018-11-02","3",181,12274013,88
"7461","신과함께-인과 연","2018-11-03","1",3,12274016,89
"7462","신과함께-인과 연","2018-11-04","1",1,12274017,90
"7463","신과함께-인과 연","2018-11-07","1",5,12274022,91
"7464","신과함께-인과 연","2018-11-09","1",1,12274023,92
"7465","신과함께-인과 연","2018-11-10","1",4,12274027,93
"7466","신과함께-인과 연","2018-11-15","1",132,12274159,94
"7467","신과함께-인과 연","2018-12-01","2",190,12274349,95
"7468","신과함께-인과 연","2018-12-14","3",320,12274669,96
"7469","신과함께-인과 연","2018-12-15","1",2,12274671,97
"7470","신과함께-인과 연","2018-12-16","1",175,12274846,98
"7471","신과함께-인과 연","2018-12-20","1",150,12274996,99
"7472","신과함께-인과 연","2019-01-27","2",526,12275522,100
"7473","신과함께-인과 연","2019-01-31","1",321,12275843,101
"7474","신과함께-인과 연","2019-03-03","2",272,12276115,102
"7592","안시성","2018-09-10","1",406,406,0
"7593","안시성","2018-09-12","9",2891,3297,0
"7594","안시성","2018-09-13","29",7425,10722,0
"7595","안시성","2018-09-14","29",4187,14909,0
"7596","안시성","2018-09-17","31",5806,20715,0
"7597","안시성","2018-09-18","19",4535,25250,0
"7598","안시성","2018-09-19","1,121",122859,148109,1
"7599","안시성","2018-09-20","1,172",133051,281160,2
"7600","안시성","2018-09-21","1,175",211699,492859,3
"7601","안시성","2018-09-22","1,279",433290,926149,4
"7602","안시성","2018-09-23","1,344",484415,1410564,5
"7603","안시성","2018-09-24","1,476",691357,2101921,6
"7604","안시성","2018-09-25","1,540",795259,2897180,7
"7605","안시성","2018-09-26","1,430",655960,3553140,8
"7606","안시성","2018-09-27","1,264",163516,3716656,9
"7607","안시성","2018-09-28","1,318",170503,3887159,10
"7608","안시성","2018-09-29","1,383",337367,4224526,11
"7609","안시성","2018-09-30","1,365",307431,4531957,12
"7610","안시성","2018-10-01","1,277",93971,4625928,13
"7611","안시성","2018-10-02","1,294",103875,4729803,14
"7612","안시성","2018-10-03","657",136204,4866007,15
"7613","안시성","2018-10-04","633",33082,4899089,16
"7614","안시성","2018-10-05","649",48512,4947601,17
"7615","안시성","2018-10-06","644",103687,5051288,18
"7616","안시성","2018-10-07","622",82669,5133957,19
"7617","안시성","2018-10-08","635",51263,5185220,20
"7618","안시성","2018-10-09","584",64896,5250116,21
"7619","안시성","2018-10-10","544",18852,5268968,22
"7620","안시성","2018-10-11","484",13036,5282004,23
"7621","안시성","2018-10-12","522",16843,5298847,24
"7622","안시성","2018-10-13","535",28823,5327670,25
"7623","안시성","2018-10-14","528",26620,5354290,26
"7624","안시성","2018-10-15","489",9655,5363945,27
"7625","안시성","2018-10-16","492",8984,5372929,28
"7626","안시성","2018-10-17","470",9682,5382611,29
"7627","안시성","2018-10-18","248",5337,5387948,30
"7628","안시성","2018-10-19","260",6243,5394191,31
"7629","안시성","2018-10-20","262",9575,5403766,32
"7630","안시성","2018-10-21","269",9604,5413370,33
"7631","안시성","2018-10-22","261",3936,5417306,34
"7632","안시성","2018-10-23","271",5222,5422528,35
"7633","안시성","2018-10-24","256",4093,5426621,36
"7634","안시성","2018-10-25","91",1720,5428341,37
"7635","안시성","2018-10-26","87",1746,5430087,38
"7636","안시성","2018-10-27","72",1545,5431632,39
"7637","안시성","2018-10-28","67",1402,5433034,40
"7638","안시성","2018-10-29","67",1196,5434230,41
"7639","안시성","2018-10-30","66",1410,5435640,42
"7640","안시성","2018-10-31","14",754,5436394,43
"7641","안시성","2018-11-01","9",596,5436990,44
"7642","안시성","2018-11-02","8",358,5437348,45
"7643","안시성","2018-11-03","4",61,5437409,46
"7644","안시성","2018-11-04","5",50,5437459,47
"7645","안시성","2018-11-05","4",13,5437472,48
"7646","안시성","2018-11-06","8",431,5437903,49
"7647","안시성","2018-11-07","5",24,5437927,50
"7648","안시성","2018-11-08","8",456,5438383,51
"7649","안시성","2018-11-09","6",220,5438603,52
"7650","안시성","2018-11-10","3",7,5438610,53
"7651","안시성","2018-11-11","4",98,5438708,54
"7652","안시성","2018-11-12","2",2,5438710,55
"7653","안시성","2018-11-13","3",10,5438720,56
"7654","안시성","2018-11-14","4",173,5438893,57
"7655","안시성","2018-11-15","1",0,5438893,58
"7656","안시성","2018-11-16","5",18,5438911,59
"7657","안시성","2018-11-17","1",8,5438919,60
"7658","안시성","2018-11-19","1",3,5438922,61
"7659","안시성","2018-11-20","1",1,5438923,62
"7660","안시성","2018-11-22","1",200,5439123,63
"7661","안시성","2018-11-25","1",185,5439308,64
"7662","안시성","2018-11-28","2",180,5439488,65
"7663","안시성","2018-11-29","3",427,5439915,66
"7664","안시성","2018-11-30","1",86,5440001,67
"7665","안시성","2018-12-13","1",185,5440186,68
"7666","안시성","2019-01-24","2",340,5440526,69
"7667","안시성","2019-01-27","1",234,5440760,70
"7668","안시성","2019-01-28","2",260,5441020,71
"7669","완벽한 타인","2018-10-01","1",158,158,0
"7670","완벽한 타인","2018-10-02","1",231,389,0
"7671","완벽한 타인","2018-10-12","1",124,513,0
"7672","완벽한 타인","2018-10-16","4",895,1408,0
"7673","완벽한 타인","2018-10-17","6",1238,2646,0
"7674","완벽한 타인","2018-10-18","2",248,2894,0
"7675","완벽한 타인","2018-10-22","2",644,3538,0
"7676","완벽한 타인","2018-10-23","18",3436,6974,0
"7677","완벽한 타인","2018-10-24","19",4113,11087,0
"7678","완벽한 타인","2018-10-26","2",472,11559,0
"7679","완벽한 타인","2018-10-27","136",13057,24616,0
"7680","완벽한 타인","2018-10-28","136",17393,42009,0
"7681","완벽한 타인","2018-10-29","15",3119,45128,0
"7682","완벽한 타인","2018-10-30","32",1982,47110,0
"7683","완벽한 타인","2018-10-31","1,081",274118,321228,1
"7684","완벽한 타인","2018-11-01","1,048",170213,491441,2
"7685","완벽한 타인","2018-11-02","1,122",248122,739563,3
"7686","완벽한 타인","2018-11-03","1,305",474745,1214308,4
"7687","완벽한 타인","2018-11-04","1,313",450294,1664602,5
"7688","완벽한 타인","2018-11-05","1,189",185179,1849781,6
"7689","완벽한 타인","2018-11-06","1,214",179137,2028918,7
"7690","완벽한 타인","2018-11-07","1,258",177435,2206353,8
"7691","완벽한 타인","2018-11-08","1,256",169783,2376136,9
"7692","완벽한 타인","2018-11-09","1,285",225144,2601280,10
"7693","완벽한 타인","2018-11-10","1,325",407144,3008424,11
"7694","완벽한 타인","2018-11-11","1,322",367324,3375748,12
"7695","완벽한 타인","2018-11-12","1,231",127366,3503114,13
"7696","완벽한 타인","2018-11-13","1,252",117089,3620203,14
"7697","완벽한 타인","2018-11-14","823",117230,3737433,15
"7698","완벽한 타인","2018-11-15","853",114544,3851977,16
"7699","완벽한 타인","2018-11-16","866",128960,3980937,17
"7700","완벽한 타인","2018-11-17","899",196946,4177883,18
"7701","완벽한 타인","2018-11-18","883",172589,4350472,19
"7702","완벽한 타인","2018-11-19","849",77444,4427916,20
"7703","완벽한 타인","2018-11-20","864",69729,4497645,21
"7704","완벽한 타인","2018-11-21","874",74473,4572118,22
"7705","완벽한 타인","2018-11-22","675",51202,4623320,23
"7706","완벽한 타인","2018-11-23","719",63772,4687092,24
"7707","완벽한 타인","2018-11-24","731",109493,4796585,25
"7708","완벽한 타인","2018-11-25","721",93769,4890354,26
"7709","완벽한 타인","2018-11-26","660",40652,4931006,27
"7710","완벽한 타인","2018-11-27","681",38368,4969374,28
"7711","완벽한 타인","2018-11-28","537",35837,5005211,29
"7712","완벽한 타인","2018-11-29","483",22632,5027843,30
"7713","완벽한 타인","2018-11-30","499",28259,5056102,31
"7714","완벽한 타인","2018-12-01","541",41080,5097182,32
"7715","완벽한 타인","2018-12-02","548",34861,5132043,33
"7716","완벽한 타인","2018-12-03","514",16855,5148898,34
"7717","완벽한 타인","2018-12-04","517",17672,5166570,35
"7718","완벽한 타인","2018-12-05","308",9855,5176425,36
"7719","완벽한 타인","2018-12-06","296",8781,5185206,37
"7720","완벽한 타인","2018-12-07","281",9401,5194607,38
"7721","완벽한 타인","2018-12-08","283",14782,5209389,39
"7722","완벽한 타인","2018-12-09","269",12904,5222293,40
"7723","완벽한 타인","2018-12-10","290",6473,5228766,41
"7724","완벽한 타인","2018-12-11","277",6379,5235145,42
"7725","완벽한 타인","2018-12-12","234",6139,5241284,43
"7726","완벽한 타인","2018-12-13","233",6564,5247848,44
"7727","완벽한 타인","2018-12-14","226",6053,5253901,45
"7728","완벽한 타인","2018-12-15","211",8636,5262537,46
"7729","완벽한 타인","2018-12-16","210",8084,5270621,47
"7730","완벽한 타인","2018-12-17","238",4909,5275530,48
"7731","완벽한 타인","2018-12-18","244",5090,5280620,49
"7732","완벽한 타인","2018-12-19","36",545,5281165,50
"7733","완벽한 타인","2018-12-20","39",720,5281885,51
"7734","완벽한 타인","2018-12-21","42",790,5282675,52
"7735","완벽한 타인","2018-12-22","38",1553,5284228,53
"7736","완벽한 타인","2018-12-23","39",1625,5285853,54
"7737","완벽한 타인","2018-12-24","34",1268,5287121,55
"7738","완벽한 타인","2018-12-25","18",1201,5288322,56
"7739","완벽한 타인","2018-12-26","1",35,5288357,57
"7740","완벽한 타인","2018-12-27","1",29,5288386,58
"7741","완벽한 타인","2018-12-28","3",943,5289329,59
"7742","완벽한 타인","2018-12-29","29",1645,5290974,60
"7743","완벽한 타인","2018-12-30","29",1738,5292712,61
"7744","완벽한 타인","2018-12-31","21",723,5293435,62
"7745","완벽한 타인","2019-01-01","7",536,5293971,63
"7746","완벽한 타인","2019-01-02","3",45,5294016,64
"7747","완벽한 타인","2019-01-03","1",13,5294029,65
"7748","완벽한 타인","2019-01-04","1",12,5294041,66
"7749","완벽한 타인","2019-01-05","1",30,5294071,67
"7750","완벽한 타인","2019-01-06","1",7,5294078,68
"7751","완벽한 타인","2019-01-07","1",12,5294090,69
"7752","완벽한 타인","2019-01-08","1",29,5294119,70
"7849","독전","2018-05-11","1",401,401,0
"7850","독전","2018-05-15","5",1143,1544,0
"7851","독전","2018-05-17","12",1943,3487,0
"7852","독전","2018-05-18","4",747,4234,0
"7853","독전","2018-05-21","12",2883,7117,0
"7854","독전","2018-05-22","1,063",376530,383647,1
"7855","독전","2018-05-23","1,071",161146,544793,2
"7856","독전","2018-05-24","1,078",158565,703358,3
"7857","독전","2018-05-25","1,188",219564,922922,4
"7858","독전","2018-05-26","1,357",459752,1382674,5
"7859","독전","2018-05-27","1,345",430064,1812738,6
"7860","독전","2018-05-28","1,216",157099,1969837,7
"7861","독전","2018-05-29","1,219",137551,2107388,8
"7862","독전","2018-05-30","1,390",299941,2407329,9
"7863","독전","2018-05-31","1,292",142362,2549691,10
"7864","독전","2018-06-01","1,382",193592,2743283,11
"7865","독전","2018-06-02","1,532",421760,3165043,12
"7866","독전","2018-06-03","1,503",366225,3531268,13
"7867","독전","2018-06-04","1,373",117688,3648956,14
"7868","독전","2018-06-05","1,413",155578,3804534,15
"7869","독전","2018-06-06","788",230603,4035137,16
"7870","독전","2018-06-07","734",68600,4103737,17
"7871","독전","2018-06-08","753",84343,4188080,18
"7872","독전","2018-06-09","738",168852,4356932,19
"7873","독전","2018-06-10","744",148107,4505039,20
"7874","독전","2018-06-11","730",52889,4557928,21
"7875","독전","2018-06-12","762",61751,4619679,22
"7876","독전","2018-06-13","434",58713,4678392,23
"7877","독전","2018-06-14","431",21751,4700143,24
"7878","독전","2018-06-15","459",26266,4726409,25
"7879","독전","2018-06-16","549",53825,4780234,26
"7880","독전","2018-06-17","567",46614,4826848,27
"7881","독전","2018-06-18","514",15514,4842362,28
"7882","독전","2018-06-19","527",17970,4860332,29
"7883","독전","2018-06-20","436",17470,4877802,30
"7884","독전","2018-06-21","417",14144,4891946,31
"7885","독전","2018-06-22","436",19096,4911042,32
"7886","독전","2018-06-23","529",32418,4943460,33
"7887","독전","2018-06-24","511",34685,4978145,34
"7888","독전","2018-06-25","477",15260,4993405,35
"7889","독전","2018-06-26","470",14910,5008315,36
"7890","독전","2018-06-27","285",10367,5018682,37
"7891","독전","2018-06-28","264",5893,5024575,38
"7892","독전","2018-06-29","262",6898,5031473,39
"7893","독전","2018-06-30","257",12298,5043771,40
"7894","독전","2018-07-01","244",9334,5053105,41
"7895","독전","2018-07-02","251",4167,5057272,42
"7896","독전","2018-07-03","247",3800,5061072,43
"7897","독전","2018-07-04","21",221,5061293,44
"7898","독전","2018-07-05","19",264,5061557,45
"7899","독전","2018-07-06","17",266,5061823,46
"7900","독전","2018-07-07","18",287,5062110,47
"7901","독전","2018-07-08","16",301,5062411,48
"7902","독전","2018-07-09","21",197,5062608,49
"7903","독전","2018-07-10","23",289,5062897,50
"7904","독전","2018-07-11","10",84,5062981,51
"7905","독전","2018-07-12","7",45,5063026,52
"7906","독전","2018-07-13","7",140,5063166,53
"7907","독전","2018-07-14","7",92,5063258,54
"7908","독전","2018-07-15","8",95,5063353,55
"7909","독전","2018-07-16","9",34,5063387,56
"7910","독전","2018-07-17","7",41,5063428,57
"7911","독전","2018-07-18","1",1,5063429,58
"7912","독전","2018-07-23","1",0,5063429,59
"7913","독전","2018-07-24","1",1,5063430,60
"7914","독전","2018-07-27","1",3,5063433,61
"7915","독전","2018-08-22","1",21,5063454,62
"7916","독전","2018-08-25","1",166,5063620,63
"7917","독전","2018-11-12","1",0,5063620,64
"7918","독전","2018-11-18","1",0,5063620,65
"7919","독전","2018-12-15","1",42,5063662,66
"7920","독전","2018-12-18","1",2,5063664,67
"7921","독전","2018-12-20","1",20,5063684,68
"7922","공작","2018-07-25","1",200,200,0
"7923","공작","2018-07-31","9",3051,3251,0
"7924","공작","2018-08-01","1",371,3622,0
"7925","공작","2018-08-02","6",4348,7970,0
"7926","공작","2018-08-03","1",429,8399,0
"7927","공작","2018-08-06","27",4538,12937,0
"7928","공작","2018-08-07","10",2160,15097,0
"7929","공작","2018-08-08","934",333316,348413,1
"7930","공작","2018-08-09","1,103",293161,641574,2
"7931","공작","2018-08-10","1,204",319083,960657,3
"7932","공작","2018-08-11","1,304",566483,1527140,4
"7933","공작","2018-08-12","1,317",539350,2066490,5
"7934","공작","2018-08-13","1,218",256834,2323324,6
"7935","공작","2018-08-14","1,265",299991,2623315,7
"7936","공작","2018-08-15","1,112",476029,3099344,8
"7937","공작","2018-08-16","1,028",160322,3259666,9
"7938","공작","2018-08-17","1,038",164591,3424257,10
"7939","공작","2018-08-18","1,051",330041,3754298,11
"7940","공작","2018-08-19","1,016",287278,4041576,12
"7941","공작","2018-08-20","959",91225,4132801,13
"7942","공작","2018-08-21","974",87838,4220639,14
"7943","공작","2018-08-22","836",69826,4290465,15
"7944","공작","2018-08-23","784",54462,4344927,16
"7945","공작","2018-08-24","797",74448,4419375,17
"7946","공작","2018-08-25","746",129922,4549297,18
"7947","공작","2018-08-26","732",113325,4662622,19
"7948","공작","2018-08-27","725",37333,4699955,20
"7949","공작","2018-08-28","724",36399,4736354,21
"7950","공작","2018-08-29","570",35128,4771482,22
"7951","공작","2018-08-30","519",21573,4793055,23
"7952","공작","2018-08-31","525",24071,4817126,24
"7953","공작","2018-09-01","536",29573,4846699,25
"7954","공작","2018-09-02","514",32887,4879586,26
"7955","공작","2018-09-03","516",11584,4891170,27
"7956","공작","2018-09-04","515",10306,4901476,28
"7957","공작","2018-09-05","480",8865,4910341,29
"7958","공작","2018-09-06","361",6365,4916706,30
"7959","공작","2018-09-07","367",7305,4924011,31
"7960","공작","2018-09-08","375",12580,4936591,32
"7961","공작","2018-09-09","363",12994,4949585,33
"7962","공작","2018-09-10","365",4331,4953916,34
"7963","공작","2018-09-11","387",5328,4959244,35
"7964","공작","2018-09-12","130",1181,4960425,36
"7965","공작","2018-09-13","139",1801,4962226,37
"7966","공작","2018-09-14","133",1363,4963589,38
"7967","공작","2018-09-15","138",2586,4966175,39
"7968","공작","2018-09-16","131",2150,4968325,40
"7969","공작","2018-09-17","118",1117,4969442,41
"7970","공작","2018-09-18","123",1011,4970453,42
"7971","공작","2018-09-19","9",185,4970638,43
"7972","공작","2018-09-20","14",812,4971450,44
"7973","공작","2018-09-21","7",170,4971620,45
"7974","공작","2018-09-22","6",188,4971808,46
"7975","공작","2018-09-23","7",190,4971998,47
"7976","공작","2018-09-24","9",247,4972245,48
"7977","공작","2018-09-25","8",233,4972478,49
"7978","공작","2018-09-26","6",204,4972682,50
"7979","공작","2018-09-27","8",233,4972915,51
"7980","공작","2018-09-28","7",156,4973071,52
"7981","공작","2018-09-29","7",166,4973237,53
"7982","공작","2018-09-30","7",180,4973417,54
"7983","공작","2018-10-01","7",163,4973580,55
"7984","공작","2018-10-02","7",157,4973737,56
"7985","공작","2018-10-03","6",166,4973903,57
"7986","공작","2018-10-10","1",2,4973905,58
"7987","공작","2018-10-11","2",11,4973916,59
"7988","공작","2018-10-12","1",7,4973923,60
"7989","공작","2018-10-13","1",6,4973929,61
"7990","공작","2018-10-14","1",8,4973937,62
"7991","공작","2018-10-15","1",3,4973940,63
"7992","공작","2018-10-16","1",3,4973943,64
"7993","공작","2018-10-17","2",79,4974022,65
"7994","공작","2018-10-19","1",0,4974022,66
"7995","공작","2018-10-27","1",318,4974340,67
"7996","공작","2018-10-30","1",57,4974397,68
"7997","공작","2018-10-31","1",57,4974454,69
"7998","공작","2018-11-01","1",58,4974512,70
"7999","공작","2018-11-13","1",0,4974512,71
"8000","공작","2018-11-17","1",0,4974512,72
"8001","공작","2018-12-29","1",8,4974520,73
"8002","암수살인","2018-09-12","4",714,714,0
"8003","암수살인","2018-09-13","14",3559,4273,0
"8004","암수살인","2018-09-14","2",448,4721,0
"8005","암수살인","2018-09-17","19",4200,8921,0
"8006","암수살인","2018-09-18","25",4571,13492,0
"8007","암수살인","2018-09-20","2",313,13805,0
"8008","암수살인","2018-09-21","1",288,14093,0
"8009","암수살인","2018-09-27","2",406,14499,0
"8010","암수살인","2018-09-28","16",2202,16701,0
"8011","암수살인","2018-10-01","3",830,17531,0
"8012","암수살인","2018-10-02","20",2981,20512,0
"8013","암수살인","2018-10-03","957",439309,459821,1
"8014","암수살인","2018-10-04","942",156928,616749,2
"8015","암수살인","2018-10-05","1,018",216771,833520,3
"8016","암수살인","2018-10-06","1,163",424807,1258327,4
"8017","암수살인","2018-10-07","1,177",354127,1612454,5
"8018","암수살인","2018-10-08","1,134",201828,1814282,6
"8019","암수살인","2018-10-09","1,175",285521,2099803,7
"8020","암수살인","2018-10-10","1,114",95021,2194824,8
"8021","암수살인","2018-10-11","986",86094,2280918,9
"8022","암수살인","2018-10-12","1,015",120803,2401721,10
"8023","암수살인","2018-10-13","1,062",231038,2632759,11
"8024","암수살인","2018-10-14","1,064",201135,2833894,12
"8025","암수살인","2018-10-15","992",73152,2907046,13
"8026","암수살인","2018-10-16","996",62649,2969695,14
"8027","암수살인","2018-10-17","998",64221,3033916,15
"8028","암수살인","2018-10-18","769",51269,3085185,16
"8029","암수살인","2018-10-19","787",73159,3158344,17
"8030","암수살인","2018-10-20","902",127843,3286187,18
"8031","암수살인","2018-10-21","879",110590,3396777,19
"8032","암수살인","2018-10-22","827",37547,3434324,20
"8033","암수살인","2018-10-23","816",38051,3472375,21
"8034","암수살인","2018-10-24","824",38993,3511368,22
"8035","암수살인","2018-10-25","591",25072,3536440,23
"8036","암수살인","2018-10-26","595",37941,3574381,24
"8037","암수살인","2018-10-27","601",62589,3636970,25
"8038","암수살인","2018-10-28","601",60680,3697650,26
"8039","암수살인","2018-10-29","591",22231,3719881,27
"8040","암수살인","2018-10-30","587",23502,3743383,28
"8041","암수살인","2018-10-31","370",12502,3755885,29
"8042","암수살인","2018-11-01","349",5028,3760913,30
"8043","암수살인","2018-11-02","354",5137,3766050,31
"8044","암수살인","2018-11-03","289",6466,3772516,32
"8045","암수살인","2018-11-04","280",5095,3777611,33
"8046","암수살인","2018-11-05","285",2442,3780053,34
"8047","암수살인","2018-11-06","265",2198,3782251,35
"8048","암수살인","2018-11-07","96",947,3783198,36
"8049","암수살인","2018-11-08","61",624,3783822,37
"8050","암수살인","2018-11-09","63",665,3784487,38
"8051","암수살인","2018-11-10","52",986,3785473,39
"8052","암수살인","2018-11-11","55",939,3786412,40
"8053","암수살인","2018-11-12","45",365,3786777,41
"8054","암수살인","2018-11-13","67",1084,3787861,42
"8055","암수살인","2018-11-14","6",122,3787983,43
"8056","암수살인","2018-11-15","22",712,3788695,44
"8057","암수살인","2018-11-16","1",7,3788702,45
"8058","암수살인","2018-11-17","7",100,3788802,46
"8059","암수살인","2018-11-18","1",13,3788815,47
"8060","암수살인","2018-11-19","5",135,3788950,48
"8061","암수살인","2018-11-20","4",92,3789042,49
"8062","암수살인","2018-11-21","2",12,3789054,50
"8063","암수살인","2018-11-22","1",27,3789081,51
"8064","암수살인","2018-11-23","1",50,3789131,52
"8065","암수살인","2018-11-26","1",19,3789150,53
"8066","암수살인","2018-11-27","1",1,3789151,54
"8067","암수살인","2018-11-29","2",170,3789321,55
"8068","국가부도의 날","2018-11-07","1",406,406,0
"8069","국가부도의 날","2018-11-19","8",2636,3042,0
"8070","국가부도의 날","2018-11-20","4",915,3957,0
"8071","국가부도의 날","2018-11-21","19",2888,6845,0
"8072","국가부도의 날","2018-11-22","18",3663,10508,0
"8073","국가부도의 날","2018-11-23","14",2410,12918,0
"8074","국가부도의 날","2018-11-24","2",383,13301,0
"8075","국가부도의 날","2018-11-25","2",383,13684,0
"8076","국가부도의 날","2018-11-26","16",1571,15255,0
"8077","국가부도의 날","2018-11-27","22",3953,19208,0
"8078","국가부도의 날","2018-11-28","1,180",301330,320538,1
"8079","국가부도의 날","2018-11-29","1,133",181581,502119,2
"8080","국가부도의 날","2018-11-30","1,156",242516,744635,3
"8081","국가부도의 날","2018-12-01","1,171",427163,1171798,4
"8082","국가부도의 날","2018-12-02","1,152",400083,1571881,5
"8083","국가부도의 날","2018-12-03","1,138",155844,1727725,6
"8084","국가부도의 날","2018-12-04","1,173",144472,1872197,7
"8085","국가부도의 날","2018-12-05","975",111993,1984190,8
"8086","국가부도의 날","2018-12-06","960",108907,2093097,9
"8087","국가부도의 날","2018-12-07","982",129288,2222385,10
"8088","국가부도의 날","2018-12-08","976",256115,2478500,11
"8089","국가부도의 날","2018-12-09","974",245798,2724298,12
"8090","국가부도의 날","2018-12-10","952",84333,2808631,13
"8091","국가부도의 날","2018-12-11","1,012",89309,2897940,14
"8092","국가부도의 날","2018-12-12","896",85784,2983724,15
"8093","국가부도의 날","2018-12-13","919",87984,3071708,16
"8094","국가부도의 날","2018-12-14","971",106108,3177816,17
"8095","국가부도의 날","2018-12-15","961",187005,3364821,18
"8096","국가부도의 날","2018-12-16","946",171177,3535998,19
"8097","국가부도의 날","2018-12-17","917",63357,3599355,20
"8098","국가부도의 날","2018-12-18","966",64550,3663905,21
"8099","국가부도의 날","2018-12-19","302",12265,3676170,22
"8100","국가부도의 날","2018-12-20","300",10177,3686347,23
"8101","국가부도의 날","2018-12-21","285",10857,3697204,24
"8102","국가부도의 날","2018-12-22","238",14297,3711501,25
"8103","국가부도의 날","2018-12-23","232",12412,3723913,26
"8104","국가부도의 날","2018-12-24","187",8923,3732836,27
"8105","국가부도의 날","2018-12-25","65",5244,3738080,28
"8106","국가부도의 날","2018-12-26","51",1964,3740044,29
"8107","국가부도의 날","2018-12-27","46",1528,3741572,30
"8108","국가부도의 날","2018-12-28","44",1384,3742956,31
"8109","국가부도의 날","2018-12-29","37",1426,3744382,32
"8110","국가부도의 날","2018-12-30","39",1326,3745708,33
"8111","국가부도의 날","2018-12-31","38",2244,3747952,34
"8112","국가부도의 날","2019-01-01","21",1124,3749076,35
"8113","국가부도의 날","2019-01-02","20",548,3749624,36
"8114","국가부도의 날","2019-01-03","16",797,3750421,37
"8115","국가부도의 날","2019-01-04","13",244,3750665,38
"8116","국가부도의 날","2019-01-05","14",477,3751142,39
"8117","국가부도의 날","2019-01-06","12",419,3751561,40
"8118","국가부도의 날","2019-01-07","13",229,3751790,41
"8119","국가부도의 날","2019-01-08","13",239,3752029,42
"8120","국가부도의 날","2019-01-09","7",121,3752150,43
"8121","국가부도의 날","2019-01-10","8",131,3752281,44
"8122","국가부도의 날","2019-01-11","2",44,3752325,45
"8123","국가부도의 날","2019-01-12","3",157,3752482,46
"8124","국가부도의 날","2019-01-13","2",26,3752508,47
"8125","국가부도의 날","2019-01-14","2",19,3752527,48
"8126","국가부도의 날","2019-01-15","27",756,3753283,49
"8127","국가부도의 날","2019-01-16","3",59,3753342,50
"8128","국가부도의 날","2019-01-17","25",932,3754274,51
"8129","국가부도의 날","2019-01-18","2",50,3754324,52
"8130","국가부도의 날","2019-01-19","7",160,3754484,53
"8131","국가부도의 날","2019-01-20","1",15,3754499,54
"8132","국가부도의 날","2019-01-21","5",169,3754668,55
"8133","국가부도의 날","2019-01-22","1",6,3754674,56
"8134","국가부도의 날","2019-01-23","2",5,3754679,57
"8135","국가부도의 날","2019-01-24","1",50,3754729,58
"8136","국가부도의 날","2019-01-25","1",1,3754730,59
"8137","국가부도의 날","2019-01-28","1",1,3754731,60
"8138","국가부도의 날","2019-01-29","1",1,3754732,61
"8139","국가부도의 날","2019-02-13","1",251,3754983,62
"8140","그것만이 내 세상","2017-12-28","1",414,414,0
"8141","그것만이 내 세상","2018-01-03","6",1584,1998,0
"8142","그것만이 내 세상","2018-01-07","1",261,2259,0
"8143","그것만이 내 세상","2018-01-10","34",6307,8566,0
"8144","그것만이 내 세상","2018-01-11","9",1652,10218,0
"8145","그것만이 내 세상","2018-01-12","8",1789,12007,0
"8146","그것만이 내 세상","2018-01-15","12",2357,14364,0
"8147","그것만이 내 세상","2018-01-16","55",8343,22707,0
"8148","그것만이 내 세상","2018-01-17","825",126797,149504,1
"8149","그것만이 내 세상","2018-01-18","833",112992,262496,2
"8150","그것만이 내 세상","2018-01-19","825",129275,391771,3
"8151","그것만이 내 세상","2018-01-20","856",259762,651533,4
"8152","그것만이 내 세상","2018-01-21","861",258836,910369,5
"8153","그것만이 내 세상","2018-01-22","843",100645,1011014,6
"8154","그것만이 내 세상","2018-01-23","862",103234,1114248,7
"8155","그것만이 내 세상","2018-01-24","754",92672,1206920,8
"8156","그것만이 내 세상","2018-01-25","791",98162,1305082,9
"8157","그것만이 내 세상","2018-01-26","839",117046,1422128,10
"8158","그것만이 내 세상","2018-01-27","951",279702,1701830,11
"8159","그것만이 내 세상","2018-01-28","956",275942,1977772,12
"8160","그것만이 내 세상","2018-01-29","866",94151,2071923,13
"8161","그것만이 내 세상","2018-01-30","884",91515,2163438,14
"8162","그것만이 내 세상","2018-01-31","706",123036,2286474,15
"8163","그것만이 내 세상","2018-02-01","668",64564,2351038,16
"8164","그것만이 내 세상","2018-02-02","746",78474,2429512,17
"8165","그것만이 내 세상","2018-02-03","855",186723,2616235,18
"8166","그것만이 내 세상","2018-02-04","863",175811,2792046,19
"8167","그것만이 내 세상","2018-02-05","793",53836,2845882,20
"8168","그것만이 내 세상","2018-02-06","840",55685,2901567,21
"8169","그것만이 내 세상","2018-02-07","860",55124,2956691,22
"8170","그것만이 내 세상","2018-02-08","703",41431,2998122,23
"8171","그것만이 내 세상","2018-02-09","689",45104,3043226,24
"8172","그것만이 내 세상","2018-02-10","724",92722,3135948,25
"8173","그것만이 내 세상","2018-02-11","705",84720,3220668,26
"8174","그것만이 내 세상","2018-02-12","674",28443,3249111,27
"8175","그것만이 내 세상","2018-02-13","692",28725,3277836,28
"8176","그것만이 내 세상","2018-02-14","318",9428,3287264,29
"8177","그것만이 내 세상","2018-02-15","312",17402,3304666,30
"8178","그것만이 내 세상","2018-02-16","288",21790,3326456,31
"8179","그것만이 내 세상","2018-02-17","305",24904,3351360,32
"8180","그것만이 내 세상","2018-02-18","315",16902,3368262,33
"8181","그것만이 내 세상","2018-02-19","345",7771,3376033,34
"8182","그것만이 내 세상","2018-02-20","340",6623,3382656,35
"8183","그것만이 내 세상","2018-02-21","321",5558,3388214,36
"8184","그것만이 내 세상","2018-02-22","236",3508,3391722,37
"8185","그것만이 내 세상","2018-02-23","232",3652,3395374,38
"8186","그것만이 내 세상","2018-02-24","211",6930,3402304,39
"8187","그것만이 내 세상","2018-02-25","199",5821,3408125,40
"8188","그것만이 내 세상","2018-02-26","211",3098,3411223,41
"8189","그것만이 내 세상","2018-02-27","206",3527,3414750,42
"8190","그것만이 내 세상","2018-02-28","26",385,3415135,43
"8191","그것만이 내 세상","2018-03-01","6",467,3415602,44
"8192","그것만이 내 세상","2018-03-02","4",34,3415636,45
"8193","그것만이 내 세상","2018-03-03","2",57,3415693,46
"8194","그것만이 내 세상","2018-03-04","3",260,3415953,47
"8195","그것만이 내 세상","2018-03-05","4",92,3416045,48
"8196","그것만이 내 세상","2018-03-06","3",14,3416059,49
"8197","그것만이 내 세상","2018-03-07","3",253,3416312,50
"8198","그것만이 내 세상","2018-03-08","2",4,3416316,51
"8199","그것만이 내 세상","2018-03-09","3",35,3416351,52
"8200","그것만이 내 세상","2018-03-12","2",21,3416372,53
"8201","그것만이 내 세상","2018-03-13","2",31,3416403,54
"8202","그것만이 내 세상","2018-03-14","3",254,3416657,55
"8203","그것만이 내 세상","2018-03-15","4",82,3416739,56
"8204","그것만이 내 세상","2018-03-19","1",1,3416740,57
"8205","그것만이 내 세상","2018-03-20","3",256,3416996,58
"8206","그것만이 내 세상","2018-03-21","1",138,3417134,59
"8207","그것만이 내 세상","2018-03-22","3",79,3417213,60
"8208","그것만이 내 세상","2018-03-27","1",1,3417214,61
"8209","그것만이 내 세상","2018-04-08","1",110,3417324,62
"8210","그것만이 내 세상","2018-04-12","2",369,3417693,63
"8211","그것만이 내 세상","2018-04-20","1",120,3417813,64
"8212","그것만이 내 세상","2018-04-26","1",168,3417981,65
"8213","그것만이 내 세상","2018-05-10","1",62,3418043,66
"8214","그것만이 내 세상","2018-06-14","1",43,3418086,67
"8215","그것만이 내 세상","2018-06-21","1",128,3418214,68
"8216","그것만이 내 세상","2018-06-26","1",141,3418355,69
"8217","그것만이 내 세상","2018-07-23","1",0,3418355,70
"8218","그것만이 내 세상","2018-09-04","1",1,3418356,71
"8219","그것만이 내 세상","2018-09-10","1",123,3418479,72
"8220","그것만이 내 세상","2018-09-18","1",183,3418662,73
"8221","그것만이 내 세상","2018-09-27","1",114,3418776,74
"8222","그것만이 내 세상","2018-10-30","1",147,3418923,75
"8223","그것만이 내 세상","2018-10-31","1",85,3419008,76
"8224","그것만이 내 세상","2018-11-16","1",103,3419111,77
"8225","그것만이 내 세상","2018-11-21","1",127,3419238,78
"8226","그것만이 내 세상","2018-12-04","1",160,3419398,79
"8227","그것만이 내 세상","2018-12-06","1",138,3419536,80
"8228","그것만이 내 세상","2018-12-12","1",137,3419673,81
"8229","그것만이 내 세상","2018-12-28","1",80,3419753,82
"8230","마녀","2018-06-15","1",830,830,0
"8231","마녀","2018-06-19","5",1571,2401,0
"8232","마녀","2018-06-20","10",3012,5413,0
"8233","마녀","2018-06-23","7",765,6178,0
"8234","마녀","2018-06-24","1",180,6358,0
"8235","마녀","2018-06-25","4",1478,7836,0
"8236","마녀","2018-06-27","880",121990,129826,1
"8237","마녀","2018-06-28","864",94414,224240,2
"8238","마녀","2018-06-29","921",136113,360353,3
"8239","마녀","2018-06-30","1,054",301612,661965,4
"8240","마녀","2018-07-01","1,117",296821,958786,5
"8241","마녀","2018-07-02","1,017",124470,1083256,6
"8242","마녀","2018-07-03","1,033",115689,1198945,7
"8243","마녀","2018-07-04","667",73312,1272257,8
"8244","마녀","2018-07-05","694",73342,1345599,9
"8245","마녀","2018-07-06","729",98836,1444435,10
"8246","마녀","2018-07-07","801",181475,1625910,11
"8247","마녀","2018-07-08","808",170792,1796702,12
"8248","마녀","2018-07-09","750",77886,1874588,13
"8249","마녀","2018-07-10","772",83912,1958500,14
"8250","마녀","2018-07-11","662",70060,2028560,15
"8251","마녀","2018-07-12","683",61009,2089569,16
"8252","마녀","2018-07-13","677",79406,2168975,17
"8253","마녀","2018-07-14","751",160607,2329582,18
"8254","마녀","2018-07-15","756",147295,2476877,19
"8255","마녀","2018-07-16","724",54579,2531456,20
"8256","마녀","2018-07-17","728",51203,2582659,21
"8257","마녀","2018-07-18","582",49738,2632397,22
"8258","마녀","2018-07-19","591",47058,2679455,23
"8259","마녀","2018-07-20","648",71362,2750817,24
"8260","마녀","2018-07-21","750",127555,2878372,25
"8261","마녀","2018-07-22","757",121909,3000281,26
"8262","마녀","2018-07-23","691",51378,3051659,27
"8263","마녀","2018-07-24","697",49582,3101241,28
"8264","마녀","2018-07-25","319",14300,3115541,29
"8265","마녀","2018-07-26","279",9648,3125189,30
"8266","마녀","2018-07-27","263",9927,3135116,31
"8267","마녀","2018-07-28","235",14724,3149840,32
"8268","마녀","2018-07-29","256",14078,3163918,33
"8269","마녀","2018-07-30","265",10961,3174879,34
"8270","마녀","2018-07-31","258",11551,3186430,35
"8271","마녀","2018-08-01","24",457,3186887,36
"8272","마녀","2018-08-02","26",484,3187371,37
"8273","마녀","2018-08-03","15",375,3187746,38
"8274","마녀","2018-08-04","16",370,3188116,39
"8275","마녀","2018-08-05","17",289,3188405,40
"8276","마녀","2018-08-06","16",232,3188637,41
"8277","마녀","2018-08-07","17",197,3188834,42
"8278","마녀","2018-08-08","1",16,3188850,43
"8279","마녀","2018-08-09","1",23,3188873,44
"8280","마녀","2018-08-10","1",24,3188897,45
"8281","마녀","2018-08-11","1",43,3188940,46
"8282","마녀","2018-08-12","1",29,3188969,47
"8283","마녀","2018-08-13","1",10,3188979,48
"8284","마녀","2018-08-14","1",15,3188994,49
"8285","마녀","2018-08-15","1",28,3189022,50
"8286","마녀","2018-08-16","1",11,3189033,51
"8287","마녀","2018-08-17","1",11,3189044,52
"8288","마녀","2018-08-18","1",16,3189060,53
"8289","마녀","2018-08-19","1",10,3189070,54
"8290","마녀","2018-08-20","1",5,3189075,55
"8291","마녀","2018-08-21","1",9,3189084,56
"8292","마녀","2018-08-22","1",7,3189091,57
"8293","마녀","2018-11-12","1",0,3189091,58
"8294","마녀","2018-11-16","1",0,3189091,59
"8295","탐정: 리턴즈","2018-05-25","2",256,256,0
"8296","탐정: 리턴즈","2018-05-30","4",1256,1512,0
"8297","탐정: 리턴즈","2018-05-31","17",3322,4834,0
"8298","탐정: 리턴즈","2018-06-05","9",1451,6285,0
"8299","탐정: 리턴즈","2018-06-07","9",1908,8193,0
"8300","탐정: 리턴즈","2018-06-09","5",1038,9231,0
"8301","탐정: 리턴즈","2018-06-10","5",599,9830,0
"8302","탐정: 리턴즈","2018-06-11","17",3330,13160,0
"8303","탐정: 리턴즈","2018-06-12","25",2787,15947,0
"8304","탐정: 리턴즈","2018-06-13","971",235184,251131,1
"8305","탐정: 리턴즈","2018-06-14","967",92253,343384,2
"8306","탐정: 리턴즈","2018-06-15","947",127030,470414,3
"8307","탐정: 리턴즈","2018-06-16","1,033",288726,759140,4
"8308","탐정: 리턴즈","2018-06-17","1,041",271180,1030320,5
"8309","탐정: 리턴즈","2018-06-18","993",73793,1104113,6
"8310","탐정: 리턴즈","2018-06-19","1,017",95060,1199173,7
"8311","탐정: 리턴즈","2018-06-20","1,003",105042,1304215,8
"8312","탐정: 리턴즈","2018-06-21","975",101536,1405751,9
"8313","탐정: 리턴즈","2018-06-22","1,012",131759,1537510,10
"8314","탐정: 리턴즈","2018-06-23","1,137",242646,1780156,11
"8315","탐정: 리턴즈","2018-06-24","1,091",252731,2032887,12
"8316","탐정: 리턴즈","2018-06-25","1,011",91676,2124563,13
"8317","탐정: 리턴즈","2018-06-26","1,031",93252,2217815,14
"8318","탐정: 리턴즈","2018-06-27","854",124510,2342325,15
"8319","탐정: 리턴즈","2018-06-28","834",68148,2410473,16
"8320","탐정: 리턴즈","2018-06-29","880",84356,2494829,17
"8321","탐정: 리턴즈","2018-06-30","932",182557,2677386,18
"8322","탐정: 리턴즈","2018-07-01","929",152451,2829837,19
"8323","탐정: 리턴즈","2018-07-02","837",52435,2882272,20
"8324","탐정: 리턴즈","2018-07-03","844",46377,2928649,21
"8325","탐정: 리턴즈","2018-07-04","459",19456,2948105,22
"8326","탐정: 리턴즈","2018-07-05","455",19332,2967437,23
"8327","탐정: 리턴즈","2018-07-06","468",23447,2990884,24
"8328","탐정: 리턴즈","2018-07-07","440",35849,3026733,25
"8329","탐정: 리턴즈","2018-07-08","448",34251,3060984,26
"8330","탐정: 리턴즈","2018-07-09","460",14402,3075386,27
"8331","탐정: 리턴즈","2018-07-10","464",15380,3090766,28
"8332","탐정: 리턴즈","2018-07-11","276",7697,3098463,29
"8333","탐정: 리턴즈","2018-07-12","229",5547,3104010,30
"8334","탐정: 리턴즈","2018-07-13","214",6187,3110197,31
"8335","탐정: 리턴즈","2018-07-14","198",11365,3121562,32
"8336","탐정: 리턴즈","2018-07-15","192",11424,3132986,33
"8337","탐정: 리턴즈","2018-07-16","200",4349,3137335,34
"8338","탐정: 리턴즈","2018-07-17","212",4750,3142085,35
"8339","탐정: 리턴즈","2018-07-18","46",1324,3143409,36
"8340","탐정: 리턴즈","2018-07-19","44",1020,3144429,37
"8341","탐정: 리턴즈","2018-07-20","40",1349,3145778,38
"8342","탐정: 리턴즈","2018-07-21","34",1445,3147223,39
"8343","탐정: 리턴즈","2018-07-22","34",1390,3148613,40
"8344","탐정: 리턴즈","2018-07-23","39",720,3149333,41
"8345","탐정: 리턴즈","2018-07-24","44",880,3150213,42
"8346","탐정: 리턴즈","2018-07-25","9",243,3150456,43
"8347","탐정: 리턴즈","2018-07-26","7",275,3150731,44
"8348","탐정: 리턴즈","2018-07-27","7",178,3150909,45
"8349","탐정: 리턴즈","2018-07-28","5",128,3151037,46
"8350","탐정: 리턴즈","2018-07-29","6",159,3151196,47
"8351","탐정: 리턴즈","2018-07-30","7",226,3151422,48
"8352","탐정: 리턴즈","2018-07-31","8",396,3151818,49
"8353","탐정: 리턴즈","2018-08-01","5",150,3151968,50
"8354","탐정: 리턴즈","2018-08-02","5",150,3152118,51
"8355","탐정: 리턴즈","2018-08-03","5",150,3152268,52
"8356","탐정: 리턴즈","2018-08-04","5",150,3152418,53
"8357","탐정: 리턴즈","2018-08-05","5",150,3152568,54
"8358","탐정: 리턴즈","2018-08-06","4",120,3152688,55
"8359","탐정: 리턴즈","2018-08-07","5",180,3152868,56
"8360","탐정: 리턴즈","2018-08-31","1",2,3152870,57
"8361","탐정: 리턴즈","2018-09-04","1",2,3152872,58
"8362","너의 결혼식","2018-07-23","2",940,940,0
"8363","너의 결혼식","2018-08-02","13",2819,3759,0
"8364","너의 결혼식","2018-08-06","8",1328,5087,0
"8365","너의 결혼식","2018-08-07","18",4215,9302,0
"8366","너의 결혼식","2018-08-08","5",1750,11052,0
"8367","너의 결혼식","2018-08-09","10",2000,13052,0
"8368","너의 결혼식","2018-08-13","3",817,13869,0
"8369","너의 결혼식","2018-08-14","7",1744,15613,0
"8370","너의 결혼식","2018-08-16","12",3782,19395,0
"8371","너의 결혼식","2018-08-17","4",536,19931,0
"8372","너의 결혼식","2018-08-18","8",2279,22210,0
"8373","너의 결혼식","2018-08-19","9",2296,24506,0
"8374","너의 결혼식","2018-08-20","17",3244,27750,0
"8375","너의 결혼식","2018-08-21","21",3270,31020,0
"8376","너의 결혼식","2018-08-22","736",99411,130431,1
"8377","너의 결혼식","2018-08-23","778",76677,207108,2
"8378","너의 결혼식","2018-08-24","849",143132,350240,3
"8379","너의 결혼식","2018-08-25","950",280112,630352,4
"8380","너의 결혼식","2018-08-26","962",271250,901602,5
"8381","너의 결혼식","2018-08-27","897",104231,1005833,6
"8382","너의 결혼식","2018-08-28","904",106742,1112575,7
"8383","너의 결혼식","2018-08-29","849",169737,1282312,8
"8384","너의 결혼식","2018-08-30","854",98606,1380918,9
"8385","너의 결혼식","2018-08-31","900",130680,1511598,10
"8386","너의 결혼식","2018-09-01","970",216717,1728315,11
"8387","너의 결혼식","2018-09-02","966",221049,1949364,12
"8388","너의 결혼식","2018-09-03","867",70057,2019421,13
"8389","너의 결혼식","2018-09-04","865",62586,2082007,14
"8390","너의 결혼식","2018-09-05","866",67900,2149907,15
"8391","너의 결혼식","2018-09-06","792",51414,2201321,16
"8392","너의 결혼식","2018-09-07","814",66438,2267759,17
"8393","너의 결혼식","2018-09-08","906",132266,2400025,18
"8394","너의 결혼식","2018-09-09","898",122766,2522791,19
"8395","너의 결혼식","2018-09-10","804",32726,2555517,20
"8396","너의 결혼식","2018-09-11","819",29693,2585210,21
"8397","너의 결혼식","2018-09-12","511",22360,2607570,22
"8398","너의 결혼식","2018-09-13","542",20617,2628187,23
"8399","너의 결혼식","2018-09-14","568",28626,2656813,24
"8400","너의 결혼식","2018-09-15","618",62977,2719790,25
"8401","너의 결혼식","2018-09-16","610",53029,2772819,26
"8402","너의 결혼식","2018-09-17","573",17581,2790400,27
"8403","너의 결혼식","2018-09-18","587",16282,2806682,28
"8404","너의 결혼식","2018-09-19","68",904,2807586,29
"8405","너의 결혼식","2018-09-20","50",929,2808515,30
"8406","너의 결혼식","2018-09-21","44",1120,2809635,31
"8407","너의 결혼식","2018-09-22","39",1407,2811042,32
"8408","너의 결혼식","2018-09-23","37",1184,2812226,33
"8409","너의 결혼식","2018-09-24","37",1113,2813339,34
"8410","너의 결혼식","2018-09-25","40",1591,2814930,35
"8411","너의 결혼식","2018-09-26","37",1347,2816277,36
"8412","너의 결혼식","2018-09-27","51",826,2817103,37
"8413","너의 결혼식","2018-09-28","33",414,2817517,38
"8414","너의 결혼식","2018-09-29","27",683,2818200,39
"8415","너의 결혼식","2018-09-30","28",556,2818756,40
"8416","너의 결혼식","2018-10-01","27",239,2818995,41
"8417","너의 결혼식","2018-10-02","27",322,2819317,42
"8418","너의 결혼식","2018-10-03","10",156,2819473,43
"8419","너의 결혼식","2018-10-04","9",80,2819553,44
"8420","너의 결혼식","2018-10-05","8",83,2819636,45
"8421","너의 결혼식","2018-10-06","8",93,2819729,46
"8422","너의 결혼식","2018-10-07","8",77,2819806,47
"8423","너의 결혼식","2018-10-08","8",219,2820025,48
"8424","너의 결혼식","2018-10-09","7",83,2820108,49
"8425","너의 결혼식","2018-10-10","6",62,2820170,50
"8426","너의 결혼식","2018-10-11","5",50,2820220,51
"8427","너의 결혼식","2018-10-12","6",51,2820271,52
"8428","너의 결혼식","2018-10-13","7",160,2820431,53
"8429","너의 결혼식","2018-10-14","6",55,2820486,54
"8430","너의 결혼식","2018-10-15","6",52,2820538,55
"8431","너의 결혼식","2018-10-16","6",52,2820590,56
"8432","너의 결혼식","2018-10-17","6",53,2820643,57
"8433","너의 결혼식","2018-10-20","1",4,2820647,58
"8434","너의 결혼식","2018-10-21","1",6,2820653,59
"8435","너의 결혼식","2018-10-22","1",1,2820654,60
"8436","너의 결혼식","2018-10-23","1",2,2820656,61
"8437","너의 결혼식","2018-10-24","1",1,2820657,62
"8438","너의 결혼식","2018-10-27","1",1,2820658,63
"8439","너의 결혼식","2018-10-30","1",105,2820763,64
"8440","너의 결혼식","2018-10-31","1",106,2820869,65
"8441","너의 결혼식","2018-11-16","2",100,2820969,66
"8442","곤지암","2018-03-14","5",1111,1111,0
"8443","곤지암","2018-03-15","4",907,2018,0
"8444","곤지암","2018-03-16","15",2716,4734,0
"8445","곤지암","2018-03-17","10",1726,6460,0
"8446","곤지암","2018-03-18","1",100,6560,0
"8447","곤지암","2018-03-19","5",1346,7906,0
"8448","곤지암","2018-03-20","10",2259,10165,0
"8449","곤지암","2018-03-21","5",1178,11343,0
"8450","곤지암","2018-03-22","9",1806,13149,0
"8451","곤지암","2018-03-23","9",1438,14587,0
"8452","곤지암","2018-03-24","152",24301,38888,0
"8453","곤지암","2018-03-25","153",29041,67929,0
"8454","곤지암","2018-03-26","1",154,68083,0
"8455","곤지암","2018-03-28","808",198365,266448,1
"8456","곤지암","2018-03-29","849",117945,384393,2
"8457","곤지암","2018-03-30","954",185811,570204,3
"8458","곤지암","2018-03-31","1,075",423340,993544,4
"8459","곤지암","2018-04-01","1,124",373836,1367380,5
"8460","곤지암","2018-04-02","927",109505,1476885,6
"8461","곤지암","2018-04-03","977",87577,1564462,7
"8462","곤지암","2018-04-04","989",92046,1656508,8
"8463","곤지암","2018-04-05","896",78273,1734781,9
"8464","곤지암","2018-04-06","922",111319,1846100,10
"8465","곤지암","2018-04-07","950",226594,2072694,11
"8466","곤지암","2018-04-08","947",175711,2248405,12
"8467","곤지암","2018-04-09","843",47017,2295422,13
"8468","곤지암","2018-04-10","845",40526,2335948,14
"8469","곤지암","2018-04-11","844",40888,2376836,15
"8470","곤지암","2018-04-12","543",24288,2401124,16
"8471","곤지암","2018-04-13","552",37043,2438167,17
"8472","곤지암","2018-04-14","608",76299,2514466,18
"8473","곤지암","2018-04-15","586",52792,2567258,19
"8474","곤지암","2018-04-16","498",13543,2580801,20
"8475","곤지암","2018-04-17","491",11893,2592694,21
"8476","곤지암","2018-04-18","499",11576,2604270,22
"8477","곤지암","2018-04-19","374",8387,2612657,23
"8478","곤지암","2018-04-20","392",10770,2623427,24
"8479","곤지암","2018-04-21","427",21697,2645124,25
"8480","곤지암","2018-04-22","416",17253,2662377,26
"8481","곤지암","2018-04-23","361",5227,2667604,27
"8482","곤지암","2018-04-24","347",4645,2672249,28
"8483","곤지암","2018-04-25","25",225,2672474,29
"8484","곤지암","2018-04-26","21",284,2672758,30
"8485","곤지암","2018-04-27","24",559,2673317,31
"8486","곤지암","2018-04-28","17",435,2673752,32
"8487","곤지암","2018-04-29","13",406,2674158,33
"8488","곤지암","2018-04-30","16",334,2674492,34
"8489","곤지암","2018-05-01","7",291,2674783,35
"8490","곤지암","2018-05-02","8",85,2674868,36
"8491","곤지암","2018-05-03","4",35,2674903,37
"8492","곤지암","2018-05-04","5",42,2674945,38
"8493","곤지암","2018-05-05","7",165,2675110,39
"8494","곤지암","2018-05-06","8",214,2675324,40
"8495","곤지암","2018-05-07","6",86,2675410,41
"8496","곤지암","2018-05-08","5",36,2675446,42
"8497","곤지암","2018-05-09","2",7,2675453,43
"8498","곤지암","2018-05-10","1",9,2675462,44
"8499","곤지암","2018-05-11","1",7,2675469,45
"8500","곤지암","2018-05-12","1",20,2675489,46
"8501","곤지암","2018-05-13","1",21,2675510,47
"8502","곤지암","2018-05-14","1",3,2675513,48
"8503","곤지암","2018-05-15","1",13,2675526,49
"8504","곤지암","2018-05-16","1",2,2675528,50
"8505","곤지암","2018-05-17","1",1,2675529,51
"8506","곤지암","2018-05-19","1",11,2675540,52
"8507","곤지암","2018-05-20","1",4,2675544,53
"8508","곤지암","2018-05-22","1",2,2675546,54
"8509","곤지암","2018-05-25","1",2,2675548,55
"8510","곤지암","2018-05-26","1",6,2675554,56
"8511","곤지암","2018-05-27","1",4,2675558,57
"8512","곤지암","2018-05-30","1",1,2675559,58
"8513","곤지암","2018-07-05","1",0,2675559,59
"8514","곤지암","2018-08-30","1",1,2675560,60
"8515","곤지암","2018-09-01","1",2,2675562,61
"8516","곤지암","2018-09-02","1",2,2675564,62
"8517","곤지암","2018-09-03","1",5,2675569,63
"8518","곤지암","2018-09-05","1",1,2675570,64
"8519","곤지암","2018-09-07","1",2,2675572,65
"8520","곤지암","2018-09-08","1",3,2675575,66
"8521","곤지암","2018-11-16","1",0,2675575,67
"8522","지금 만나러 갑니다","2018-03-01","1",91,91,0
"8523","지금 만나러 갑니다","2018-03-02","1",66,157,0
"8524","지금 만나러 갑니다","2018-03-05","1",401,558,0
"8525","지금 만나러 갑니다","2018-03-06","31",5945,6503,0
"8526","지금 만나러 갑니다","2018-03-07","9",1976,8479,0
"8527","지금 만나러 갑니다","2018-03-08","18",3166,11645,0
"8528","지금 만나러 갑니다","2018-03-09","8",2102,13747,0
"8529","지금 만나러 갑니다","2018-03-12","20",4793,18540,0
"8530","지금 만나러 갑니다","2018-03-13","35",4040,22580,0
"8531","지금 만나러 갑니다","2018-03-14","990",89772,112352,1
"8532","지금 만나러 갑니다","2018-03-15","1,020",85399,197751,2
"8533","지금 만나러 갑니다","2018-03-16","1,051",125650,323401,3
"8534","지금 만나러 갑니다","2018-03-17","1,163",285322,608723,4
"8535","지금 만나러 갑니다","2018-03-18","1,163",272180,880903,5
"8536","지금 만나러 갑니다","2018-03-19","1,087",99894,980797,6
"8537","지금 만나러 갑니다","2018-03-20","1,092",94239,1075036,7
"8538","지금 만나러 갑니다","2018-03-21","1,003",88210,1163246,8
"8539","지금 만나러 갑니다","2018-03-22","961",83417,1246663,9
"8540","지금 만나러 갑니다","2018-03-23","1,035",114375,1361038,10
"8541","지금 만나러 갑니다","2018-03-24","1,191",247062,1608100,11
"8542","지금 만나러 갑니다","2018-03-25","1,164",215646,1823746,12
"8543","지금 만나러 갑니다","2018-03-26","1,047",64727,1888473,13
"8544","지금 만나러 갑니다","2018-03-27","1,072",63258,1951731,14
"8545","지금 만나러 갑니다","2018-03-28","701",76162,2027893,15
"8546","지금 만나러 갑니다","2018-03-29","677",40017,2067910,16
"8547","지금 만나러 갑니다","2018-03-30","708",54151,2122061,17
"8548","지금 만나러 갑니다","2018-03-31","736",108358,2230419,18
"8549","지금 만나러 갑니다","2018-04-01","735",90812,2321231,19
"8550","지금 만나러 갑니다","2018-04-02","654",28444,2349675,20
"8551","지금 만나러 갑니다","2018-04-03","681",25784,2375459,21
"8552","지금 만나러 갑니다","2018-04-04","665",28134,2403593,22
"8553","지금 만나러 갑니다","2018-04-05","507",19801,2423394,23
"8554","지금 만나러 갑니다","2018-04-06","528",25202,2448596,24
"8555","지금 만나러 갑니다","2018-04-07","530",42484,2491080,25
"8556","지금 만나러 갑니다","2018-04-08","521",34655,2525735,26
"8557","지금 만나러 갑니다","2018-04-09","484",11969,2537704,27
"8558","지금 만나러 갑니다","2018-04-10","495",11241,2548945,28
"8559","지금 만나러 갑니다","2018-04-11","479",11675,2560620,29
"8560","지금 만나러 갑니다","2018-04-12","222",4104,2564724,30
"8561","지금 만나러 갑니다","2018-04-13","219",5468,2570192,31
"8562","지금 만나러 갑니다","2018-04-14","203",9325,2579517,32
"8563","지금 만나러 갑니다","2018-04-15","198",6923,2586440,33
"8564","지금 만나러 갑니다","2018-04-16","202",3022,2589462,34
"8565","지금 만나러 갑니다","2018-04-17","201",2496,2591958,35
"8566","지금 만나러 갑니다","2018-04-18","204",2559,2594517,36
"8567","지금 만나러 갑니다","2018-04-19","51",738,2595255,37
"8568","지금 만나러 갑니다","2018-04-20","55",1251,2596506,38
"8569","지금 만나러 갑니다","2018-04-21","48",1268,2597774,39
"8570","지금 만나러 갑니다","2018-04-22","49",1326,2599100,40
"8571","지금 만나러 갑니다","2018-04-23","57",527,2599627,41
"8572","지금 만나러 갑니다","2018-04-24","52",634,2600261,42
"8573","지금 만나러 갑니다","2018-04-25","2",22,2600283,43
"8574","지금 만나러 갑니다","2018-04-26","1",23,2600306,44
"8575","지금 만나러 갑니다","2018-04-27","1",39,2600345,45
"8576","지금 만나러 갑니다","2018-04-28","1",37,2600382,46
"8577","지금 만나러 갑니다","2018-04-29","1",35,2600417,47
"8578","지금 만나러 갑니다","2018-04-30","1",57,2600474,48
"8579","지금 만나러 갑니다","2018-05-01","1",53,2600527,49
"8580","지금 만나러 갑니다","2018-05-02","1",14,2600541,50
"8581","지금 만나러 갑니다","2018-05-03","1",28,2600569,51
"8582","지금 만나러 갑니다","2018-05-04","2",218,2600787,52
"8583","지금 만나러 갑니다","2018-05-05","2",59,2600846,53
"8584","지금 만나러 갑니다","2018-05-06","2",39,2600885,54
"8585","지금 만나러 갑니다","2018-05-07","1",44,2600929,55
"8586","지금 만나러 갑니다","2018-05-08","1",9,2600938,56
"8587","지금 만나러 갑니다","2018-05-09","1",4,2600942,57
"8588","지금 만나러 갑니다","2018-05-10","1",11,2600953,58
"8589","지금 만나러 갑니다","2018-05-11","1",13,2600966,59
"8590","지금 만나러 갑니다","2018-05-12","3",36,2601002,60
"8591","지금 만나러 갑니다","2018-05-13","2",17,2601019,61
"8592","지금 만나러 갑니다","2018-05-14","1",8,2601027,62
"8593","지금 만나러 갑니다","2018-05-15","1",9,2601036,63
"8594","지금 만나러 갑니다","2018-05-16","2",0,2601036,64
"8595","지금 만나러 갑니다","2018-05-19","2",17,2601053,65
"8596","지금 만나러 갑니다","2018-05-20","1",16,2601069,66
"8597","지금 만나러 갑니다","2018-05-21","1",10,2601079,67
"8598","지금 만나러 갑니다","2018-05-31","1",220,2601299,68
"8599","지금 만나러 갑니다","2018-06-05","1",119,2601418,69
"8600","지금 만나러 갑니다","2018-06-06","1",27,2601445,70
"8601","지금 만나러 갑니다","2018-06-11","1",60,2601505,71
"8602","지금 만나러 갑니다","2018-06-14","1",24,2601529,72
"8603","지금 만나러 갑니다","2018-07-04","1",0,2601529,73
"8604","지금 만나러 갑니다","2018-07-06","1",0,2601529,74
"8605","지금 만나러 갑니다","2018-07-14","15",168,2601697,75
"8606","지금 만나러 갑니다","2018-07-15","15",160,2601857,76
"8607","지금 만나러 갑니다","2018-07-16","15",86,2601943,77
"8608","지금 만나러 갑니다","2018-07-17","16",66,2602009,78
"8609","지금 만나러 갑니다","2018-07-18","12",40,2602049,79
"8610","지금 만나러 갑니다","2018-07-19","11",63,2602112,80
"8611","지금 만나러 갑니다","2018-07-20","6",40,2602152,81
"8612","지금 만나러 갑니다","2018-07-21","5",20,2602172,82
"8613","지금 만나러 갑니다","2018-07-22","5",37,2602209,83
"8614","지금 만나러 갑니다","2018-07-23","2",8,2602217,84
"8615","지금 만나러 갑니다","2018-07-24","5",56,2602273,85
"8616","목격자","2018-07-18","1",247,247,0
"8617","목격자","2018-08-06","11",2568,2815,0
"8618","목격자","2018-08-07","30",6485,9300,0
"8619","목격자","2018-08-08","37",8150,17450,0
"8620","목격자","2018-08-09","18",3616,21066,0
"8621","목격자","2018-08-14","24",3014,24080,0
"8622","목격자","2018-08-15","808",368981,393061,1
"8623","목격자","2018-08-16","808",161783,554844,2
"8624","목격자","2018-08-17","868",177251,732095,3
"8625","목격자","2018-08-18","1,005",334388,1066483,4
"8626","목격자","2018-08-19","1,021",298946,1365429,5
"8627","목격자","2018-08-20","971",128512,1493941,6
"8628","목격자","2018-08-21","938",109251,1603192,7
"8629","목격자","2018-08-22","840",93526,1696718,8
"8630","목격자","2018-08-23","806",67553,1764271,9
"8631","목격자","2018-08-24","842",96627,1860898,10
"8632","목격자","2018-08-25","845",181657,2042555,11
"8633","목격자","2018-08-26","819",154660,2197215,12
"8634","목격자","2018-08-27","778",44786,2242001,13
"8635","목격자","2018-08-28","779",41972,2283973,14
"8636","목격자","2018-08-29","605",43373,2327346,15
"8637","목격자","2018-08-30","552",24199,2351545,16
"8638","목격자","2018-08-31","561",27981,2379526,17
"8639","목격자","2018-09-01","571",36502,2416028,18
"8640","목격자","2018-09-02","567",37610,2453638,19
"8641","목격자","2018-09-03","515",11575,2465213,20
"8642","목격자","2018-09-04","515",9560,2474773,21
"8643","목격자","2018-09-05","495",8710,2483483,22
"8644","목격자","2018-09-06","371",5290,2488773,23
"8645","목격자","2018-09-07","384",5883,2494656,24
"8646","목격자","2018-09-08","375",9233,2503889,25
"8647","목격자","2018-09-09","361",8270,2512159,26
"8648","목격자","2018-09-10","311",3648,2515807,27
"8649","목격자","2018-09-11","333",3709,2519516,28
"8650","목격자","2018-09-12","59",1329,2520845,29
"8651","목격자","2018-09-13","54",255,2521100,30
"8652","목격자","2018-09-14","62",327,2521427,31
"8653","목격자","2018-09-15","64",654,2522081,32
"8654","목격자","2018-09-16","63",648,2522729,33
"8655","목격자","2018-09-17","57",293,2523022,34
"8656","목격자","2018-09-18","60",748,2523770,35
"8657","목격자","2018-09-19","3",59,2523829,36
"8658","목격자","2018-09-20","13",420,2524249,37
"8659","목격자","2018-09-21","4",84,2524333,38
"8660","목격자","2018-10-30","1",129,2524462,39
"8661","목격자","2018-10-31","1",129,2524591,40
"8662","목격자","2018-11-01","1",129,2524720,41
"8663","조선명탐정: 흡혈괴마의 비밀","2018-01-29","20",4906,4906,0
"8664","조선명탐정: 흡혈괴마의 비밀","2018-01-30","72",11673,16579,0
"8665","조선명탐정: 흡혈괴마의 비밀","2018-01-31","12",3214,19793,0
"8666","조선명탐정: 흡혈괴마의 비밀","2018-02-01","34",5787,25580,0
"8667","조선명탐정: 흡혈괴마의 비밀","2018-02-02","5",1100,26680,0
"8668","조선명탐정: 흡혈괴마의 비밀","2018-02-03","11",2263,28943,0
"8669","조선명탐정: 흡혈괴마의 비밀","2018-02-04","7",1466,30409,0
"8670","조선명탐정: 흡혈괴마의 비밀","2018-02-05","10",1814,32223,0
"8671","조선명탐정: 흡혈괴마의 비밀","2018-02-06","27",3283,35506,0
"8672","조선명탐정: 흡혈괴마의 비밀","2018-02-07","1",140,35646,0
"8673","조선명탐정: 흡혈괴마의 비밀","2018-02-08","1,140",142796,178442,1
"8674","조선명탐정: 흡혈괴마의 비밀","2018-02-09","1,183",155170,333612,2
"8675","조선명탐정: 흡혈괴마의 비밀","2018-02-10","1,249",327600,661212,3
"8676","조선명탐정: 흡혈괴마의 비밀","2018-02-11","1,236",304233,965445,4
"8677","조선명탐정: 흡혈괴마의 비밀","2018-02-12","1,165",91433,1056878,5
"8678","조선명탐정: 흡혈괴마의 비밀","2018-02-13","1,161",89617,1146495,6
"8679","조선명탐정: 흡혈괴마의 비밀","2018-02-14","618",72063,1218558,7
"8680","조선명탐정: 흡혈괴마의 비밀","2018-02-15","691",143710,1362268,8
"8681","조선명탐정: 흡혈괴마의 비밀","2018-02-16","848",231673,1593941,9
"8682","조선명탐정: 흡혈괴마의 비밀","2018-02-17","1,027",280825,1874766,10
"8683","조선명탐정: 흡혈괴마의 비밀","2018-02-18","1,014",201234,2076000,11
"8684","조선명탐정: 흡혈괴마의 비밀","2018-02-19","710",56507,2132507,12
"8685","조선명탐정: 흡혈괴마의 비밀","2018-02-20","726",40315,2172822,13
"8686","조선명탐정: 흡혈괴마의 비밀","2018-02-21","719",36522,2209344,14
"8687","조선명탐정: 흡혈괴마의 비밀","2018-02-22","645",30547,2239891,15
"8688","조선명탐정: 흡혈괴마의 비밀","2018-02-23","636",32121,2272012,16
"8689","조선명탐정: 흡혈괴마의 비밀","2018-02-24","634",61788,2333800,17
"8690","조선명탐정: 흡혈괴마의 비밀","2018-02-25","624",52916,2386716,18
"8691","조선명탐정: 흡혈괴마의 비밀","2018-02-26","559",20042,2406758,19
"8692","조선명탐정: 흡혈괴마의 비밀","2018-02-27","573",20566,2427324,20
"8693","조선명탐정: 흡혈괴마의 비밀","2018-02-28","158",3707,2431031,21
"8694","조선명탐정: 흡혈괴마의 비밀","2018-03-01","142",5047,2436078,22
"8695","조선명탐정: 흡혈괴마의 비밀","2018-03-02","129",1005,2437083,23
"8696","조선명탐정: 흡혈괴마의 비밀","2018-03-03","127",2140,2439223,24
"8697","조선명탐정: 흡혈괴마의 비밀","2018-03-04","117",1836,2441059,25
"8698","조선명탐정: 흡혈괴마의 비밀","2018-03-05","95",620,2441679,26
"8699","조선명탐정: 흡혈괴마의 비밀","2018-03-06","88",456,2442135,27
"8700","조선명탐정: 흡혈괴마의 비밀","2018-03-07","37",882,2443017,28
"8701","조선명탐정: 흡혈괴마의 비밀","2018-03-08","4",21,2443038,29
"8702","조선명탐정: 흡혈괴마의 비밀","2018-03-09","4",23,2443061,30
"8703","조선명탐정: 흡혈괴마의 비밀","2018-03-10","6",175,2443236,31
"8704","조선명탐정: 흡혈괴마의 비밀","2018-03-11","8",46,2443282,32
"8705","조선명탐정: 흡혈괴마의 비밀","2018-03-12","7",20,2443302,33
"8706","조선명탐정: 흡혈괴마의 비밀","2018-03-13","6",23,2443325,34
"8707","조선명탐정: 흡혈괴마의 비밀","2018-03-15","7",74,2443399,35
"8708","조선명탐정: 흡혈괴마의 비밀","2018-03-16","5",74,2443473,36
"8709","조선명탐정: 흡혈괴마의 비밀","2018-03-17","6",88,2443561,37
"8710","조선명탐정: 흡혈괴마의 비밀","2018-03-18","5",76,2443637,38
"8711","조선명탐정: 흡혈괴마의 비밀","2018-03-19","7",79,2443716,39
"8712","조선명탐정: 흡혈괴마의 비밀","2018-03-20","6",85,2443801,40
"8713","조선명탐정: 흡혈괴마의 비밀","2018-03-21","6",92,2443893,41
"8714","조선명탐정: 흡혈괴마의 비밀","2018-03-22","5",74,2443967,42
"8715","조선명탐정: 흡혈괴마의 비밀","2018-03-23","5",74,2444041,43
"8716","조선명탐정: 흡혈괴마의 비밀","2018-03-24","6",76,2444117,44
"8717","조선명탐정: 흡혈괴마의 비밀","2018-03-25","1",2,2444119,45
"8718","조선명탐정: 흡혈괴마의 비밀","2018-03-27","1",2,2444121,46
"8719","조선명탐정: 흡혈괴마의 비밀","2018-03-29","1",2,2444123,47
"8720","조선명탐정: 흡혈괴마의 비밀","2018-05-16","2",0,2444123,48
"8721","조선명탐정: 흡혈괴마의 비밀","2018-08-30","1",6,2444129,49
"8722","조선명탐정: 흡혈괴마의 비밀","2018-09-03","1",7,2444136,50
"8723","명당","2018-09-11","7",2426,2426,0
"8724","명당","2018-09-12","12",2578,5004,0
"8725","명당","2018-09-13","13",2405,7409,0
"8726","명당","2018-09-14","1",190,7599,0
"8727","명당","2018-09-17","6",1409,9008,0
"8728","명당","2018-09-18","21",2091,11099,0
"8729","명당","2018-09-19","1,069",108903,120002,1
"8730","명당","2018-09-20","1,046",90103,210105,2
"8731","명당","2018-09-21","1,043",114575,324680,3
"8732","명당","2018-09-22","1,117",207426,532106,4
"8733","명당","2018-09-23","1,079",227736,759842,5
"8734","명당","2018-09-24","1,017",322392,1082234,6
"8735","명당","2018-09-25","1,039",342088,1424322,7
"8736","명당","2018-09-26","942",251468,1675790,8
"8737","명당","2018-09-27","884",54855,1730645,9
"8738","명당","2018-09-28","872",54931,1785576,10
"8739","명당","2018-09-29","859",99125,1884701,11
"8740","명당","2018-09-30","831",86503,1971204,12
"8741","명당","2018-10-01","785",26642,1997846,13
"8742","명당","2018-10-02","793",29531,2027377,14
"8743","명당","2018-10-03","347",14080,2041457,15
"8744","명당","2018-10-04","346",5041,2046498,16
"8745","명당","2018-10-05","339",6965,2053463,17
"8746","명당","2018-10-06","266",7721,2061184,18
"8747","명당","2018-10-07","237",5281,2066465,19
"8748","명당","2018-10-08","258",4879,2071344,20
"8749","명당","2018-10-09","81",1899,2073243,21
"8750","명당","2018-10-10","91",870,2074113,22
"8751","명당","2018-10-11","42",1190,2075303,23
"8752","명당","2018-10-12","36",1291,2076594,24
"8753","명당","2018-10-13","38",1338,2077932,25
"8754","명당","2018-10-14","37",1306,2079238,26
"8755","명당","2018-10-15","34",241,2079479,27
"8756","명당","2018-10-16","41",889,2080368,28
"8757","명당","2018-10-17","41",1092,2081460,29
"8758","명당","2018-10-18","13",932,2082392,30
"8759","명당","2018-10-19","7",430,2082822,31
"8760","명당","2018-10-20","6",136,2082958,32
"8761","명당","2018-10-21","2",48,2083006,33
"8762","명당","2018-10-22","5",275,2083281,34
"8763","명당","2018-10-23","9",398,2083679,35
"8764","명당","2018-10-24","4",31,2083710,36
"8765","명당","2018-10-25","9",306,2084016,37
"8766","명당","2018-10-26","4",257,2084273,38
"8767","명당","2018-10-27","1",21,2084294,39
"8768","명당","2018-10-28","1",25,2084319,40
"8769","명당","2018-10-29","6",644,2084963,41
"8770","명당","2018-10-30","12",900,2085863,42
"8771","명당","2018-10-31","4",474,2086337,43
"8772","명당","2018-11-01","3",283,2086620,44
"8773","명당","2018-11-02","2",104,2086724,45
"8774","명당","2018-11-03","1",11,2086735,46
"8775","명당","2018-11-04","1",11,2086746,47
"8776","명당","2018-11-05","1",3,2086749,48
"8777","명당","2018-11-06","1",2,2086751,49
"8778","명당","2018-11-07","1",5,2086756,50
"8779","명당","2018-11-08","2",246,2087002,51
"8780","명당","2018-11-15","2",308,2087310,52
"8781","명당","2018-11-21","1",130,2087440,53
"8782","명당","2018-11-26","1",34,2087474,54
"8783","명당","2018-11-30","1",0,2087474,55
"8784","협상","2018-09-04","1",406,406,0
"8785","협상","2018-09-10","17",4646,5052,0
"8786","협상","2018-09-13","23",4971,10023,0
"8787","협상","2018-09-14","6",1461,11484,0
"8788","협상","2018-09-17","27",5492,16976,0
"8789","협상","2018-09-18","50",7601,24577,0
"8790","협상","2018-09-19","898",81031,105608,1
"8791","협상","2018-09-20","883",67737,173345,2
"8792","협상","2018-09-21","868",99740,273085,3
"8793","협상","2018-09-22","869",172357,445442,4
"8794","협상","2018-09-23","872",173105,618547,5
"8795","협상","2018-09-24","896",228598,847145,6
"8796","협상","2018-09-25","919",257940,1105085,7
"8797","협상","2018-09-26","838",207661,1312746,8
"8798","협상","2018-09-27","776",62393,1375139,9
"8799","협상","2018-09-28","798",72975,1448114,10
"8800","협상","2018-09-29","904",151512,1599626,11
"8801","협상","2018-09-30","913",144316,1743942,12
"8802","협상","2018-10-01","834",49057,1792999,13
"8803","협상","2018-10-02","867",55116,1848115,14
"8804","협상","2018-10-03","510",32802,1880917,15
"8805","협상","2018-10-04","481",8805,1889722,16
"8806","협상","2018-10-05","478",11922,1901644,17
"8807","협상","2018-10-06","413",16894,1918538,18
"8808","협상","2018-10-07","393",13396,1931934,19
"8809","협상","2018-10-08","401",8695,1940629,20
"8810","협상","2018-10-09","208",5312,1945941,21
"8811","협상","2018-10-10","217",2944,1948885,22
"8812","협상","2018-10-11","97",1031,1949916,23
"8813","협상","2018-10-12","98",1165,1951081,24
"8814","협상","2018-10-13","91",1189,1952270,25
"8815","협상","2018-10-14","81",1003,1953273,26
"8816","협상","2018-10-15","95",2648,1955921,27
"8817","협상","2018-10-16","95",2441,1958362,28
"8818","협상","2018-10-17","81",624,1958986,29
"8819","협상","2018-10-18","25",2425,1961411,30
"8820","협상","2018-10-19","25",2726,1964137,31
"8821","협상","2018-10-20","4",34,1964171,32
"8822","협상","2018-10-21","3",14,1964185,33
"8823","협상","2018-10-22","9",238,1964423,34
"8824","협상","2018-10-23","8",118,1964541,35
"8825","협상","2018-10-24","9",125,1964666,36
"8826","협상","2018-10-25","5",96,1964762,37
"8827","협상","2018-10-26","5",100,1964862,38
"8828","협상","2018-10-27","5",100,1964962,39
"8829","협상","2018-10-28","5",100,1965062,40
"8830","협상","2018-10-29","8",506,1965568,41
"8831","협상","2018-10-30","8",486,1966054,42
"8832","협상","2018-10-31","3",418,1966472,43
"8833","협상","2018-11-01","6",584,1967056,44
"8834","협상","2018-11-02","4",210,1967266,45
"8835","협상","2018-11-03","4",300,1967566,46
"8836","협상","2018-11-04","3",155,1967721,47
"8837","마약왕","2018-12-11","1",8,8,0
"8838","마약왕","2018-12-14","33",7189,7197,0
"8839","마약왕","2018-12-17","19",4166,11363,0
"8840","마약왕","2018-12-18","33",7596,18959,0
"8841","마약왕","2018-12-19","1,254",250106,269065,1
"8842","마약왕","2018-12-20","1,297",185432,454497,2
"8843","마약왕","2018-12-21","1,286",182926,637423,3
"8844","마약왕","2018-12-22","1,215",301170,938593,4
"8845","마약왕","2018-12-23","1,141",271586,1210179,5
"8846","마약왕","2018-12-24","1,075",191134,1401313,6
"8847","마약왕","2018-12-25","833",209240,1610553,7
"8848","마약왕","2018-12-26","679",51991,1662544,8
"8849","마약왕","2018-12-27","654",31836,1694380,9
"8850","마약왕","2018-12-28","622",27567,1721947,10
"8851","마약왕","2018-12-29","560",32904,1754851,11
"8852","마약왕","2018-12-30","539",32974,1787825,12
"8853","마약왕","2018-12-31","533",25769,1813594,13
"8854","마약왕","2019-01-01","426",19248,1832842,14
"8855","마약왕","2019-01-02","403",6794,1839636,15
"8856","마약왕","2019-01-03","327",4109,1843745,16
"8857","마약왕","2019-01-04","299",3904,1847649,17
"8858","마약왕","2019-01-05","266",5654,1853303,18
"8859","마약왕","2019-01-06","243",4253,1857556,19
"8860","마약왕","2019-01-07","240",2373,1859929,20
"8861","마약왕","2019-01-08","242",2254,1862183,21
"8862","마약왕","2019-01-09","11",160,1862343,22
"8863","마약왕","2019-01-10","12",168,1862511,23
"8864","마약왕","2019-01-11","10",123,1862634,24
"8865","마약왕","2019-01-12","10",443,1863077,25
"8866","마약왕","2019-01-13","9",206,1863283,26
"8867","마약왕","2019-01-14","8",80,1863363,27
"8868","마약왕","2019-01-15","10",108,1863471,28
"8869","마약왕","2019-01-16","5",41,1863512,29
"8870","마약왕","2019-01-17","2",29,1863541,30
"8871","마약왕","2019-01-18","2",20,1863561,31
"8872","마약왕","2019-01-19","3",34,1863595,32
"8873","마약왕","2019-01-20","2",56,1863651,33
"8874","마약왕","2019-01-21","2",15,1863666,34
"8875","마약왕","2019-01-22","2",25,1863691,35
"8876","마약왕","2019-01-23","1",9,1863700,36
"8877","마약왕","2019-01-24","1",8,1863708,37
"8878","마약왕","2019-01-25","1",1,1863709,38
"8879","마약왕","2019-01-27","1",1,1863710,39
"8880","마약왕","2019-01-28","1",2,1863712,40
"8881","마약왕","2019-01-29","2",2,1863714,41
"8882","마약왕","2019-01-30","2",3,1863717,42
"8883","마약왕","2019-02-14","1",359,1864076,43
"8884","창궐","2018-10-10","1",383,383,0
"8885","창궐","2018-10-17","4",1205,1588,0
"8886","창궐","2018-10-18","11",3255,4843,0
"8887","창궐","2018-10-19","12",2012,6855,0
"8888","창궐","2018-10-22","20",1749,8604,0
"8889","창궐","2018-10-23","2",361,8965,0
"8890","창궐","2018-10-24","11",2405,11370,0
"8891","창궐","2018-10-25","1,283",156629,167999,1
"8892","창궐","2018-10-26","1,304",204987,372986,2
"8893","창궐","2018-10-27","1,351",340570,713556,3
"8894","창궐","2018-10-28","1,309",295422,1008978,4
"8895","창궐","2018-10-29","1,330",128950,1137928,5
"8896","창궐","2018-10-30","1,239",82772,1220700,6
"8897","창궐","2018-10-31","802",93528,1314228,7
"8898","창궐","2018-11-01","706",34487,1348715,8
"8899","창궐","2018-11-02","711",41687,1390402,9
"8900","창궐","2018-11-03","679",74884,1465286,10
"8901","창궐","2018-11-04","650",58422,1523708,11
"8902","창궐","2018-11-05","586",15360,1539068,12
"8903","창궐","2018-11-06","580",14008,1553076,13
"8904","창궐","2018-11-07","465",7908,1560984,14
"8905","창궐","2018-11-08","413",5711,1566695,15
"8906","창궐","2018-11-09","404",6034,1572729,16
"8907","창궐","2018-11-10","356",8324,1581053,17
"8908","창궐","2018-11-11","342",7390,1588443,18
"8909","창궐","2018-11-12","297",2413,1590856,19
"8910","창궐","2018-11-13","301",4255,1595111,20
"8911","창궐","2018-11-14","21",622,1595733,21
"8912","창궐","2018-11-15","8",153,1595886,22
"8913","창궐","2018-11-16","7",255,1596141,23
"8914","창궐","2018-11-17","4",74,1596215,24
"8915","창궐","2018-11-18","3",70,1596285,25
"8916","창궐","2018-11-19","6",317,1596602,26
"8917","창궐","2018-11-20","22",875,1597477,27
"8918","창궐","2018-11-21","7",30,1597507,28
"8919","창궐","2018-11-22","19",812,1598319,29
"8920","창궐","2018-11-23","8",438,1598757,30
"8921","창궐","2018-11-24","4",22,1598779,31
"8922","창궐","2018-11-25","4",23,1598802,32
"8923","창궐","2018-11-26","4",6,1598808,33
"8924","창궐","2018-11-27","8",123,1598931,34
"8925","창궐","2018-11-28","6",84,1599015,35
"8926","창궐","2018-11-29","5",68,1599083,36
"8927","창궐","2018-11-30","3",10,1599093,37
"8928","창궐","2018-12-01","3",6,1599099,38
"8929","창궐","2018-12-02","3",11,1599110,39
"8930","창궐","2018-12-03","2",2,1599112,40
"8931","창궐","2018-12-05","1",5,1599117,41
"8932","창궐","2018-12-07","2",173,1599290,42
"8933","창궐","2019-01-18","2",308,1599598,43
"8934","성난황소","2018-11-08","17",4830,4830,0
"8935","성난황소","2018-11-09","11",2258,7088,0
"8936","성난황소","2018-11-10","3",345,7433,0
"8937","성난황소","2018-11-11","1",86,7519,0
"8938","성난황소","2018-11-12","19",3901,11420,0
"8939","성난황소","2018-11-13","28",5137,16557,0
"8940","성난황소","2018-11-14","14",2524,19081,0
"8941","성난황소","2018-11-15","14",2322,21403,0
"8942","성난황소","2018-11-16","21",2879,24282,0
"8943","성난황소","2018-11-17","310",24098,48380,0
"8944","성난황소","2018-11-18","311",30226,78606,0
"8945","성난황소","2018-11-19","4",764,79370,0
"8946","성난황소","2018-11-20","18",3833,83203,0
"8947","성난황소","2018-11-21","5",1345,84548,0
"8948","성난황소","2018-11-22","978",135764,220312,1
"8949","성난황소","2018-11-23","987",151350,371662,2
"8950","성난황소","2018-11-24","1,006",282197,653859,3
"8951","성난황소","2018-11-25","1,010",267159,921018,4
"8952","성난황소","2018-11-26","972",96214,1017232,5
"8953","성난황소","2018-11-27","992",82845,1100077,6
"8954","성난황소","2018-11-28","695",83461,1183538,7
"8955","성난황소","2018-11-29","673",43961,1227499,8
"8956","성난황소","2018-11-30","669",54861,1282360,9
"8957","성난황소","2018-12-01","635",87084,1369444,10
"8958","성난황소","2018-12-02","633",82221,1451665,11
"8959","성난황소","2018-12-03","605",31745,1483410,12
"8960","성난황소","2018-12-04","617",28533,1511943,13
"8961","성난황소","2018-12-05","405",10630,1522573,14
"8962","성난황소","2018-12-06","362",8656,1531229,15
"8963","성난황소","2018-12-07","351",8858,1540087,16
"8964","성난황소","2018-12-08","317",13790,1553877,17
"8965","성난황소","2018-12-09","309",13387,1567264,18
"8966","성난황소","2018-12-10","312",5194,1572458,19
"8967","성난황소","2018-12-11","309",5279,1577737,20
"8968","성난황소","2018-12-12","125",2965,1580702,21
"8969","성난황소","2018-12-13","106",3079,1583781,22
"8970","성난황소","2018-12-14","98",2125,1585906,23
"8971","성난황소","2018-12-15","79",2399,1588305,24
"8972","성난황소","2018-12-16","76",2286,1590591,25
"8973","성난황소","2018-12-17","90",1628,1592219,26
"8974","성난황소","2018-12-18","88",951,1593170,27
"8975","성난황소","2018-12-19","1",3,1593173,28
"8976","성난황소","2018-12-20","1",7,1593180,29
"8977","성난황소","2018-12-21","3",56,1593236,30
"8978","성난황소","2018-12-22","2",25,1593261,31
"8979","성난황소","2018-12-23","2",61,1593322,32
"8980","성난황소","2018-12-24","1",4,1593326,33
"8981","성난황소","2018-12-25","1",12,1593338,34
"8982","성난황소","2018-12-26","2",48,1593386,35
"8983","도어락","2018-11-11","2",1126,1126,0
"8984","도어락","2018-11-22","1",284,1410,0
"8985","도어락","2018-11-26","44",7433,8843,0
"8986","도어락","2018-11-27","11",2282,11125,0
"8987","도어락","2018-11-28","2",406,11531,0
"8988","도어락","2018-11-29","13",4126,15657,0
"8989","도어락","2018-11-30","1",159,15816,0
"8990","도어락","2018-12-03","8",1368,17184,0
"8991","도어락","2018-12-04","19",2858,20042,0
"8992","도어락","2018-12-05","854",122978,143020,1
"8993","도어락","2018-12-06","863",112469,255489,2
"8994","도어락","2018-12-07","913",139818,395307,3
"8995","도어락","2018-12-08","954",233867,629174,4
"8996","도어락","2018-12-09","948",198391,827565,5
"8997","도어락","2018-12-10","919",73418,900983,6
"8998","도어락","2018-12-11","913",68035,969018,7
"8999","도어락","2018-12-12","838",66503,1035521,8
"9000","도어락","2018-12-13","822",65151,1100672,9
"9001","도어락","2018-12-14","861",88605,1189277,10
"9002","도어락","2018-12-15","873",128392,1317669,11
"9003","도어락","2018-12-16","853",109723,1427392,12
"9004","도어락","2018-12-17","788",42787,1470179,13
"9005","도어락","2018-12-18","808",42846,1513025,14
"9006","도어락","2018-12-19","163",6138,1519163,15
"9007","도어락","2018-12-20","164",5868,1525031,16
"9008","도어락","2018-12-21","160",6514,1531545,17
"9009","도어락","2018-12-22","141",7581,1539126,18
"9010","도어락","2018-12-23","134",6876,1546002,19
"9011","도어락","2018-12-24","111",4713,1550715,20
"9012","도어락","2018-12-25","55",4783,1555498,21
"9013","도어락","2018-12-26","31",947,1556445,22
"9014","도어락","2018-12-27","28",630,1557075,23
"9015","도어락","2018-12-28","28",614,1557689,24
"9016","도어락","2018-12-29","33",755,1558444,25
"9017","도어락","2018-12-30","32",572,1559016,26
"9018","도어락","2018-12-31","28",600,1559616,27
"9019","도어락","2019-01-01","15",329,1559945,28
"9020","도어락","2019-01-02","15",135,1560080,29
"9021","도어락","2019-01-03","6",50,1560130,30
"9022","도어락","2019-01-04","5",62,1560192,31
"9023","도어락","2019-01-05","4",84,1560276,32
"9024","도어락","2019-01-06","4",76,1560352,33
"9025","도어락","2019-01-07","4",36,1560388,34
"9026","도어락","2019-01-08","4",27,1560415,35
"9027","도어락","2019-01-09","1",6,1560421,36
"9028","도어락","2019-01-10","1",2,1560423,37
"9029","도어락","2019-01-18","1",2,1560425,38
"9030","도어락","2019-01-20","1",2,1560427,39
"9031","도어락","2019-01-21","1",14,1560441,40
"9032","도어락","2019-01-22","13",487,1560928,41
"9033","도어락","2019-01-23","1",21,1560949,42
"9034","도어락","2019-01-24","6",185,1561134,43
"9035","도어락","2019-01-25","2",57,1561191,44
"9036","도어락","2019-01-28","2",50,1561241,45
"9037","도어락","2019-01-31","1",17,1561258,46
"9038","리틀 포레스트","2018-02-13","15",3239,3239,0
"9039","리틀 포레스트","2018-02-20","35",6846,10085,0
"9040","리틀 포레스트","2018-02-21","12",2740,12825,0
"9041","리틀 포레스트","2018-02-24","2",1212,14037,0
"9042","리틀 포레스트","2018-02-25","2",207,14244,0
"9043","리틀 포레스트","2018-02-27","10",1354,15598,0
"9044","리틀 포레스트","2018-02-28","831",131350,146948,1
"9045","리틀 포레스트","2018-03-01","884",167097,314045,2
"9046","리틀 포레스트","2018-03-02","830",78782,392827,3
"9047","리틀 포레스트","2018-03-03","830",154014,546841,4
"9048","리틀 포레스트","2018-03-04","833",139732,686573,5
"9049","리틀 포레스트","2018-03-05","751",50835,737408,6
"9050","리틀 포레스트","2018-03-06","766",47876,785284,7
"9051","리틀 포레스트","2018-03-07","666",40047,825331,8
"9052","리틀 포레스트","2018-03-08","579",35210,860541,9
"9053","리틀 포레스트","2018-03-09","622",48732,909273,10
"9054","리틀 포레스트","2018-03-10","699",114883,1024156,11
"9055","리틀 포레스트","2018-03-11","694",99324,1123480,12
"9056","리틀 포레스트","2018-03-12","640",30094,1153574,13
"9057","리틀 포레스트","2018-03-13","655",30183,1183757,14
"9058","리틀 포레스트","2018-03-14","510",22905,1206662,15
"9059","리틀 포레스트","2018-03-15","521",19352,1226014,16
"9060","리틀 포레스트","2018-03-16","538",26541,1252555,17
"9061","리틀 포레스트","2018-03-17","584",55314,1307869,18
"9062","리틀 포레스트","2018-03-18","588",45707,1353576,19
"9063","리틀 포레스트","2018-03-19","546",15005,1368581,20
"9064","리틀 포레스트","2018-03-20","528",14371,1382952,21
"9065","리틀 포레스트","2018-03-21","514",12838,1395790,22
"9066","리틀 포레스트","2018-03-22","430",10268,1406058,23
"9067","리틀 포레스트","2018-03-23","459",12799,1418857,24
"9068","리틀 포레스트","2018-03-24","466",25371,1444228,25
"9069","리틀 포레스트","2018-03-25","458",22029,1466257,26
"9070","리틀 포레스트","2018-03-26","448",7874,1474131,27
"9071","리틀 포레스트","2018-03-27","458",8590,1482721,28
"9072","리틀 포레스트","2018-03-28","126",2808,1485529,29
"9073","리틀 포레스트","2018-03-29","114",1960,1487489,30
"9074","리틀 포레스트","2018-03-30","124",2407,1489896,31
"9075","리틀 포레스트","2018-03-31","92",3561,1493457,32
"9076","리틀 포레스트","2018-04-01","88",2747,1496204,33
"9077","리틀 포레스트","2018-04-02","112",1626,1497830,34
"9078","리틀 포레스트","2018-04-03","105",1423,1499253,35
"9079","리틀 포레스트","2018-04-04","94",1251,1500504,36
"9080","리틀 포레스트","2018-04-05","23",535,1501039,37
"9081","리틀 포레스트","2018-04-06","24",436,1501475,38
"9082","리틀 포레스트","2018-04-07","23",411,1501886,39
"9083","리틀 포레스트","2018-04-08","18",565,1502451,40
"9084","리틀 포레스트","2018-04-09","25",218,1502669,41
"9085","리틀 포레스트","2018-04-10","25",186,1502855,42
"9086","리틀 포레스트","2018-04-11","26",206,1503061,43
"9087","리틀 포레스트","2018-04-12","3",24,1503085,44
"9088","리틀 포레스트","2018-04-13","5",152,1503237,45
"9089","리틀 포레스트","2018-04-14","7",170,1503407,46
"9090","리틀 포레스트","2018-04-15","4",107,1503514,47
"9091","리틀 포레스트","2018-04-16","5",76,1503590,48
"9092","리틀 포레스트","2018-04-17","4",46,1503636,49
"9093","리틀 포레스트","2018-04-18","5",75,1503711,50
"9094","리틀 포레스트","2018-04-19","1",30,1503741,51
"9095","리틀 포레스트","2018-04-20","3",35,1503776,52
"9096","리틀 포레스트","2018-04-21","2",51,1503827,53
"9097","리틀 포레스트","2018-04-22","4",40,1503867,54
"9098","리틀 포레스트","2018-04-23","4",23,1503890,55
"9099","리틀 포레스트","2018-04-24","4",40,1503930,56
"9100","리틀 포레스트","2018-04-25","3",130,1504060,57
"9101","리틀 포레스트","2018-04-27","1",90,1504150,58
"9102","리틀 포레스트","2018-04-28","1",14,1504164,59
"9103","리틀 포레스트","2018-04-29","1",9,1504173,60
"9104","리틀 포레스트","2018-04-30","2",33,1504206,61
"9105","리틀 포레스트","2018-05-01","1",39,1504245,62
"9106","리틀 포레스트","2018-05-07","1",14,1504259,63
"9107","리틀 포레스트","2018-05-08","1",2,1504261,64
"9108","리틀 포레스트","2018-05-09","1",6,1504267,65
"9109","리틀 포레스트","2018-05-10","1",32,1504299,66
"9110","리틀 포레스트","2018-05-14","1",1,1504300,67
"9111","리틀 포레스트","2018-05-15","1",45,1504345,68
"9112","리틀 포레스트","2018-05-16","1",2,1504347,69
"9113","리틀 포레스트","2018-05-19","1",22,1504369,70
"9114","리틀 포레스트","2018-05-21","1",3,1504372,71
"9115","리틀 포레스트","2018-05-22","2",47,1504419,72
"9116","리틀 포레스트","2018-05-23","1",6,1504425,73
"9117","리틀 포레스트","2018-05-29","1",1,1504426,74
"9118","리틀 포레스트","2018-05-30","1",50,1504476,75
"9119","리틀 포레스트","2018-05-31","1",70,1504546,76
"9120","리틀 포레스트","2018-06-04","1",114,1504660,77
"9121","리틀 포레스트","2018-06-23","1",60,1504720,78
"9122","리틀 포레스트","2018-06-24","1",49,1504769,79
"9123","리틀 포레스트","2018-06-27","1",97,1504866,80
"9124","리틀 포레스트","2018-07-03","1",0,1504866,81
"9125","리틀 포레스트","2018-07-04","1",158,1505024,82
"9126","리틀 포레스트","2018-07-05","1",0,1505024,83
"9127","리틀 포레스트","2018-07-06","1",0,1505024,84
"9128","리틀 포레스트","2018-07-07","1",83,1505107,85
"9129","리틀 포레스트","2018-07-10","2",141,1505248,86
"9130","리틀 포레스트","2018-07-19","1",198,1505446,87
"9131","리틀 포레스트","2018-07-27","1",44,1505490,88
"9132","리틀 포레스트","2018-08-11","1",70,1505560,89
"9133","리틀 포레스트","2018-09-17","1",162,1505722,90
"9134","리틀 포레스트","2018-10-17","1",10,1505732,91
"9135","리틀 포레스트","2018-10-24","1",100,1505832,92
"9136","리틀 포레스트","2018-10-29","1",20,1505852,93
"9137","리틀 포레스트","2018-11-14","1",0,1505852,94
"9138","리틀 포레스트","2018-12-07","1",145,1505997,95
"9139","리틀 포레스트","2018-12-13","1",16,1506013,96
"9140","리틀 포레스트","2018-12-14","1",214,1506227,97
"9141","리틀 포레스트","2018-12-15","1",42,1506269,98
"9142","리틀 포레스트","2019-01-22","4",240,1506509,99
"9143","리틀 포레스트","2019-03-15","1",150,1506659,100
"9144","골든슬럼버","2018-02-07","5",1848,1848,0
"9145","골든슬럼버","2018-02-09","15",2969,4817,0
"9146","골든슬럼버","2018-02-11","1",828,5645,0
"9147","골든슬럼버","2018-02-12","1",4,5649,0
"9148","골든슬럼버","2018-02-13","23",3036,8685,0
"9149","골든슬럼버","2018-02-14","762",161564,170249,1
"9150","골든슬럼버","2018-02-15","822",183922,354171,2
"9151","골든슬럼버","2018-02-16","815",223269,577440,3
"9152","골든슬럼버","2018-02-17","833",236581,814021,4
"9153","골든슬럼버","2018-02-18","809",168610,982631,5
"9154","골든슬럼버","2018-02-19","722",62366,1044997,6
"9155","골든슬럼버","2018-02-20","720",48097,1093094,7
"9156","골든슬럼버","2018-02-21","689",42786,1135880,8
"9157","골든슬럼버","2018-02-22","623",33505,1169385,9
"9158","골든슬럼버","2018-02-23","635",35745,1205130,10
"9159","골든슬럼버","2018-02-24","684",65523,1270653,11
"9160","골든슬럼버","2018-02-25","670",56939,1327592,12
"9161","골든슬럼버","2018-02-26","592",21702,1349294,13
"9162","골든슬럼버","2018-02-27","597",20252,1369546,14
"9163","골든슬럼버","2018-02-28","167",3911,1373457,15
"9164","골든슬럼버","2018-03-01","156",4065,1377522,16
"9165","골든슬럼버","2018-03-02","126",1086,1378608,17
"9166","골든슬럼버","2018-03-03","118",1852,1380460,18
"9167","골든슬럼버","2018-03-04","116",1864,1382324,19
"9168","골든슬럼버","2018-03-05","96",542,1382866,20
"9169","골든슬럼버","2018-03-06","107",1070,1383936,21
"9170","골든슬럼버","2018-03-07","33",187,1384123,22
"9171","골든슬럼버","2018-03-08","6",19,1384142,23
"9172","골든슬럼버","2018-03-09","10",126,1384268,24
"9173","골든슬럼버","2018-03-10","9",135,1384403,25
"9174","골든슬럼버","2018-03-11","8",128,1384531,26
"9175","골든슬럼버","2018-03-12","10",125,1384656,27
"9176","골든슬럼버","2018-03-13","29",723,1385379,28
"9177","골든슬럼버","2018-03-14","8",148,1385527,29
"9178","골든슬럼버","2018-03-15","29",853,1386380,30
"9179","골든슬럼버","2018-03-16","9",194,1386574,31
"9180","골든슬럼버","2018-03-17","13",207,1386781,32
"9181","골든슬럼버","2018-03-18","6",101,1386882,33
"9182","골든슬럼버","2018-03-19","8",158,1387040,34
"9183","골든슬럼버","2018-03-20","9",143,1387183,35
"9184","골든슬럼버","2018-03-21","3",121,1387304,36
"9185","골든슬럼버","2018-03-22","4",189,1387493,37
"9186","골든슬럼버","2018-03-26","1",15,1387508,38
"9187","궁합","2018-02-14","1",406,406,0
"9188","궁합","2018-02-21","4",1186,1592,0
"9189","궁합","2018-02-23","4",1087,2679,0
"9190","궁합","2018-02-26","3",710,3389,0
"9191","궁합","2018-02-27","7",1213,4602,0
"9192","궁합","2018-02-28","855",175057,179659,1
"9193","궁합","2018-03-01","876",254670,434329,2
"9194","궁합","2018-03-02","884",103101,537430,3
"9195","궁합","2018-03-03","966",207151,744581,4
"9196","궁합","2018-03-04","965",179647,924228,5
"9197","궁합","2018-03-05","855",59586,983814,6
"9198","궁합","2018-03-06","856",53369,1037183,7
"9199","궁합","2018-03-07","747",40867,1078050,8
"9200","궁합","2018-03-08","618",33911,1111961,9
"9201","궁합","2018-03-09","630",33716,1145677,10
"9202","궁합","2018-03-10","647",67922,1213599,11
"9203","궁합","2018-03-11","618",55441,1269040,12
"9204","궁합","2018-03-12","573",15151,1284191,13
"9205","궁합","2018-03-13","565",14852,1299043,14
"9206","궁합","2018-03-14","360",5674,1304717,15
"9207","궁합","2018-03-15","337",5203,1309920,16
"9208","궁합","2018-03-16","321",4401,1314321,17
"9209","궁합","2018-03-17","311",7121,1321442,18
"9210","궁합","2018-03-18","296",5999,1327441,19
"9211","궁합","2018-03-19","279",3291,1330732,20
"9212","궁합","2018-03-20","272",2561,1333293,21
"9213","궁합","2018-03-21","85",1724,1335017,22
"9214","궁합","2018-03-22","42",1082,1336099,23
"9215","궁합","2018-03-23","36",444,1336543,24
"9216","궁합","2018-03-24","41",1268,1337811,25
"9217","궁합","2018-03-25","34",513,1338324,26
"9218","궁합","2018-03-26","50",235,1338559,27
"9219","궁합","2018-03-27","48",275,1338834,28
"9220","궁합","2018-03-28","10",130,1338964,29
"9221","궁합","2018-03-29","6",22,1338986,30
"9222","궁합","2018-03-30","5",97,1339083,31
"9223","궁합","2018-03-31","1",144,1339227,32
"9224","궁합","2018-04-03","1",3,1339230,33
"9225","궁합","2018-04-05","1",162,1339392,34
"9226","궁합","2018-04-07","1",144,1339536,35
"9227","궁합","2018-04-08","1",144,1339680,36
"9228","궁합","2018-04-10","1",13,1339693,37
"9229","궁합","2018-04-11","1",1,1339694,38
"9230","궁합","2018-04-12","1",100,1339794,39
"9231","궁합","2018-04-17","1",53,1339847,40
"9232","궁합","2018-04-18","2",270,1340117,41
"9233","사라진 밤","2018-02-22","1",208,208,0
"9234","사라진 밤","2018-02-28","6",1244,1452,0
"9235","사라진 밤","2018-03-05","12",2795,4247,0
"9236","사라진 밤","2018-03-06","33",3976,8223,0
"9237","사라진 밤","2018-03-07","697",57161,65384,1
"9238","사라진 밤","2018-03-08","608",65087,130471,2
"9239","사라진 밤","2018-03-09","683",91236,221707,3
"9240","사라진 밤","2018-03-10","857",222771,444478,4
"9241","사라진 밤","2018-03-11","925",209500,653978,5
"9242","사라진 밤","2018-03-12","790",59935,713913,6
"9243","사라진 밤","2018-03-13","800",54522,768435,7
"9244","사라진 밤","2018-03-14","675",49340,817775,8
"9245","사라진 밤","2018-03-15","652",39473,857248,9
"9246","사라진 밤","2018-03-16","683",49664,906912,10
"9247","사라진 밤","2018-03-17","777",110296,1017208,11
"9248","사라진 밤","2018-03-18","749",91943,1109151,12
"9249","사라진 밤","2018-03-19","684",27408,1136559,13
"9250","사라진 밤","2018-03-20","677",23879,1160438,14
"9251","사라진 밤","2018-03-21","590",19194,1179632,15
"9252","사라진 밤","2018-03-22","523",15735,1195367,16
"9253","사라진 밤","2018-03-23","535",20242,1215609,17
"9254","사라진 밤","2018-03-24","540",39530,1255139,18
"9255","사라진 밤","2018-03-25","542",32858,1287997,19
"9256","사라진 밤","2018-03-26","504",11187,1299184,20
"9257","사라진 밤","2018-03-27","509",10577,1309761,21
"9258","사라진 밤","2018-03-28","134",1198,1310959,22
"9259","사라진 밤","2018-03-29","124",799,1311758,23
"9260","사라진 밤","2018-03-30","126",808,1312566,24
"9261","사라진 밤","2018-03-31","94",1029,1313595,25
"9262","사라진 밤","2018-04-01","84",713,1314308,26
"9263","사라진 밤","2018-04-02","76",328,1314636,27
"9264","사라진 밤","2018-04-03","81",335,1314971,28
"9265","사라진 밤","2018-04-04","50",260,1315231,29
"9266","사라진 밤","2018-04-06","2",2,1315233,30
"9267","사라진 밤","2018-04-07","2",2,1315235,31
"9268","사라진 밤","2018-04-08","2",2,1315237,32
"9269","사라진 밤","2018-04-09","2",2,1315239,33
"9270","사라진 밤","2018-04-10","2",2,1315241,34
"9271","사라진 밤","2018-04-11","2",2,1315243,35
"9272","사라진 밤","2018-04-12","5",5,1315248,36
"9273","사라진 밤","2018-04-13","5",5,1315253,37
"9274","사라진 밤","2018-04-14","5",5,1315258,38
"9275","사라진 밤","2018-04-15","5",5,1315263,39
"9276","사라진 밤","2018-04-17","4",4,1315267,40
"9277","사라진 밤","2018-04-18","6",391,1315658,41
"9278","사라진 밤","2018-04-19","5",5,1315663,42
"9279","사라진 밤","2018-04-20","5",5,1315668,43
"9280","사라진 밤","2018-04-21","5",5,1315673,44
"9281","사라진 밤","2018-04-22","5",5,1315678,45
"9282","사라진 밤","2018-04-23","6",5,1315683,46
"9283","사라진 밤","2018-04-24","4",3,1315686,47
"9284","사라진 밤","2018-04-25","5",5,1315691,48
"9285","사라진 밤","2018-04-26","5",5,1315696,49
"9286","사라진 밤","2018-04-27","5",5,1315701,50
"9287","사라진 밤","2018-04-28","5",5,1315706,51
"9288","사라진 밤","2018-04-29","5",5,1315711,52
"9289","사라진 밤","2018-04-30","5",5,1315716,53
"9290","사라진 밤","2018-05-01","5",5,1315721,54
"9291","사라진 밤","2018-05-02","5",5,1315726,55
"9292","사라진 밤","2018-07-05","1",0,1315726,56
"9293","스윙키즈","2018-11-23","1",247,247,0
"9294","스윙키즈","2018-11-29","1",247,494,0
"9295","스윙키즈","2018-12-04","4",1595,2089,0
"9296","스윙키즈","2018-12-05","12",1730,3819,0
"9297","스윙키즈","2018-12-06","52",10538,14357,0
"9298","스윙키즈","2018-12-07","25",4318,18675,0
"9299","스윙키즈","2018-12-09","2",306,18981,0
"9300","스윙키즈","2018-12-10","2",184,19165,0
"9301","스윙키즈","2018-12-11","14",4702,23867,0
"9302","스윙키즈","2018-12-12","6",1017,24884,0
"9303","스윙키즈","2018-12-13","20",3045,27929,0
"9304","스윙키즈","2018-12-14","353",9804,37733,0
"9305","스윙키즈","2018-12-15","418",30951,68684,0
"9306","스윙키즈","2018-12-16","407",32305,100989,0
"9307","스윙키즈","2018-12-17","17",3086,104075,0
"9308","스윙키즈","2018-12-18","21",4631,108706,0
"9309","스윙키즈","2018-12-19","984",102502,211208,1
"9310","스윙키즈","2018-12-20","983",78455,289663,2
"9311","스윙키즈","2018-12-21","983",94342,384005,3
"9312","스윙키즈","2018-12-22","860",141390,525395,4
"9313","스윙키즈","2018-12-23","810",135550,660945,5
"9314","스윙키즈","2018-12-24","831",114277,775222,6
"9315","스윙키즈","2018-12-25","656",144828,920050,7
"9316","스윙키즈","2018-12-26","608",54156,974206,8
"9317","스윙키즈","2018-12-27","631",39085,1013291,9
"9318","스윙키즈","2018-12-28","666",43230,1056521,10
"9319","스윙키즈","2018-12-29","680",68940,1125461,11
"9320","스윙키즈","2018-12-30","653",69690,1195151,12
"9321","스윙키즈","2018-12-31","662",63660,1258811,13
"9322","스윙키즈","2019-01-01","577",66173,1324984,14
"9323","스윙키즈","2019-01-02","587",23104,1348088,15
"9324","스윙키즈","2019-01-03","536",19023,1367111,16
"9325","스윙키즈","2019-01-04","525",17370,1384481,17
"9326","스윙키즈","2019-01-05","479",24315,1408796,18
"9327","스윙키즈","2019-01-06","472",19210,1428006,19
"9328","스윙키즈","2019-01-07","484",10788,1438794,20
"9329","스윙키즈","2019-01-08","510",11573,1450367,21
"9330","스윙키즈","2019-01-09","161",2736,1453103,22
"9331","스윙키즈","2019-01-10","131",2655,1455758,23
"9332","스윙키즈","2019-01-11","128",2113,1457871,24
"9333","스윙키즈","2019-01-12","105",3338,1461209,25
"9334","스윙키즈","2019-01-13","97",1665,1462874,26
"9335","스윙키즈","2019-01-14","99",956,1463830,27
"9336","스윙키즈","2019-01-15","106",1449,1465279,28
"9337","스윙키즈","2019-01-16","14",1006,1466285,29
"9338","스윙키즈","2019-01-17","12",603,1466888,30
"9339","스윙키즈","2019-01-18","7",508,1467396,31
"9340","스윙키즈","2019-01-19","6",345,1467741,32
"9341","스윙키즈","2019-01-20","4",55,1467796,33
"9342","스윙키즈","2019-01-21","4",37,1467833,34
"9343","스윙키즈","2019-01-22","7",269,1468102,35
"9344","스윙키즈","2019-01-23","5",378,1468480,36
"9345","스윙키즈","2019-01-24","3",29,1468509,37
"9346","스윙키즈","2019-01-25","5",192,1468701,38
"9347","스윙키즈","2019-01-26","3",99,1468800,39
"9348","스윙키즈","2019-01-27","4",41,1468841,40
"9349","스윙키즈","2019-01-28","8",248,1469089,41
"9350","스윙키즈","2019-01-29","15",807,1469896,42
"9351","스윙키즈","2019-01-30","8",418,1470314,43
"9352","스윙키즈","2019-01-31","5",93,1470407,44
"9353","스윙키즈","2019-02-01","3",15,1470422,45
"9354","스윙키즈","2019-02-02","3",25,1470447,46
"9355","스윙키즈","2019-02-03","3",29,1470476,47
"9356","스윙키즈","2019-02-04","3",26,1470502,48
"9357","스윙키즈","2019-02-05","2",30,1470532,49
"9358","스윙키즈","2019-02-06","3",33,1470565,50
"9359","스윙키즈","2019-02-07","2",3,1470568,51
"9360","스윙키즈","2019-02-08","2",162,1470730,52
"9361","스윙키즈","2019-02-09","1",11,1470741,53
"9362","스윙키즈","2019-02-10","1",22,1470763,54
"9363","스윙키즈","2019-02-11","1",9,1470772,55
"9364","스윙키즈","2019-02-12","1",12,1470784,56
"9365","스윙키즈","2019-02-13","4",464,1471248,57
"9366","바람 바람 바람","2018-03-22","3",1060,1060,0
"9367","바람 바람 바람","2018-03-23","1",0,1060,0
"9368","바람 바람 바람","2018-03-27","12",3446,4506,0
"9369","바람 바람 바람","2018-03-28","9",2075,6581,0
"9370","바람 바람 바람","2018-03-29","6",1286,7867,0
"9371","바람 바람 바람","2018-03-31","11",2403,10270,0
"9372","바람 바람 바람","2018-04-01","9",1377,11647,0
"9373","바람 바람 바람","2018-04-02","5",996,12643,0
"9374","바람 바람 바람","2018-04-03","38",4785,17428,0
"9375","바람 바람 바람","2018-04-04","1",2,17430,0
"9376","바람 바람 바람","2018-04-05","792",95534,112964,1
"9377","바람 바람 바람","2018-04-06","955",135974,248938,2
"9378","바람 바람 바람","2018-04-07","985",206378,455316,3
"9379","바람 바람 바람","2018-04-08","968",161658,616974,4
"9380","바람 바람 바람","2018-04-09","881",56883,673857,5
"9381","바람 바람 바람","2018-04-10","884",54858,728715,6
"9382","바람 바람 바람","2018-04-11","876",58994,787709,7
"9383","바람 바람 바람","2018-04-12","584",36074,823783,8
"9384","바람 바람 바람","2018-04-13","608",42063,865846,9
"9385","바람 바람 바람","2018-04-14","623",86145,951991,10
"9386","바람 바람 바람","2018-04-15","619",57646,1009637,11
"9387","바람 바람 바람","2018-04-16","550",22433,1032070,12
"9388","바람 바람 바람","2018-04-17","561",21724,1053794,13
"9389","바람 바람 바람","2018-04-18","562",20656,1074450,14
"9390","바람 바람 바람","2018-04-19","456",13827,1088277,15
"9391","바람 바람 바람","2018-04-20","483",17175,1105452,16
"9392","바람 바람 바람","2018-04-21","489",26596,1132048,17
"9393","바람 바람 바람","2018-04-22","492",27399,1159447,18
"9394","바람 바람 바람","2018-04-23","474",13678,1173125,19
"9395","바람 바람 바람","2018-04-24","479",11832,1184957,20
"9396","바람 바람 바람","2018-04-25","94",2023,1186980,21
"9397","바람 바람 바람","2018-04-26","79",1354,1188334,22
"9398","바람 바람 바람","2018-04-27","78",1158,1189492,23
"9399","바람 바람 바람","2018-04-28","57",1288,1190780,24
"9400","바람 바람 바람","2018-04-29","54",996,1191776,25
"9401","바람 바람 바람","2018-04-30","64",1131,1192907,26
"9402","바람 바람 바람","2018-05-01","19",515,1193422,27
"9403","바람 바람 바람","2018-05-02","22",321,1193743,28
"9404","바람 바람 바람","2018-05-03","14",146,1193889,29
"9405","바람 바람 바람","2018-05-04","11",50,1193939,30
"9406","바람 바람 바람","2018-05-05","6",10,1193949,31
"9407","바람 바람 바람","2018-05-06","6",23,1193972,32
"9408","바람 바람 바람","2018-05-07","6",27,1193999,33
"9409","바람 바람 바람","2018-05-08","9",45,1194044,34
"9410","바람 바람 바람","2018-05-09","4",9,1194053,35
"9411","바람 바람 바람","2018-05-10","4",4,1194057,36
"9412","바람 바람 바람","2018-05-11","5",19,1194076,37
"9413","바람 바람 바람","2018-05-12","5",49,1194125,38
"9414","바람 바람 바람","2018-05-13","6",32,1194157,39
"9415","바람 바람 바람","2018-05-14","6",16,1194173,40
"9416","바람 바람 바람","2018-05-15","4",22,1194195,41
"9417","바람 바람 바람","2018-05-16","3",3,1194198,42
"9418","바람 바람 바람","2018-05-17","2",2,1194200,43
"9419","바람 바람 바람","2018-05-18","2",2,1194202,44
"9420","바람 바람 바람","2018-05-19","2",2,1194204,45
"9421","바람 바람 바람","2018-05-20","2",2,1194206,46
"9422","바람 바람 바람","2018-05-21","2",2,1194208,47
"9423","바람 바람 바람","2018-05-22","2",2,1194210,48
"9424","바람 바람 바람","2018-05-23","2",2,1194212,49
"9425","바람 바람 바람","2018-05-24","2",2,1194214,50
"9426","바람 바람 바람","2018-05-25","2",2,1194216,51
"9427","바람 바람 바람","2018-05-26","2",2,1194218,52
"9428","바람 바람 바람","2018-05-27","2",2,1194220,53
"9429","바람 바람 바람","2018-05-28","1",1,1194221,54
"9430","바람 바람 바람","2018-06-06","1",1,1194222,55
"9431","바람 바람 바람","2018-06-07","1",1,1194223,56
"9432","바람 바람 바람","2018-06-08","1",1,1194224,57
"9433","바람 바람 바람","2018-06-09","1",1,1194225,58
"9434","바람 바람 바람","2018-06-10","1",1,1194226,59
"9435","바람 바람 바람","2018-06-11","1",1,1194227,60
"9436","바람 바람 바람","2018-06-12","1",1,1194228,61
"9437","바람 바람 바람","2018-06-13","1",1,1194229,62
"9438","바람 바람 바람","2018-07-04","1",0,1194229,63
"9439","바람 바람 바람","2018-07-06","1",0,1194229,64
"9440","PMC: 더 벙커","2018-12-17","1",214,214,0
"9441","PMC: 더 벙커","2018-12-19","10",2511,2725,0
"9442","PMC: 더 벙커","2018-12-20","14",4153,6878,0
"9443","PMC: 더 벙커","2018-12-21","66",12731,19609,0
"9444","PMC: 더 벙커","2018-12-22","5",1315,20924,0
"9445","PMC: 더 벙커","2018-12-23","5",1112,22036,0
"9446","PMC: 더 벙커","2018-12-24","2",145,22181,0
"9447","PMC: 더 벙커","2018-12-26","1,047",219234,241415,1
"9448","PMC: 더 벙커","2018-12-27","1,027",130647,372062,2
"9449","PMC: 더 벙커","2018-12-28","1,081",154163,526225,3
"9450","PMC: 더 벙커","2018-12-29","1,027",251466,777691,4
"9451","PMC: 더 벙커","2018-12-30","995",236214,1013905,5
"9452","PMC: 더 벙커","2018-12-31","957",165126,1179031,6
"9453","PMC: 더 벙커","2019-01-01","893",195859,1374890,7
"9454","PMC: 더 벙커","2019-01-02","819",49300,1424190,8
"9455","PMC: 더 벙커","2019-01-03","747",35509,1459699,9
"9456","PMC: 더 벙커","2019-01-04","732",36003,1495702,10
"9457","PMC: 더 벙커","2019-01-05","741",61436,1557138,11
"9458","PMC: 더 벙커","2019-01-06","715",50537,1607675,12
"9459","PMC: 더 벙커","2019-01-07","670",18774,1626449,13
"9460","PMC: 더 벙커","2019-01-08","665",17250,1643699,14
"9461","PMC: 더 벙커","2019-01-09","341",4688,1648387,15
"9462","PMC: 더 벙커","2019-01-10","278",3285,1651672,16
"9463","PMC: 더 벙커","2019-01-11","268",3601,1655273,17
"9464","PMC: 더 벙커","2019-01-12","218",5093,1660366,18
"9465","PMC: 더 벙커","2019-01-13","204",4834,1665200,19
"9466","PMC: 더 벙커","2019-01-14","191",1586,1666786,20
"9467","PMC: 더 벙커","2019-01-15","205",1565,1668351,21
"9468","PMC: 더 벙커","2019-01-16","17",371,1668722,22
"9469","PMC: 더 벙커","2019-01-17","5",99,1668821,23
"9470","PMC: 더 벙커","2019-01-18","6",115,1668936,24
"9471","PMC: 더 벙커","2019-01-19","9",192,1669128,25
"9472","PMC: 더 벙커","2019-01-20","10",171,1669299,26
"9473","PMC: 더 벙커","2019-01-21","2",12,1669311,27
"9474","PMC: 더 벙커","2019-01-22","3",36,1669347,28
"9475","PMC: 더 벙커","2019-01-23","20",400,1669747,29
"9476","PMC: 더 벙커","2019-01-24","6",109,1669856,30
"9477","PMC: 더 벙커","2019-01-25","5",100,1669956,31
"9478","PMC: 더 벙커","2019-01-26","5",100,1670056,32
"9479","PMC: 더 벙커","2019-01-27","5",100,1670156,33
"9480","PMC: 더 벙커","2019-01-28","6",101,1670257,34
"9481","PMC: 더 벙커","2019-01-29","6",101,1670358,35
"9482","PMC: 더 벙커","2019-01-30","6",101,1670459,36
"9483","PMC: 더 벙커","2019-01-31","5",100,1670559,37
"9484","PMC: 더 벙커","2019-02-01","4",80,1670639,38
"9485","PMC: 더 벙커","2019-02-02","5",120,1670759,39
"9486","PMC: 더 벙커","2019-02-03","5",100,1670859,40
"9487","PMC: 더 벙커","2019-02-04","5",100,1670959,41
"9488","PMC: 더 벙커","2019-02-05","5",100,1671059,42
"9489","PMC: 더 벙커","2019-02-08","1",1,1671060,43
"9490","PMC: 더 벙커","2019-02-12","1",1,1671061,44
"9491","PMC: 더 벙커","2019-02-13","1",306,1671367,45
"9492","PMC: 더 벙커","2019-02-14","2",178,1671545,46
"9493","PMC: 더 벙커","2019-02-22","1",1,1671546,47
"9494","PMC: 더 벙커","2019-02-25","1",1,1671547,48
"9495","PMC: 더 벙커","2019-02-28","1",1,1671548,49
"9496","챔피언","2018-04-26","3",695,695,0
"9497","챔피언","2018-04-30","11",2760,3455,0
"9498","챔피언","2018-05-01","795",139965,143420,1
"9499","챔피언","2018-05-02","816",62830,206250,2
"9500","챔피언","2018-05-03","815",54305,260555,3
"9501","챔피언","2018-05-04","812",75687,336242,4
"9502","챔피언","2018-05-05","806",170126,506368,5
"9503","챔피언","2018-05-06","839",194847,701215,6
"9504","챔피언","2018-05-07","874",147452,848667,7
"9505","챔피언","2018-05-08","822",42277,890944,8
"9506","챔피언","2018-05-09","626",22102,913046,9
"9507","챔피언","2018-05-10","601",17225,930271,10
"9508","챔피언","2018-05-11","631",23799,954070,11
"9509","챔피언","2018-05-12","638",59670,1013740,12
"9510","챔피언","2018-05-13","633",53814,1067554,13
"9511","챔피언","2018-05-14","584",13166,1080720,14
"9512","챔피언","2018-05-15","601",15443,1096163,15
"9513","챔피언","2018-05-16","379",6550,1102713,16
"9514","챔피언","2018-05-17","196",3595,1106308,17
"9515","챔피언","2018-05-18","175",3814,1110122,18
"9516","챔피언","2018-05-19","156",3898,1114020,19
"9517","챔피언","2018-05-20","152",3519,1117539,20
"9518","챔피언","2018-05-21","165",3453,1120992,21
"9519","챔피언","2018-05-22","64",1437,1122429,22
"9520","챔피언","2018-05-23","60",545,1122974,23
"9521","챔피언","2018-05-24","53",894,1123868,24
"9522","챔피언","2018-05-25","49",771,1124639,25
"9523","챔피언","2018-05-26","46",814,1125453,26
"9524","챔피언","2018-05-27","40",395,1125848,27
"9525","챔피언","2018-05-28","41",288,1126136,28
"9526","챔피언","2018-05-29","43",690,1126826,29
"9527","챔피언","2018-05-30","6",405,1127231,30
"9528","챔피언","2018-05-31","5",488,1127719,31
"9529","챔피언","2018-06-01","2",189,1127908,32
"9530","챔피언","2018-06-02","1",3,1127911,33
"9531","챔피언","2018-06-04","1",131,1128042,34
"9532","챔피언","2018-06-05","1",26,1128068,35
"9533","챔피언","2018-06-07","1",140,1128208,36
"9534","챔피언","2018-06-09","2",224,1128432,37
"9535","챔피언","2018-06-14","1",86,1128518,38
"9536","챔피언","2018-06-15","1",89,1128607,39
"9537","챔피언","2018-06-16","1",86,1128693,40
"9538","챔피언","2018-07-12","1",81,1128774,41
"9539","염력","2018-01-22","1",247,247,0
"9540","염력","2018-01-23","4",1616,1863,0
"9541","염력","2018-01-25","8",1852,3715,0
"9542","염력","2018-01-26","1",144,3859,0
"9543","염력","2018-01-29","8",3737,7596,0
"9544","염력","2018-01-30","3",985,8581,0
"9545","염력","2018-01-31","1,099",264711,273292,1
"9546","염력","2018-02-01","1,053",101924,375216,2
"9547","염력","2018-02-02","1,051",103337,478553,3
"9548","염력","2018-02-03","946",204075,682628,4
"9549","염력","2018-02-04","916",164349,846977,5
"9550","염력","2018-02-05","839",35464,882441,6
"9551","염력","2018-02-06","839",30414,912855,7
"9552","염력","2018-02-07","766",22656,935511,8
"9553","염력","2018-02-08","535",15130,950641,9
"9554","염력","2018-02-09","500",7287,957928,10
"9555","염력","2018-02-10","492",10545,968473,11
"9556","염력","2018-02-11","465",9654,978127,12
"9557","염력","2018-02-12","424",3459,981586,13
"9558","염력","2018-02-13","434",3721,985307,14
"9559","염력","2018-02-14","12",325,985632,15
"9560","염력","2018-02-15","11",232,985864,16
"9561","염력","2018-02-16","8",87,985951,17
"9562","염력","2018-02-17","9",160,986111,18
"9563","염력","2018-02-18","10",247,986358,19
"9564","염력","2018-02-19","6",72,986430,20
"9565","염력","2018-02-20","9",46,986476,21
"9566","염력","2018-02-21","9",58,986534,22
"9567","염력","2018-02-22","1",17,986551,23
"9568","염력","2018-02-23","1",31,986582,24
"9569","염력","2018-02-24","2",28,986610,25
"9570","염력","2018-02-25","2",30,986640,26
"9571","염력","2018-02-26","1",5,986645,27
"9572","염력","2018-02-27","1",6,986651,28
"9573","염력","2018-03-08","4",1171,987822,29
"9574","염력","2018-03-26","19",163,987985,30
"9575","염력","2018-03-27","19",182,988167,31
"9576","염력","2018-03-28","19",172,988339,32
"9577","염력","2018-03-29","20",173,988512,33
"9578","염력","2018-03-30","20",173,988685,34
"9579","염력","2018-03-31","20",173,988858,35
"9580","염력","2018-04-01","20",173,989031,36
"9581","염력","2018-04-02","18",153,989184,37
"9582","염력","2018-04-03","18",153,989337,38
"9583","염력","2018-04-04","18",153,989490,39
"9584","염력","2018-04-05","18",153,989643,40
"9585","염력","2018-04-06","18",153,989796,41
"9586","염력","2018-04-07","17",143,989939,42
"9587","염력","2018-04-08","18",163,990102,43
"9588","염력","2018-04-09","2",2,990104,44
"9589","인랑","2018-07-20","7",2431,2431,0
"9590","인랑","2018-07-23","17",3791,6222,0
"9591","인랑","2018-07-24","69",13444,19666,0
"9592","인랑","2018-07-25","1,085",274510,294176,1
"9593","인랑","2018-07-26","1,029",101715,395891,2
"9594","인랑","2018-07-27","977",88857,484748,3
"9595","인랑","2018-07-28","829",145053,629801,4
"9596","인랑","2018-07-29","805",129514,759315,5
"9597","인랑","2018-07-30","712",53845,813160,6
"9598","인랑","2018-07-31","694",49925,863085,7
"9599","인랑","2018-08-01","274",6072,869157,8
"9600","인랑","2018-08-02","232",4966,874123,9
"9601","인랑","2018-08-03","207",4267,878390,10
"9602","인랑","2018-08-04","152",6217,884607,11
"9603","인랑","2018-08-05","151",6701,891308,12
"9604","인랑","2018-08-06","147",1857,893165,13
"9605","인랑","2018-08-07","153",1800,894965,14
"9606","인랑","2018-08-08","8",188,895153,15
"9607","인랑","2018-08-09","4",71,895224,16
"9608","인랑","2018-08-10","7",129,895353,17
"9609","인랑","2018-08-11","4",72,895425,18
"9610","인랑","2018-08-12","4",127,895552,19
"9611","인랑","2018-08-13","6",89,895641,20
"9612","인랑","2018-08-14","23",735,896376,21
"9613","인랑","2018-08-15","5",44,896420,22
"9614","인랑","2018-08-16","19",680,897100,23
"9615","인랑","2018-08-17","2",35,897135,24
"9616","인랑","2018-08-18","5",99,897234,25
"9617","인랑","2018-08-19","1",21,897255,26
"9618","인랑","2018-08-20","2",64,897319,27
"9619","인랑","2018-08-21","2",27,897346,28
"9620","인랑","2018-08-22","4",137,897483,29
"9621","인랑","2018-08-27","1",14,897497,30
"9622","인랑","2018-08-30","1",51,897548,31
"9623","인랑","2018-10-30","1",416,897964,32
"9624","인랑","2018-10-31","2",466,898430,33
"9625","인랑","2018-11-01","2",515,898945,34
"9626","인랑","2018-11-14","1",0,898945,35
"9627","인랑","2018-11-18","1",0,898945,36
"9628","극장판 헬로카봇 : 백악기 시대","2018-07-25","1",218,218,0
"9629","극장판 헬로카봇 : 백악기 시대","2018-07-28","11",2740,2958,0
"9630","극장판 헬로카봇 : 백악기 시대","2018-07-29","2",402,3360,0
"9631","극장판 헬로카봇 : 백악기 시대","2018-07-30","5",902,4262,0
"9632","극장판 헬로카봇 : 백악기 시대","2018-07-31","1",220,4482,0
"9633","극장판 헬로카봇 : 백악기 시대","2018-08-01","721",162242,166724,1
"9634","극장판 헬로카봇 : 백악기 시대","2018-08-02","758",127108,293832,2
"9635","극장판 헬로카봇 : 백악기 시대","2018-08-03","745",103199,397031,3
"9636","극장판 헬로카봇 : 백악기 시대","2018-08-04","725",117326,514357,4
"9637","극장판 헬로카봇 : 백악기 시대","2018-08-05","690",107431,621788,5
"9638","극장판 헬로카봇 : 백악기 시대","2018-08-06","597",39842,661630,6
"9639","극장판 헬로카봇 : 백악기 시대","2018-08-07","601",36921,698551,7
"9640","극장판 헬로카봇 : 백악기 시대","2018-08-08","228",12872,711423,8
"9641","극장판 헬로카봇 : 백악기 시대","2018-08-09","238",11744,723167,9
"9642","극장판 헬로카봇 : 백악기 시대","2018-08-10","264",11620,734787,10
"9643","극장판 헬로카봇 : 백악기 시대","2018-08-11","254",24070,758857,11
"9644","극장판 헬로카봇 : 백악기 시대","2018-08-12","277",26484,785341,12
"9645","극장판 헬로카봇 : 백악기 시대","2018-08-13","250",7167,792508,13
"9646","극장판 헬로카봇 : 백악기 시대","2018-08-14","257",7900,800408,14
"9647","극장판 헬로카봇 : 백악기 시대","2018-08-15","182",23767,824175,15
"9648","극장판 헬로카봇 : 백악기 시대","2018-08-16","122",3362,827537,16
"9649","극장판 헬로카봇 : 백악기 시대","2018-08-17","133",2971,830508,17
"9650","극장판 헬로카봇 : 백악기 시대","2018-08-18","187",11967,842475,18
"9651","극장판 헬로카봇 : 백악기 시대","2018-08-19","189",11755,854230,19
"9652","극장판 헬로카봇 : 백악기 시대","2018-08-20","100",1416,855646,20
"9653","극장판 헬로카봇 : 백악기 시대","2018-08-21","117",1678,857324,21
"9654","극장판 헬로카봇 : 백악기 시대","2018-08-22","59",1099,858423,22
"9655","극장판 헬로카봇 : 백악기 시대","2018-08-23","34",667,859090,23
"9656","극장판 헬로카봇 : 백악기 시대","2018-08-24","38",1246,860336,24
"9657","극장판 헬로카봇 : 백악기 시대","2018-08-25","84",3261,863597,25
"9658","극장판 헬로카봇 : 백악기 시대","2018-08-26","82",3263,866860,26
"9659","극장판 헬로카봇 : 백악기 시대","2018-08-27","33",472,867332,27
"9660","극장판 헬로카봇 : 백악기 시대","2018-08-28","41",445,867777,28
"9661","극장판 헬로카봇 : 백악기 시대","2018-08-29","23",676,868453,29
"9662","극장판 헬로카봇 : 백악기 시대","2018-08-30","15",580,869033,30
"9663","극장판 헬로카봇 : 백악기 시대","2018-08-31","23",1068,870101,31
"9664","극장판 헬로카봇 : 백악기 시대","2018-09-01","32",964,871065,32
"9665","극장판 헬로카봇 : 백악기 시대","2018-09-02","32",995,872060,33
"9666","극장판 헬로카봇 : 백악기 시대","2018-09-03","12",85,872145,34
"9667","극장판 헬로카봇 : 백악기 시대","2018-09-04","10",112,872257,35
"9668","극장판 헬로카봇 : 백악기 시대","2018-09-05","11",81,872338,36
"9669","극장판 헬로카봇 : 백악기 시대","2018-09-06","9",69,872407,37
"9670","극장판 헬로카봇 : 백악기 시대","2018-09-07","14",278,872685,38
"9671","극장판 헬로카봇 : 백악기 시대","2018-09-08","21",505,873190,39
"9672","극장판 헬로카봇 : 백악기 시대","2018-09-09","19",407,873597,40
"9673","극장판 헬로카봇 : 백악기 시대","2018-09-10","21",2521,876118,41
"9674","극장판 헬로카봇 : 백악기 시대","2018-09-11","7",114,876232,42
"9675","극장판 헬로카봇 : 백악기 시대","2018-09-12","6",37,876269,43
"9676","극장판 헬로카봇 : 백악기 시대","2018-09-13","6",117,876386,44
"9677","극장판 헬로카봇 : 백악기 시대","2018-09-14","7",110,876496,45
"9678","극장판 헬로카봇 : 백악기 시대","2018-09-15","9",250,876746,46
"9679","극장판 헬로카봇 : 백악기 시대","2018-09-16","9",214,876960,47
"9680","극장판 헬로카봇 : 백악기 시대","2018-09-17","3",15,876975,48
"9681","극장판 헬로카봇 : 백악기 시대","2018-09-18","4",12,876987,49
"9682","극장판 헬로카봇 : 백악기 시대","2018-09-19","5",28,877015,50
"9683","극장판 헬로카봇 : 백악기 시대","2018-09-25","1",12,877027,51
"9684","극장판 헬로카봇 : 백악기 시대","2018-09-26","1",8,877035,52
"9685","극장판 헬로카봇 : 백악기 시대","2018-09-27","1",2,877037,53
"9686","극장판 헬로카봇 : 백악기 시대","2018-09-28","2",33,877070,54
"9687","극장판 헬로카봇 : 백악기 시대","2018-09-29","1",5,877075,55
"9688","극장판 헬로카봇 : 백악기 시대","2018-09-30","2",10,877085,56
"9689","극장판 헬로카봇 : 백악기 시대","2018-10-01","1",2,877087,57
"9690","극장판 헬로카봇 : 백악기 시대","2018-10-02","1",2,877089,58
"9691","극장판 헬로카봇 : 백악기 시대","2018-10-03","1",25,877114,59
"9692","극장판 헬로카봇 : 백악기 시대","2018-10-04","1",2,877116,60
"9693","극장판 헬로카봇 : 백악기 시대","2018-10-06","1",8,877124,61
"9694","극장판 헬로카봇 : 백악기 시대","2018-10-07","1",7,877131,62
"9695","극장판 헬로카봇 : 백악기 시대","2018-10-09","1",19,877150,63
"9696","극장판 헬로카봇 : 백악기 시대","2018-10-11","1",1,877151,64
"9697","극장판 헬로카봇 : 백악기 시대","2018-10-13","1",26,877177,65
"9698","극장판 헬로카봇 : 백악기 시대","2018-10-14","1",9,877186,66
"9699","극장판 헬로카봇 : 백악기 시대","2018-10-15","2",149,877335,67
"9700","극장판 헬로카봇 : 백악기 시대","2018-10-16","1",95,877430,68
"9701","극장판 헬로카봇 : 백악기 시대","2018-10-22","1",101,877531,69
"9702","극장판 헬로카봇 : 백악기 시대","2018-10-23","1",117,877648,70
"9703","극장판 헬로카봇 : 백악기 시대","2018-10-24","2",340,877988,71
"9704","극장판 헬로카봇 : 백악기 시대","2018-10-25","3",462,878450,72
"9705","극장판 헬로카봇 : 백악기 시대","2018-10-26","1",1,878451,73
"9706","극장판 헬로카봇 : 백악기 시대","2018-10-28","1",12,878463,74
"9707","극장판 헬로카봇 : 백악기 시대","2018-10-29","1",85,878548,75
"9708","극장판 헬로카봇 : 백악기 시대","2018-10-30","3",95,878643,76
"9709","극장판 헬로카봇 : 백악기 시대","2018-11-01","1",4,878647,77
"9710","극장판 헬로카봇 : 백악기 시대","2018-11-03","1",2,878649,78
"9711","극장판 헬로카봇 : 백악기 시대","2018-11-04","2",15,878664,79
"9712","극장판 헬로카봇 : 백악기 시대","2018-11-05","1",110,878774,80
"9713","극장판 헬로카봇 : 백악기 시대","2018-11-06","1",87,878861,81
"9714","극장판 헬로카봇 : 백악기 시대","2018-11-11","1",9,878870,82
"9715","극장판 헬로카봇 : 백악기 시대","2018-11-12","1",3,878873,83
"9716","극장판 헬로카봇 : 백악기 시대","2018-11-13","1",82,878955,84
"9717","극장판 헬로카봇 : 백악기 시대","2018-11-14","2",3,878958,85
"9718","극장판 헬로카봇 : 백악기 시대","2018-11-15","1",4,878962,86
"9719","극장판 헬로카봇 : 백악기 시대","2018-11-16","1",1,878963,87
"9720","극장판 헬로카봇 : 백악기 시대","2018-11-17","2",105,879068,88
"9721","극장판 헬로카봇 : 백악기 시대","2018-11-18","2",87,879155,89
"9722","극장판 헬로카봇 : 백악기 시대","2018-11-20","1",0,879155,90
"9723","극장판 헬로카봇 : 백악기 시대","2018-11-21","1",2,879157,91
"9724","극장판 헬로카봇 : 백악기 시대","2018-11-22","1",1,879158,92
"9725","극장판 헬로카봇 : 백악기 시대","2018-11-23","1",1,879159,93
"9726","극장판 헬로카봇 : 백악기 시대","2018-11-24","2",16,879175,94
"9727","극장판 헬로카봇 : 백악기 시대","2018-11-25","1",24,879199,95
"9728","극장판 헬로카봇 : 백악기 시대","2018-11-28","1",2,879201,96
"9729","극장판 헬로카봇 : 백악기 시대","2018-11-29","1",1,879202,97
"9730","극장판 헬로카봇 : 백악기 시대","2018-11-30","2",110,879312,98
"9731","극장판 헬로카봇 : 백악기 시대","2018-12-01","1",11,879323,99
"9732","극장판 헬로카봇 : 백악기 시대","2018-12-02","2",31,879354,100
"9733","극장판 헬로카봇 : 백악기 시대","2018-12-03","1",6,879360,101
"9734","극장판 헬로카봇 : 백악기 시대","2018-12-05","1",5,879365,102
"9735","극장판 헬로카봇 : 백악기 시대","2018-12-07","1",3,879368,103
"9736","극장판 헬로카봇 : 백악기 시대","2018-12-08","1",24,879392,104
"9737","극장판 헬로카봇 : 백악기 시대","2018-12-12","1",3,879395,105
"9738","극장판 헬로카봇 : 백악기 시대","2018-12-13","1",5,879400,106
"9739","극장판 헬로카봇 : 백악기 시대","2018-12-20","1",49,879449,107
"9740","극장판 헬로카봇 : 백악기 시대","2019-01-31","1",2,879451,108
"9741","극장판 헬로카봇 : 백악기 시대","2019-02-01","1",2,879453,109
"9742","레슬러","2018-04-18","1",262,262,0
"9743","레슬러","2018-04-23","5",1104,1366,0
"9744","레슬러","2018-04-26","6",1260,2626,0
"9745","레슬러","2018-04-30","14",2552,5178,0
"9746","레슬러","2018-05-02","21",4084,9262,0
"9747","레슬러","2018-05-03","15",1898,11160,0
"9748","레슬러","2018-05-04","7",2124,13284,0
"9749","레슬러","2018-05-06","151",19414,32698,0
"9750","레슬러","2018-05-07","156",18959,51657,0
"9751","레슬러","2018-05-08","16",1951,53608,0
"9752","레슬러","2018-05-09","878",63660,117268,1
"9753","레슬러","2018-05-10","881",53923,171191,2
"9754","레슬러","2018-05-11","902",69096,240287,3
"9755","레슬러","2018-05-12","957",163425,403712,4
"9756","레슬러","2018-05-13","947",133059,536771,5
"9757","레슬러","2018-05-14","878",32344,569115,6
"9758","레슬러","2018-05-15","923",38090,607205,7
"9759","레슬러","2018-05-16","637",20525,627730,8
"9760","레슬러","2018-05-17","528",18316,646046,9
"9761","레슬러","2018-05-18","552",21948,667994,10
"9762","레슬러","2018-05-19","541",29488,697482,11
"9763","레슬러","2018-05-20","539",27045,724527,12
"9764","레슬러","2018-05-21","539",21710,746237,13
"9765","레슬러","2018-05-22","235",7633,753870,14
"9766","레슬러","2018-05-23","179",1802,755672,15
"9767","레슬러","2018-05-24","158",5058,760730,16
"9768","레슬러","2018-05-25","148",1573,762303,17
"9769","레슬러","2018-05-26","117",1884,764187,18
"9770","레슬러","2018-05-27","111",1549,765736,19
"9771","레슬러","2018-05-28","87",569,766305,20
"9772","레슬러","2018-05-29","103",1063,767368,21
"9773","레슬러","2018-05-30","28",756,768124,22
"9774","레슬러","2018-05-31","19",455,768579,23
"9775","레슬러","2018-06-01","14",59,768638,24
"9776","레슬러","2018-06-02","11",117,768755,25
"9777","레슬러","2018-06-03","14",301,769056,26
"9778","레슬러","2018-06-04","10",43,769099,27
"9779","레슬러","2018-06-05","11",46,769145,28
"9780","레슬러","2018-06-06","5",21,769166,29
"9781","레슬러","2018-06-07","5",174,769340,30
"9782","레슬러","2018-06-08","4",25,769365,31
"9783","레슬러","2018-06-09","2",4,769369,32
"9784","레슬러","2018-06-10","1",2,769371,33
"9785","레슬러","2018-06-11","3",196,769567,34
"9786","레슬러","2018-06-12","7",375,769942,35
"9787","레슬러","2018-06-14","4",120,770062,36
"9788","레슬러","2018-06-15","6",269,770331,37
"9789","레슬러","2018-06-16","5",150,770481,38
"9790","레슬러","2018-06-17","5",150,770631,39
"9791","레슬러","2018-06-18","4",120,770751,40
"9792","레슬러","2018-06-20","1",220,770971,41
"9793","레슬러","2018-06-21","1",20,770991,42
"9794","레슬러","2018-07-04","1",0,770991,43
"9795","레슬러","2018-07-06","1",0,770991,44
"9796","레슬러","2018-07-26","1",150,771141,45
"9797","상류사회","2018-08-16","1",262,262,0
"9798","상류사회","2018-08-21","4",929,1191,0
"9799","상류사회","2018-08-23","1",160,1351,0
"9800","상류사회","2018-08-24","1",436,1787,0
"9801","상류사회","2018-08-27","6",1501,3288,0
"9802","상류사회","2018-08-29","867",131795,135083,1
"9803","상류사회","2018-08-30","820",82912,217995,2
"9804","상류사회","2018-08-31","841",89069,307064,3
"9805","상류사회","2018-09-01","797",99858,406922,4
"9806","상류사회","2018-09-02","773",101729,508651,5
"9807","상류사회","2018-09-03","736",41450,550101,6
"9808","상류사회","2018-09-04","726",34856,584957,7
"9809","상류사회","2018-09-05","688",26714,611671,8
"9810","상류사회","2018-09-06","562",20053,631724,9
"9811","상류사회","2018-09-07","565",22159,653883,10
"9812","상류사회","2018-09-08","573",32703,686586,11
"9813","상류사회","2018-09-09","561",30701,717287,12
"9814","상류사회","2018-09-10","522",11682,728969,13
"9815","상류사회","2018-09-11","521",10587,739556,14
"9816","상류사회","2018-09-12","338",3708,743264,15
"9817","상류사회","2018-09-13","335",3511,746775,16
"9818","상류사회","2018-09-14","332",4155,750930,17
"9819","상류사회","2018-09-15","310",5357,756287,18
"9820","상류사회","2018-09-16","301",4658,760945,19
"9821","상류사회","2018-09-17","298",2342,763287,20
"9822","상류사회","2018-09-18","310",2091,765378,21
"9823","상류사회","2018-09-19","2",24,765402,22
"9824","상류사회","2018-09-20","2",35,765437,23
"9825","상류사회","2018-09-21","2",37,765474,24
"9826","상류사회","2018-09-22","2",61,765535,25
"9827","상류사회","2018-09-23","3",62,765597,26
"9828","상류사회","2018-09-24","2",27,765624,27
"9829","상류사회","2018-09-25","2",88,765712,28
"9830","상류사회","2018-09-26","2",45,765757,29
"9831","상류사회","2018-09-27","1",21,765778,30
"9832","상류사회","2018-09-28","1",12,765790,31
"9833","상류사회","2018-09-29","1",13,765803,32
"9834","상류사회","2018-09-30","1",7,765810,33
"9835","상류사회","2018-10-01","21",285,766095,34
"9836","상류사회","2018-10-02","8",661,766756,35
"9837","상류사회","2018-10-03","7",97,766853,36
"9838","상류사회","2018-10-04","5",67,766920,37
"9839","상류사회","2018-10-05","6",70,766990,38
"9840","상류사회","2018-10-06","5",74,767064,39
"9841","상류사회","2018-10-07","6",61,767125,40
"9842","상류사회","2018-10-08","5",66,767191,41
"9843","상류사회","2018-10-09","5",66,767257,42
"9844","상류사회","2018-10-10","5",70,767327,43
"9845","상류사회","2018-10-11","5",62,767389,44
"9846","상류사회","2018-10-12","5",64,767453,45
"9847","상류사회","2018-10-13","5",71,767524,46
"9848","상류사회","2018-10-14","5",65,767589,47
"9849","상류사회","2018-10-15","5",66,767655,48
"9850","상류사회","2018-10-16","5",60,767715,49
"9851","상류사회","2018-10-30","1",242,767957,50
"9852","상류사회","2018-10-31","1",242,768199,51
"9853","상류사회","2018-11-01","1",243,768442,52
"9854","물괴","2018-08-31","1",208,208,0
"9855","물괴","2018-09-03","4",862,1070,0
"9856","물괴","2018-09-04","1",189,1259,0
"9857","물괴","2018-09-10","18",3785,5044,0
"9858","물괴","2018-09-11","27",2393,7437,0
"9859","물괴","2018-09-12","1,183",105255,112692,1
"9860","물괴","2018-09-13","1,151",79106,191798,2
"9861","물괴","2018-09-14","1,163",93286,285084,3
"9862","물괴","2018-09-15","1,108",177848,462932,4
"9863","물괴","2018-09-16","1,095",150958,613890,5
"9864","물괴","2018-09-17","1,034",37928,651818,6
"9865","물괴","2018-09-18","1,043",30590,682408,7
"9866","물괴","2018-09-19","341",3083,685491,8
"9867","물괴","2018-09-20","316",2784,688275,9
"9868","물괴","2018-09-21","290",2916,691191,10
"9869","물괴","2018-09-22","265",5778,696969,11
"9870","물괴","2018-09-23","252",5127,702096,12
"9871","물괴","2018-09-24","212",4584,706680,13
"9872","물괴","2018-09-25","212",5031,711711,14
"9873","물괴","2018-09-26","145",3169,714880,15
"9874","물괴","2018-09-27","110",2617,717497,16
"9875","물괴","2018-09-28","90",575,718072,17
"9876","물괴","2018-09-29","82",974,719046,18
"9877","물괴","2018-09-30","83",922,719968,19
"9878","물괴","2018-10-01","58",269,720237,20
"9879","물괴","2018-10-02","66",462,720699,21
"9880","물괴","2018-10-03","3",22,720721,22
"9881","물괴","2018-10-08","2",3,720724,23
"9882","물괴","2018-10-09","2",6,720730,24
"9883","물괴","2018-10-10","2",3,720733,25
"9884","물괴","2018-10-12","1",1,720734,26
"9885","물괴","2018-10-13","2",4,720738,27
"9886","물괴","2018-10-14","1",2,720740,28
"9887","물괴","2018-10-15","1",35,720775,29
"9888","물괴","2018-10-16","21",555,721330,30
"9889","물괴","2018-10-17","7",383,721713,31
"9890","물괴","2018-10-18","18",701,722414,32
"9891","물괴","2018-10-19","1",24,722438,33
"9892","물괴","2018-10-20","5",48,722486,34
"9893","물괴","2018-10-22","6",129,722615,35
"9894","물괴","2018-10-23","2",37,722652,36
"9895","물괴","2018-10-24","1",17,722669,37
"9896","물괴","2018-10-30","1",318,722987,38
"9897","물괴","2018-10-31","1",318,723305,39
"9898","물괴","2018-11-01","1",317,723622,40
"9899","미쓰백","2018-09-11","1",786,786,0
"9900","미쓰백","2018-09-13","1",247,1033,0
"9901","미쓰백","2018-09-27","3",683,1716,0
"9902","미쓰백","2018-09-28","1",174,1890,0
"9903","미쓰백","2018-10-01","6",1239,3129,0
"9904","미쓰백","2018-10-02","8",1806,4935,0
"9905","미쓰백","2018-10-04","6",1426,6361,0
"9906","미쓰백","2018-10-05","2",506,6867,0
"9907","미쓰백","2018-10-06","3",529,7396,0
"9908","미쓰백","2018-10-07","7",1161,8557,0
"9909","미쓰백","2018-10-08","4",1225,9782,0
"9910","미쓰백","2018-10-10","6",650,10432,0
"9911","미쓰백","2018-10-11","547",21887,32319,1
"9912","미쓰백","2018-10-12","582",34098,66417,2
"9913","미쓰백","2018-10-13","624",60163,126580,3
"9914","미쓰백","2018-10-14","618",67207,193787,4
"9915","미쓰백","2018-10-15","600",32491,226278,5
"9916","미쓰백","2018-10-16","638",29266,255544,6
"9917","미쓰백","2018-10-17","634",31884,287428,7
"9918","미쓰백","2018-10-18","587",21416,308844,8
"9919","미쓰백","2018-10-19","632",31840,340684,9
"9920","미쓰백","2018-10-20","663",57441,398125,10
"9921","미쓰백","2018-10-21","671",54453,452578,11
"9922","미쓰백","2018-10-22","636",22297,474875,12
"9923","미쓰백","2018-10-23","655",23343,498218,13
"9924","미쓰백","2018-10-24","666",28354,526572,14
"9925","미쓰백","2018-10-25","501",17095,543667,15
"9926","미쓰백","2018-10-26","553",25051,568718,16
"9927","미쓰백","2018-10-27","568",36587,605305,17
"9928","미쓰백","2018-10-28","559",35622,640927,18
"9929","미쓰백","2018-10-29","536",17380,658307,19
"9930","미쓰백","2018-10-30","532",18633,676940,20
"9931","미쓰백","2018-10-31","264",8644,685584,21
"9932","미쓰백","2018-11-01","267",4972,690556,22
"9933","미쓰백","2018-11-02","271",8118,698674,23
"9934","미쓰백","2018-11-03","244",6481,705155,24
"9935","미쓰백","2018-11-04","244",5625,710780,25
"9936","미쓰백","2018-11-05","236",2474,713254,26
"9937","미쓰백","2018-11-06","240",1940,715194,27
"9938","미쓰백","2018-11-07","112",1220,716414,28
"9939","미쓰백","2018-11-08","75",851,717265,29
"9940","미쓰백","2018-11-09","76",1129,718394,30
"9941","미쓰백","2018-11-10","61",803,719197,31
"9942","미쓰백","2018-11-11","56",760,719957,32
"9943","미쓰백","2018-11-12","59",319,720276,33
"9944","미쓰백","2018-11-13","60",356,720632,34
"9945","미쓰백","2018-11-14","7",66,720698,35
"9946","미쓰백","2018-11-15","7",258,720956,36
"9947","미쓰백","2018-11-16","6",87,721043,37
"9948","미쓰백","2018-11-17","6",112,721155,38
"9949","미쓰백","2018-11-18","4",28,721183,39
"9950","미쓰백","2018-11-19","7",21,721204,40
"9951","미쓰백","2018-11-20","8",41,721245,41
"9952","미쓰백","2018-11-21","5",25,721270,42
"9953","미쓰백","2018-11-22","1",251,721521,43
"9954","미쓰백","2018-11-23","2",85,721606,44
"9955","미쓰백","2018-11-24","2",27,721633,45
"9956","미쓰백","2018-11-25","2",15,721648,46
"9957","미쓰백","2018-11-26","2",14,721662,47
"9958","미쓰백","2018-11-27","4",65,721727,48
"9959","미쓰백","2018-11-28","3",24,721751,49
"9960","미쓰백","2018-11-29","3",81,721832,50
"9961","미쓰백","2018-11-30","2",6,721838,51
"9962","미쓰백","2018-12-01","2",8,721846,52
"9963","미쓰백","2018-12-02","2",5,721851,53
"9964","미쓰백","2018-12-03","1",150,722001,54
"9965","미쓰백","2018-12-04","1",3,722004,55
"9966","미쓰백","2018-12-08","1",151,722155,56
"9967","미쓰백","2018-12-16","1",19,722174,57
"9968","미쓰백","2018-12-18","1",8,722182,58
"9969","미쓰백","2019-01-15","2",104,722286,59
"9970","미쓰백","2019-02-10","1",162,722448,60
"9971","미쓰백","2019-03-17","1",112,722560,61
"9972","신비아파트: 금빛 도깨비와 비밀의 동굴","2018-07-16","8",1462,1462,0
"9973","신비아파트: 금빛 도깨비와 비밀의 동굴","2018-07-18","1",172,1634,0
"9974","신비아파트: 금빛 도깨비와 비밀의 동굴","2018-07-24","2",200,1834,0
"9975","신비아파트: 금빛 도깨비와 비밀의 동굴","2018-07-25","559",36633,38467,1
"9976","신비아파트: 금빛 도깨비와 비밀의 동굴","2018-07-26","587",37938,76405,2
"9977","신비아파트: 금빛 도깨비와 비밀의 동굴","2018-07-27","650",43498,119903,3
"9978","신비아파트: 금빛 도깨비와 비밀의 동굴","2018-07-28","733",104068,223971,4
"9979","신비아파트: 금빛 도깨비와 비밀의 동굴","2018-07-29","762",94962,318933,5
"9980","신비아파트: 금빛 도깨비와 비밀의 동굴","2018-07-30","682",65555,384488,6
"9981","신비아파트: 금빛 도깨비와 비밀의 동굴","2018-07-31","693",60997,445485,7
"9982","신비아파트: 금빛 도깨비와 비밀의 동굴","2018-08-01","490",39482,484967,8
"9983","신비아파트: 금빛 도깨비와 비밀의 동굴","2018-08-02","477",37195,522162,9
"9984","신비아파트: 금빛 도깨비와 비밀의 동굴","2018-08-03","467",31721,553883,10
"9985","신비아파트: 금빛 도깨비와 비밀의 동굴","2018-08-04","460",34386,588269,11
"9986","신비아파트: 금빛 도깨비와 비밀의 동굴","2018-08-05","469",33691,621960,12
"9987","신비아파트: 금빛 도깨비와 비밀의 동굴","2018-08-06","443",14897,636857,13
"9988","신비아파트: 금빛 도깨비와 비밀의 동굴","2018-08-07","452",16225,653082,14
"9989","신비아파트: 금빛 도깨비와 비밀의 동굴","2018-08-08","74",1910,654992,15
"9990","신비아파트: 금빛 도깨비와 비밀의 동굴","2018-08-09","67",1519,656511,16
"9991","신비아파트: 금빛 도깨비와 비밀의 동굴","2018-08-10","72",1543,658054,17
"9992","신비아파트: 금빛 도깨비와 비밀의 동굴","2018-08-11","98",4727,662781,18
"9993","신비아파트: 금빛 도깨비와 비밀의 동굴","2018-08-12","97",5098,667879,19
"9994","신비아파트: 금빛 도깨비와 비밀의 동굴","2018-08-13","68",1224,669103,20
"9995","신비아파트: 금빛 도깨비와 비밀의 동굴","2018-08-14","69",1490,670593,21
"9996","신비아파트: 금빛 도깨비와 비밀의 동굴","2018-08-15","46",2871,673464,22
"9997","신비아파트: 금빛 도깨비와 비밀의 동굴","2018-08-16","24",509,673973,23
"9998","신비아파트: 금빛 도깨비와 비밀의 동굴","2018-08-17","24",403,674376,24
"9999","신비아파트: 금빛 도깨비와 비밀의 동굴","2018-08-18","39",1099,675475,25
"10000","신비아파트: 금빛 도깨비와 비밀의 동굴","2018-08-19","37",1022,676497,26
"10001","신비아파트: 금빛 도깨비와 비밀의 동굴","2018-08-20","21",175,676672,27
"10002","신비아파트: 금빛 도깨비와 비밀의 동굴","2018-08-21","21",191,676863,28
"10003","신비아파트: 금빛 도깨비와 비밀의 동굴","2018-08-22","9",161,677024,29
"10004","신비아파트: 금빛 도깨비와 비밀의 동굴","2018-08-23","3",28,677052,30
"10005","신비아파트: 금빛 도깨비와 비밀의 동굴","2018-08-24","4",54,677106,31
"10006","신비아파트: 금빛 도깨비와 비밀의 동굴","2018-08-25","7",159,677265,32
"10007","신비아파트: 금빛 도깨비와 비밀의 동굴","2018-08-26","7",227,677492,33
"10008","신비아파트: 금빛 도깨비와 비밀의 동굴","2018-08-27","3",7,677499,34
"10009","신비아파트: 금빛 도깨비와 비밀의 동굴","2018-08-28","3",42,677541,35
"10010","신비아파트: 금빛 도깨비와 비밀의 동굴","2018-08-29","4",23,677564,36
"10011","신비아파트: 금빛 도깨비와 비밀의 동굴","2018-08-30","3",39,677603,37
"10012","신비아파트: 금빛 도깨비와 비밀의 동굴","2018-08-31","3",45,677648,38
"10013","신비아파트: 금빛 도깨비와 비밀의 동굴","2018-09-01","4",47,677695,39
"10014","신비아파트: 금빛 도깨비와 비밀의 동굴","2018-09-02","6",93,677788,40
"10015","신비아파트: 금빛 도깨비와 비밀의 동굴","2018-09-05","1",2,677790,41
"10016","신비아파트: 금빛 도깨비와 비밀의 동굴","2018-09-06","1",4,677794,42
"10017","신비아파트: 금빛 도깨비와 비밀의 동굴","2018-09-08","4",32,677826,43
"10018","신비아파트: 금빛 도깨비와 비밀의 동굴","2018-09-09","7",65,677891,44
"10019","신비아파트: 금빛 도깨비와 비밀의 동굴","2018-09-10","1",0,677891,45
"10020","신비아파트: 금빛 도깨비와 비밀의 동굴","2018-09-11","1",2,677893,46
"10021","신비아파트: 금빛 도깨비와 비밀의 동굴","2018-09-12","1",4,677897,47
"10022","신비아파트: 금빛 도깨비와 비밀의 동굴","2018-09-15","1",2,677899,48
"10023","신비아파트: 금빛 도깨비와 비밀의 동굴","2018-09-16","1",12,677911,49
"10024","신비아파트: 금빛 도깨비와 비밀의 동굴","2018-09-19","1",1,677912,50
"10025","신비아파트: 금빛 도깨비와 비밀의 동굴","2018-09-27","1",4,677916,51
"10026","신비아파트: 금빛 도깨비와 비밀의 동굴","2018-09-29","1",7,677923,52
"10027","신비아파트: 금빛 도깨비와 비밀의 동굴","2018-09-30","1",16,677939,53
"10028","신비아파트: 금빛 도깨비와 비밀의 동굴","2018-10-02","1",7,677946,54
"10029","신비아파트: 금빛 도깨비와 비밀의 동굴","2018-10-03","1",12,677958,55
"10030","신비아파트: 금빛 도깨비와 비밀의 동굴","2018-10-13","1",3,677961,56
"10031","신비아파트: 금빛 도깨비와 비밀의 동굴","2018-10-20","1",12,677973,57
"10032","신비아파트: 금빛 도깨비와 비밀의 동굴","2018-10-21","1",11,677984,58
"10033","신비아파트: 금빛 도깨비와 비밀의 동굴","2018-10-22","2",3,677987,59
"10034","신비아파트: 금빛 도깨비와 비밀의 동굴","2018-10-24","1",2,677989,60
"10035","신비아파트: 금빛 도깨비와 비밀의 동굴","2018-10-25","1",3,677992,61
"10036","신비아파트: 금빛 도깨비와 비밀의 동굴","2018-10-27","1",8,678000,62
"10037","신비아파트: 금빛 도깨비와 비밀의 동굴","2018-10-28","1",12,678012,63
"10038","신비아파트: 금빛 도깨비와 비밀의 동굴","2018-10-29","1",2,678014,64
"10039","신비아파트: 금빛 도깨비와 비밀의 동굴","2018-11-01","2",8,678022,65
"10040","신비아파트: 금빛 도깨비와 비밀의 동굴","2018-11-02","1",21,678043,66
"10041","신비아파트: 금빛 도깨비와 비밀의 동굴","2018-11-03","1",2,678045,67
"10042","신비아파트: 금빛 도깨비와 비밀의 동굴","2018-11-04","1",2,678047,68
"10043","신비아파트: 금빛 도깨비와 비밀의 동굴","2018-11-06","2",6,678053,69
"10044","신비아파트: 금빛 도깨비와 비밀의 동굴","2018-11-10","1",2,678055,70
"10045","신비아파트: 금빛 도깨비와 비밀의 동굴","2018-11-11","1",14,678069,71
"10046","신비아파트: 금빛 도깨비와 비밀의 동굴","2018-11-15","1",2,678071,72
"10047","신비아파트: 금빛 도깨비와 비밀의 동굴","2018-11-16","1",2,678073,73
"10048","신비아파트: 금빛 도깨비와 비밀의 동굴","2018-11-17","1",8,678081,74
"10049","신비아파트: 금빛 도깨비와 비밀의 동굴","2018-11-18","1",5,678086,75
"10050","신비아파트: 금빛 도깨비와 비밀의 동굴","2018-11-22","1",1,678087,76
"10051","신비아파트: 금빛 도깨비와 비밀의 동굴","2018-11-24","1",3,678090,77
"10052","신비아파트: 금빛 도깨비와 비밀의 동굴","2018-11-28","1",1,678091,78
"10053","그날, 바다","2018-03-21","1",30,30,0
"10054","그날, 바다","2018-03-30","1",8,38,0
"10055","그날, 바다","2018-04-05","1",103,141,0
"10056","그날, 바다","2018-04-06","1",58,199,0
"10057","그날, 바다","2018-04-07","1",347,546,0
"10058","그날, 바다","2018-04-11","161",7319,7865,0
"10059","그날, 바다","2018-04-12","483",24593,32458,1
"10060","그날, 바다","2018-04-13","550",31321,63779,2
"10061","그날, 바다","2018-04-14","569",59120,122899,3
"10062","그날, 바다","2018-04-15","565",55366,178265,4
"10063","그날, 바다","2018-04-16","545",33962,212227,5
"10064","그날, 바다","2018-04-17","568",23224,235451,6
"10065","그날, 바다","2018-04-18","611",22904,258355,7
"10066","그날, 바다","2018-04-19","569",18235,276590,8
"10067","그날, 바다","2018-04-20","609",24259,300849,9
"10068","그날, 바다","2018-04-21","643",41908,342757,10
"10069","그날, 바다","2018-04-22","639",43024,385781,11
"10070","그날, 바다","2018-04-23","564",16952,402733,12
"10071","그날, 바다","2018-04-24","595",16257,418990,13
"10072","그날, 바다","2018-04-25","366",11280,430270,14
"10073","그날, 바다","2018-04-26","391",7832,438102,15
"10074","그날, 바다","2018-04-27","374",9165,447267,16
"10075","그날, 바다","2018-04-28","364",14820,462087,17
"10076","그날, 바다","2018-04-29","367",14208,476295,18
"10077","그날, 바다","2018-04-30","415",9993,486288,19
"10078","그날, 바다","2018-05-01","258",9958,496246,20
"10079","그날, 바다","2018-05-02","266",4178,500424,21
"10080","그날, 바다","2018-05-03","202",2997,503421,22
"10081","그날, 바다","2018-05-04","209",4277,507698,23
"10082","그날, 바다","2018-05-05","159",5746,513444,24
"10083","그날, 바다","2018-05-06","180",6076,519520,25
"10084","그날, 바다","2018-05-07","190",5129,524649,26
"10085","그날, 바다","2018-05-08","228",1920,526569,27
"10086","그날, 바다","2018-05-09","172",1616,528185,28
"10087","그날, 바다","2018-05-10","123",1102,529287,29
"10088","그날, 바다","2018-05-11","119",1236,530523,30
"10089","그날, 바다","2018-05-12","115",2347,532870,31
"10090","그날, 바다","2018-05-13","114",1795,534665,32
"10091","그날, 바다","2018-05-14","136",792,535457,33
"10092","그날, 바다","2018-05-15","131",1088,536545,34
"10093","그날, 바다","2018-05-16","47",605,537150,35
"10094","그날, 바다","2018-05-17","15",319,537469,36
"10095","그날, 바다","2018-05-18","11",315,537784,37
"10096","그날, 바다","2018-05-19","13",328,538112,38
"10097","그날, 바다","2018-05-20","14",179,538291,39
"10098","그날, 바다","2018-05-21","11",240,538531,40
"10099","그날, 바다","2018-05-22","13",185,538716,41
"10100","그날, 바다","2018-05-23","15",307,539023,42
"10101","그날, 바다","2018-05-24","7",205,539228,43
"10102","그날, 바다","2018-05-25","8",169,539397,44
"10103","그날, 바다","2018-05-26","3",28,539425,45
"10104","그날, 바다","2018-05-27","4",43,539468,46
"10105","그날, 바다","2018-05-28","4",83,539551,47
"10106","그날, 바다","2018-05-29","5",287,539838,48
"10107","그날, 바다","2018-05-30","3",64,539902,49
"10108","그날, 바다","2018-05-31","7",251,540153,50
"10109","그날, 바다","2018-06-01","1",17,540170,51
"10110","그날, 바다","2018-06-02","2",10,540180,52
"10111","그날, 바다","2018-06-03","2",9,540189,53
"10112","그날, 바다","2018-06-04","3",78,540267,54
"10113","그날, 바다","2018-06-05","3",51,540318,55
"10114","그날, 바다","2018-06-06","2",19,540337,56
"10115","그날, 바다","2018-06-07","2",3,540340,57
"10116","그날, 바다","2018-06-08","1",1,540341,58
"10117","그날, 바다","2018-06-09","2",10,540351,59
"10118","그날, 바다","2018-06-10","2",17,540368,60
"10119","그날, 바다","2018-06-11","1",2,540370,61
"10120","그날, 바다","2018-06-12","2",8,540378,62
"10121","그날, 바다","2018-06-13","3",22,540400,63
"10122","그날, 바다","2018-06-15","2",8,540408,64
"10123","그날, 바다","2018-06-16","2",2,540410,65
"10124","그날, 바다","2018-06-17","2",10,540420,66
"10125","그날, 바다","2018-06-18","2",6,540426,67
"10126","그날, 바다","2018-06-19","1",1,540427,68
"10127","그날, 바다","2018-06-20","2",14,540441,69
"10128","그날, 바다","2018-06-21","1",1,540442,70
"10129","그날, 바다","2018-06-27","1",7,540449,71
"10130","그날, 바다","2018-06-28","1",147,540596,72
"10131","그날, 바다","2018-11-01","1",35,540631,73
"10132","버닝","2018-05-14","9",3100,3100,0
"10133","버닝","2018-05-16","1",1,3101,0
"10134","버닝","2018-05-17","728",54088,57189,1
"10135","버닝","2018-05-18","739",60958,118147,2
"10136","버닝","2018-05-19","705",85021,203168,3
"10137","버닝","2018-05-20","707",74723,277891,4
"10138","버닝","2018-05-21","703",51397,329288,5
"10139","버닝","2018-05-22","546",42336,371624,6
"10140","버닝","2018-05-23","537",16417,388041,7
"10141","버닝","2018-05-24","456",11934,399975,8
"10142","버닝","2018-05-25","469",13680,413655,9
"10143","버닝","2018-05-26","431",18629,432284,10
"10144","버닝","2018-05-27","417",16568,448852,11
"10145","버닝","2018-05-28","435",8382,457234,12
"10146","버닝","2018-05-29","428",9295,466529,13
"10147","버닝","2018-05-30","282",9001,475530,14
"10148","버닝","2018-05-31","269",8589,484119,15
"10149","버닝","2018-06-01","280",5130,489249,16
"10150","버닝","2018-06-02","259",8056,497305,17
"10151","버닝","2018-06-03","245",6488,503793,18
"10152","버닝","2018-06-04","260",3363,507156,19
"10153","버닝","2018-06-05","270",4531,511687,20
"10154","버닝","2018-06-06","78",3326,515013,21
"10155","버닝","2018-06-07","84",1289,516302,22
"10156","버닝","2018-06-08","82",1411,517713,23
"10157","버닝","2018-06-09","61",2126,519839,24
"10158","버닝","2018-06-10","55",1831,521670,25
"10159","버닝","2018-06-11","72",895,522565,26
"10160","버닝","2018-06-12","74",1153,523718,27
"10161","버닝","2018-06-13","32",1324,525042,28
"10162","버닝","2018-06-14","29",390,525432,29
"10163","버닝","2018-06-15","30",614,526046,30
"10164","버닝","2018-06-16","31",599,526645,31
"10165","버닝","2018-06-17","27",500,527145,32
"10166","버닝","2018-06-18","17",94,527239,33
"10167","버닝","2018-06-19","15",100,527339,34
"10168","버닝","2018-06-20","15",181,527520,35
"10169","버닝","2018-06-21","6",32,527552,36
"10170","버닝","2018-06-22","6",45,527597,37
"10171","버닝","2018-06-23","5",61,527658,38
"10172","버닝","2018-06-24","5",50,527708,39
"10173","버닝","2018-06-25","6",33,527741,40
"10174","버닝","2018-06-26","6",56,527797,41
"10175","버닝","2018-06-27","4",91,527888,42
"10176","버닝","2018-06-28","3",17,527905,43
"10177","버닝","2018-06-29","4",43,527948,44
"10178","버닝","2018-06-30","3",31,527979,45
"10179","버닝","2018-07-01","1",4,527983,46
"10180","버닝","2018-07-02","3",17,528000,47
"10181","버닝","2018-07-03","2",18,528018,48
"10182","버닝","2018-07-04","2",29,528047,49
"10183","버닝","2018-07-05","1",5,528052,50
"10184","버닝","2018-07-06","1",2,528054,51
"10185","버닝","2018-07-08","1",8,528062,52
"10186","버닝","2018-07-09","1",6,528068,53
"10187","버닝","2018-07-10","2",16,528084,54
"10188","버닝","2018-07-11","2",32,528116,55
"10189","버닝","2018-07-13","1",2,528118,56
"10190","버닝","2018-07-14","1",5,528123,57
"10191","버닝","2018-07-16","1",6,528129,58
"10192","버닝","2018-07-17","1",11,528140,59
"10193","버닝","2018-07-18","1",2,528142,60
"10194","버닝","2018-07-19","1",1,528143,61
"10195","버닝","2018-07-21","1",3,528146,62
"10196","버닝","2018-07-22","1",3,528149,63
"10197","버닝","2018-07-23","1",1,528150,64
"10198","버닝","2018-07-25","1",2,528152,65
"10199","버닝","2018-07-26","1",1,528153,66
"10200","버닝","2018-09-11","1",15,528168,67
"10201","버닝","2018-11-14","1",0,528168,68
"10202","버닝","2018-12-01","1",204,528372,69
"10203","버닝","2018-12-13","2",22,528394,70
"10204","버닝","2018-12-16","2",20,528414,71
"10205","버닝","2018-12-17","1",1,528415,72
"10206","버닝","2018-12-19","1",10,528425,73
"10207","버닝","2018-12-20","1",1,528426,74
"10208","버닝","2018-12-22","1",9,528435,75
"10209","7년의 밤","2018-03-19","1",194,194,0
"10210","7년의 밤","2018-03-21","5",1446,1640,0
"10211","7년의 밤","2018-03-23","15",2662,4302,0
"10212","7년의 밤","2018-03-26","10",1980,6282,0
"10213","7년의 밤","2018-03-27","19",1629,7911,0
"10214","7년의 밤","2018-03-28","872",124688,132599,1
"10215","7년의 밤","2018-03-29","836",52833,185432,2
"10216","7년의 밤","2018-03-30","812",57164,242596,3
"10217","7년의 밤","2018-03-31","725",95491,338087,4
"10218","7년의 밤","2018-04-01","705",80035,418122,5
"10219","7년의 밤","2018-04-02","608",24482,442604,6
"10220","7년의 밤","2018-04-03","639",22447,465051,7
"10221","7년의 밤","2018-04-04","582",18854,483905,8
"10222","7년의 밤","2018-04-05","443",7840,491745,9
"10223","7년의 밤","2018-04-06","439",7438,499183,10
"10224","7년의 밤","2018-04-07","366",7793,506976,11
"10225","7년의 밤","2018-04-08","338",6380,513356,12
"10226","7년의 밤","2018-04-09","330",2967,516323,13
"10227","7년의 밤","2018-04-10","329",2785,519108,14
"10228","7년의 밤","2018-04-11","309",2456,521564,15
"10229","7년의 밤","2018-04-12","23",306,521870,16
"10230","7년의 밤","2018-04-13","20",267,522137,17
"10231","7년의 밤","2018-04-14","15",228,522365,18
"10232","7년의 밤","2018-04-15","13",140,522505,19
"10233","7년의 밤","2018-04-16","13",553,523058,20
"10234","7년의 밤","2018-04-17","38",1210,524268,21
"10235","7년의 밤","2018-04-18","20",677,524945,22
"10236","7년의 밤","2018-04-19","28",783,525728,23
"10237","7년의 밤","2018-04-20","7",167,525895,24
"10238","7년의 밤","2018-04-21","12",335,526230,25
"10239","7년의 밤","2018-04-22","8",650,526880,26
"10240","7년의 밤","2018-04-23","9",705,527585,27
"10241","7년의 밤","2018-04-24","6",131,527716,28
"10242","7년의 밤","2018-04-25","4",80,527796,29
"10243","7년의 밤","2018-04-26","2",112,527908,30
"10244","7년의 밤","2018-04-27","1",39,527947,31
"10245","7년의 밤","2018-04-28","1",20,527967,32
"10246","7년의 밤","2018-04-29","1",20,527987,33
"10247","7년의 밤","2018-04-30","1",20,528007,34
"10248","변산","2018-06-04","2",928,928,0
"10249","변산","2018-06-05","1",186,1114,0
"10250","변산","2018-06-14","8",2080,3194,0
"10251","변산","2018-06-18","7",1519,4713,0
"10252","변산","2018-06-20","13",3068,7781,0
"10253","변산","2018-06-22","14",2456,10237,0
"10254","변산","2018-06-23","12",1594,11831,0
"10255","변산","2018-06-24","13",1376,13207,0
"10256","변산","2018-06-25","2",190,13397,0
"10257","변산","2018-06-26","7",1591,14988,0
"10258","변산","2018-06-27","2",263,15251,0
"10259","변산","2018-06-28","6",323,15574,0
"10260","변산","2018-06-29","1",322,15896,0
"10261","변산","2018-07-01","10",1811,17707,0
"10262","변산","2018-07-02","6",896,18603,0
"10263","변산","2018-07-03","1",211,18814,0
"10264","변산","2018-07-04","763",43149,61963,1
"10265","변산","2018-07-05","741",40456,102419,2
"10266","변산","2018-07-06","695",45057,147476,3
"10267","변산","2018-07-07","607",71371,218847,4
"10268","변산","2018-07-08","603",63352,282199,5
"10269","변산","2018-07-09","585",29258,311457,6
"10270","변산","2018-07-10","610",29622,341079,7
"10271","변산","2018-07-11","494",17607,358686,8
"10272","변산","2018-07-12","486",16013,374699,9
"10273","변산","2018-07-13","484",14741,389440,10
"10274","변산","2018-07-14","475",25708,415148,11
"10275","변산","2018-07-15","446",23343,438491,12
"10276","변산","2018-07-16","459",11089,449580,13
"10277","변산","2018-07-17","466",10658,460238,14
"10278","변산","2018-07-18","165",4589,464827,15
"10279","변산","2018-07-19","155",3237,468064,16
"10280","변산","2018-07-20","148",3587,471651,17
"10281","변산","2018-07-21","124",4259,475910,18
"10282","변산","2018-07-22","119",4346,480256,19
"10283","변산","2018-07-23","132",2731,482987,20
"10284","변산","2018-07-24","138",3012,485999,21
"10285","변산","2018-07-25","20",331,486330,22
"10286","변산","2018-07-26","24",862,487192,23
"10287","변산","2018-07-27","18",865,488057,24
"10288","변산","2018-07-28","12",380,488437,25
"10289","변산","2018-07-29","11",320,488757,26
"10290","변산","2018-07-30","13",211,488968,27
"10291","변산","2018-07-31","14",245,489213,28
"10292","변산","2018-08-01","3",63,489276,29
"10293","변산","2018-08-02","2",29,489305,30
"10294","변산","2018-08-03","3",261,489566,31
"10295","변산","2018-08-04","1",36,489602,32
"10296","변산","2018-08-05","1",17,489619,33
"10297","변산","2018-08-06","2",54,489673,34
"10298","변산","2018-08-07","2",31,489704,35
"10299","변산","2018-08-09","1",148,489852,36
"10300","변산","2018-08-13","2",132,489984,37
"10301","변산","2018-08-14","1",9,489993,38
"10302","변산","2018-08-17","1",40,490033,39
"10303","변산","2018-10-26","1",60,490093,40
"10304","변산","2018-11-06","1",198,490291,41
"10305","변산","2018-11-07","1",114,490405,42
"10306","변산","2018-11-08","1",114,490519,43
"10307","변산","2018-11-13","1",0,490519,44
"10308","동네사람들","2018-10-22","2",1080,1080,0
"10309","동네사람들","2018-10-29","5",1593,2673,0
"10310","동네사람들","2018-11-05","7",1225,3898,0
"10311","동네사람들","2018-11-06","10",833,4731,0
"10312","동네사람들","2018-11-07","666",54297,59028,1
"10313","동네사람들","2018-11-08","693",51055,110083,2
"10314","동네사람들","2018-11-09","715",53633,163716,3
"10315","동네사람들","2018-11-10","731",93877,257593,4
"10316","동네사람들","2018-11-11","717",94622,352215,5
"10317","동네사람들","2018-11-12","666",28349,380564,6
"10318","동네사람들","2018-11-13","687",25888,406452,7
"10319","동네사람들","2018-11-14","397",10320,416772,8
"10320","동네사람들","2018-11-15","336",7007,423779,9
"10321","동네사람들","2018-11-16","324",7070,430849,10
"10322","동네사람들","2018-11-17","281",7805,438654,11
"10323","동네사람들","2018-11-18","278",6971,445625,12
"10324","동네사람들","2018-11-19","286",4824,450449,13
"10325","동네사람들","2018-11-20","267",4147,454596,14
"10326","동네사람들","2018-11-21","231",3969,458565,15
"10327","동네사람들","2018-11-22","29",196,458761,16
"10328","동네사람들","2018-11-23","28",694,459455,17
"10329","동네사람들","2018-11-24","23",237,459692,18
"10330","동네사람들","2018-11-25","23",226,459918,19
"10331","동네사람들","2018-11-26","21",75,459993,20
"10332","동네사람들","2018-11-27","20",118,460111,21
"10333","동네사람들","2018-11-28","4",12,460123,22
"10334","동네사람들","2018-11-29","4",77,460200,23
"10335","동네사람들","2018-12-01","1",5,460205,24
"10336","동네사람들","2018-12-03","1",2,460207,25
"10337","동네사람들","2018-12-04","1",169,460376,26
"10338","동네사람들","2018-12-07","1",4,460380,27
"10339","동네사람들","2018-12-13","2",59,460439,28
"10340","동네사람들","2018-12-14","3",984,461423,29
"10341","동네사람들","2018-12-17","2",71,461494,30
"10342","동네사람들","2018-12-18","3",111,461605,31
"10343","동네사람들","2018-12-20","2",88,461693,32
"10344","원더풀 고스트","2018-09-18","7",2613,2613,0
"10345","원더풀 고스트","2018-09-19","2",194,2807,0
"10346","원더풀 고스트","2018-09-20","12",1958,4765,0
"10347","원더풀 고스트","2018-09-23","5",1553,6318,0
"10348","원더풀 고스트","2018-09-26","351",163644,169962,1
"10349","원더풀 고스트","2018-09-27","344",35733,205695,2
"10350","원더풀 고스트","2018-09-28","349",36922,242617,3
"10351","원더풀 고스트","2018-09-29","343",73455,316072,4
"10352","원더풀 고스트","2018-09-30","330",61671,377743,5
"10353","원더풀 고스트","2018-10-01","320",16218,393961,6
"10354","원더풀 고스트","2018-10-02","324",19263,413224,7
"10355","원더풀 고스트","2018-10-03","184",11667,424891,8
"10356","원더풀 고스트","2018-10-04","180",2917,427808,9
"10357","원더풀 고스트","2018-10-05","165",3829,431637,10
"10358","원더풀 고스트","2018-10-06","131",4333,435970,11
"10359","원더풀 고스트","2018-10-07","132",3940,439910,12
"10360","원더풀 고스트","2018-10-08","129",3211,443121,13
"10361","원더풀 고스트","2018-10-09","18",651,443772,14
"10362","원더풀 고스트","2018-10-10","21",407,444179,15
"10363","원더풀 고스트","2018-10-11","14",773,444952,16
"10364","원더풀 고스트","2018-10-12","15",869,445821,17
"10365","원더풀 고스트","2018-10-13","17",419,446240,18
"10366","원더풀 고스트","2018-10-14","16",323,446563,19
"10367","원더풀 고스트","2018-10-15","17",339,446902,20
"10368","원더풀 고스트","2018-10-16","19",391,447293,21
"10369","원더풀 고스트","2018-10-17","18",190,447483,22
"10370","원더풀 고스트","2018-10-18","4",334,447817,23
"10371","원더풀 고스트","2018-10-19","4",50,447867,24
"10372","원더풀 고스트","2018-10-20","9",406,448273,25
"10373","원더풀 고스트","2018-10-21","6",43,448316,26
"10374","원더풀 고스트","2018-10-22","6",192,448508,27
"10375","원더풀 고스트","2018-10-23","8",409,448917,28
"10376","원더풀 고스트","2018-10-24","5",229,449146,29
"10377","원더풀 고스트","2018-10-25","2",322,449468,30
"10378","원더풀 고스트","2018-10-26","2",3,449471,31
"10379","원더풀 고스트","2018-10-27","1",2,449473,32
"10380","원더풀 고스트","2018-10-28","2",2,449475,33
"10381","원더풀 고스트","2018-10-29","1",5,449480,34
"10382","원더풀 고스트","2018-10-31","2",388,449868,35
"10383","원더풀 고스트","2018-11-02","1",4,449872,36
"10384","원더풀 고스트","2018-11-03","1",4,449876,37
"10385","원더풀 고스트","2018-11-04","1",4,449880,38
"10386","원더풀 고스트","2018-11-07","1",118,449998,39
"10387","원더풀 고스트","2018-11-09","2",108,450106,40
"10388","원더풀 고스트","2018-11-17","1",84,450190,41
"10389","원더풀 고스트","2018-12-04","1",184,450374,42
"10390","원더풀 고스트","2019-01-09","1",4,450378,43
"10470","흥부: 글로 세상을 바꾼 자","2018-02-01","1",262,262,0
"10471","흥부: 글로 세상을 바꾼 자","2018-02-05","4",977,1239,0
"10472","흥부: 글로 세상을 바꾼 자","2018-02-09","1",342,1581,0
"10473","흥부: 글로 세상을 바꾼 자","2018-02-12","8",2269,3850,0
"10474","흥부: 글로 세상을 바꾼 자","2018-02-14","557",43694,47544,1
"10475","흥부: 글로 세상을 바꾼 자","2018-02-15","579",62908,110452,2
"10476","흥부: 글로 세상을 바꾼 자","2018-02-16","568",80692,191144,3
"10477","흥부: 글로 세상을 바꾼 자","2018-02-17","627",79863,271007,4
"10478","흥부: 글로 세상을 바꾼 자","2018-02-18","597",51325,322332,5
"10479","흥부: 글로 세상을 바꾼 자","2018-02-19","538",20038,342370,6
"10480","흥부: 글로 세상을 바꾼 자","2018-02-20","540",16983,359353,7
"10481","흥부: 글로 세상을 바꾼 자","2018-02-21","491",11916,371269,8
"10482","흥부: 글로 세상을 바꾼 자","2018-02-22","394",7630,378899,9
"10483","흥부: 글로 세상을 바꾼 자","2018-02-23","391",8045,386944,10
"10484","흥부: 글로 세상을 바꾼 자","2018-02-24","376",9775,396719,11
"10485","흥부: 글로 세상을 바꾼 자","2018-02-25","336",7930,404649,12
"10486","흥부: 글로 세상을 바꾼 자","2018-02-26","324",3871,408520,13
"10487","흥부: 글로 세상을 바꾼 자","2018-02-27","327",4175,412695,14
"10488","흥부: 글로 세상을 바꾼 자","2018-02-28","37",820,413515,15
"10489","흥부: 글로 세상을 바꾼 자","2018-03-01","16",255,413770,16
"10490","흥부: 글로 세상을 바꾼 자","2018-03-02","12",125,413895,17
"10491","흥부: 글로 세상을 바꾼 자","2018-03-03","13",186,414081,18
"10492","흥부: 글로 세상을 바꾼 자","2018-03-04","16",224,414305,19
"10493","흥부: 글로 세상을 바꾼 자","2018-03-05","13",116,414421,20
"10494","흥부: 글로 세상을 바꾼 자","2018-03-06","20",517,414938,21
"10495","흥부: 글로 세상을 바꾼 자","2018-03-07","13",464,415402,22
"10496","흥부: 글로 세상을 바꾼 자","2018-03-08","11",452,415854,23
"10497","흥부: 글로 세상을 바꾼 자","2018-03-09","6",77,415931,24
"10498","흥부: 글로 세상을 바꾼 자","2018-03-10","7",98,416029,25
"10499","흥부: 글로 세상을 바꾼 자","2018-03-11","6",108,416137,26
"10500","흥부: 글로 세상을 바꾼 자","2018-03-12","5",75,416212,27
"10501","흥부: 글로 세상을 바꾼 자","2018-03-13","6",91,416303,28
"10502","점박이 한반도의 공룡2 : 새로운 낙원","2018-12-10","1",200,200,0
"10503","점박이 한반도의 공룡2 : 새로운 낙원","2018-12-12","1",200,400,0
"10504","점박이 한반도의 공룡2 : 새로운 낙원","2018-12-13","2",334,734,0
"10505","점박이 한반도의 공룡2 : 새로운 낙원","2018-12-14","4",898,1632,0
"10506","점박이 한반도의 공룡2 : 새로운 낙원","2018-12-15","1",123,1755,0
"10507","점박이 한반도의 공룡2 : 새로운 낙원","2018-12-19","1",196,1951,0
"10508","점박이 한반도의 공룡2 : 새로운 낙원","2018-12-20","9",2525,4476,0
"10509","점박이 한반도의 공룡2 : 새로운 낙원","2018-12-21","3",624,5100,0
"10510","점박이 한반도의 공룡2 : 새로운 낙원","2018-12-22","8",1291,6391,0
"10511","점박이 한반도의 공룡2 : 새로운 낙원","2018-12-23","1",125,6516,0
"10512","점박이 한반도의 공룡2 : 새로운 낙원","2018-12-25","672",154579,161095,1
"10513","점박이 한반도의 공룡2 : 새로운 낙원","2018-12-26","413",15460,176555,2
"10514","점박이 한반도의 공룡2 : 새로운 낙원","2018-12-27","471",18039,194594,3
"10515","점박이 한반도의 공룡2 : 새로운 낙원","2018-12-28","514",20896,215490,4
"10516","점박이 한반도의 공룡2 : 새로운 낙원","2018-12-29","610",60502,275992,5
"10517","점박이 한반도의 공룡2 : 새로운 낙원","2018-12-30","623",57634,333626,6
"10518","점박이 한반도의 공룡2 : 새로운 낙원","2018-12-31","553",41686,375312,7
"10519","점박이 한반도의 공룡2 : 새로운 낙원","2019-01-01","581",60574,435886,8
"10520","점박이 한반도의 공룡2 : 새로운 낙원","2019-01-02","501",21225,457111,9
"10521","점박이 한반도의 공룡2 : 새로운 낙원","2019-01-03","369",13291,470402,10
"10522","점박이 한반도의 공룡2 : 새로운 낙원","2019-01-04","375",11503,481905,11
"10523","점박이 한반도의 공룡2 : 새로운 낙원","2019-01-05","413",19798,501703,12
"10524","점박이 한반도의 공룡2 : 새로운 낙원","2019-01-06","409",19350,521053,13
"10525","점박이 한반도의 공룡2 : 새로운 낙원","2019-01-07","352",5820,526873,14
"10526","점박이 한반도의 공룡2 : 새로운 낙원","2019-01-08","355",5638,532511,15
"10527","점박이 한반도의 공룡2 : 새로운 낙원","2019-01-09","183",3155,535666,16
"10528","점박이 한반도의 공룡2 : 새로운 낙원","2019-01-10","93",1365,537031,17
"10529","점박이 한반도의 공룡2 : 새로운 낙원","2019-01-11","95",1573,538604,18
"10530","점박이 한반도의 공룡2 : 새로운 낙원","2019-01-12","94",3514,542118,19
"10531","점박이 한반도의 공룡2 : 새로운 낙원","2019-01-13","91",3671,545789,20
"10532","점박이 한반도의 공룡2 : 새로운 낙원","2019-01-14","76",764,546553,21
"10533","점박이 한반도의 공룡2 : 새로운 낙원","2019-01-15","80",962,547515,22
"10534","점박이 한반도의 공룡2 : 새로운 낙원","2019-01-16","11",238,547753,23
"10535","점박이 한반도의 공룡2 : 새로운 낙원","2019-01-17","8",75,547828,24
"10536","점박이 한반도의 공룡2 : 새로운 낙원","2019-01-18","10",259,548087,25
"10537","점박이 한반도의 공룡2 : 새로운 낙원","2019-01-19","7",276,548363,26
"10538","점박이 한반도의 공룡2 : 새로운 낙원","2019-01-20","7",298,548661,27
"10539","점박이 한반도의 공룡2 : 새로운 낙원","2019-01-21","6",49,548710,28
"10540","점박이 한반도의 공룡2 : 새로운 낙원","2019-01-22","6",71,548781,29
"10541","점박이 한반도의 공룡2 : 새로운 낙원","2019-01-23","4",187,548968,30
"10542","점박이 한반도의 공룡2 : 새로운 낙원","2019-01-24","3",30,548998,31
"10543","점박이 한반도의 공룡2 : 새로운 낙원","2019-01-25","2",28,549026,32
"10544","점박이 한반도의 공룡2 : 새로운 낙원","2019-01-26","3",54,549080,33
"10545","점박이 한반도의 공룡2 : 새로운 낙원","2019-01-27","3",51,549131,34
"10546","점박이 한반도의 공룡2 : 새로운 낙원","2019-01-28","2",78,549209,35
"10547","점박이 한반도의 공룡2 : 새로운 낙원","2019-01-30","14",209,549418,36
"10548","점박이 한반도의 공룡2 : 새로운 낙원","2019-01-31","9",224,549642,37
"10549","점박이 한반도의 공룡2 : 새로운 낙원","2019-02-01","4",4,549646,38
"10550","점박이 한반도의 공룡2 : 새로운 낙원","2019-02-02","4",4,549650,39
"10551","점박이 한반도의 공룡2 : 새로운 낙원","2019-02-03","5",10,549660,40
"10552","점박이 한반도의 공룡2 : 새로운 낙원","2019-02-04","4",4,549664,41
"10553","점박이 한반도의 공룡2 : 새로운 낙원","2019-02-05","3",3,549667,42
"10554","점박이 한반도의 공룡2 : 새로운 낙원","2019-02-06","4",4,549671,43
"10555","점박이 한반도의 공룡2 : 새로운 낙원","2019-02-07","4",4,549675,44
"10556","점박이 한반도의 공룡2 : 새로운 낙원","2019-02-08","4",4,549679,45
"10557","점박이 한반도의 공룡2 : 새로운 낙원","2019-02-09","4",4,549683,46
"10558","점박이 한반도의 공룡2 : 새로운 낙원","2019-02-10","5",6,549689,47
"10559","점박이 한반도의 공룡2 : 새로운 낙원","2019-02-11","4",4,549693,48
"10560","점박이 한반도의 공룡2 : 새로운 낙원","2019-02-12","4",4,549697,49
"10561","점박이 한반도의 공룡2 : 새로운 낙원","2019-02-13","4",362,550059,50
"10562","점박이 한반도의 공룡2 : 새로운 낙원","2019-03-23","1",8,550067,51
"10563","허스토리","2018-06-07","3",759,759,0
"10564","허스토리","2018-06-08","4",709,1468,0
"10565","허스토리","2018-06-11","13",2409,3877,0
"10566","허스토리","2018-06-12","25",4558,8435,0
"10567","허스토리","2018-06-13","2",498,8933,0
"10568","허스토리","2018-06-14","10",2975,11908,0
"10569","허스토리","2018-06-15","4",777,12685,0
"10570","허스토리","2018-06-16","6",1417,14102,0
"10571","허스토리","2018-06-18","6",1111,15213,0
"10572","허스토리","2018-06-19","12",2341,17554,0
"10573","허스토리","2018-06-20","7",1180,18734,0
"10574","허스토리","2018-06-21","55",8769,27503,0
"10575","허스토리","2018-06-22","31",3767,31270,0
"10576","허스토리","2018-06-25","2",492,31762,0
"10577","허스토리","2018-06-26","5",644,32406,0
"10578","허스토리","2018-06-27","696",44340,76746,1
"10579","허스토리","2018-06-28","657",25879,102625,2
"10580","허스토리","2018-06-29","602",25042,127667,3
"10581","허스토리","2018-06-30","605",41663,169330,4
"10582","허스토리","2018-07-01","571",34244,203574,5
"10583","허스토리","2018-07-02","549",16986,220560,6
"10584","허스토리","2018-07-03","556",19723,240283,7
"10585","허스토리","2018-07-04","282",6715,246998,8
"10586","허스토리","2018-07-05","282",6517,253515,9
"10587","허스토리","2018-07-06","276",8111,261626,10
"10588","허스토리","2018-07-07","248",8707,270333,11
"10589","허스토리","2018-07-08","247",8090,278423,12
"10590","허스토리","2018-07-09","279",6061,284484,13
"10591","허스토리","2018-07-10","294",7933,292417,14
"10592","허스토리","2018-07-11","122",5092,297509,15
"10593","허스토리","2018-07-12","93",3711,301220,16
"10594","허스토리","2018-07-13","88",3294,304514,17
"10595","허스토리","2018-07-14","77",3059,307573,18
"10596","허스토리","2018-07-15","77",3186,310759,19
"10597","허스토리","2018-07-16","91",1996,312755,20
"10598","허스토리","2018-07-17","113",3252,316007,21
"10599","허스토리","2018-07-18","44",1707,317714,22
"10600","허스토리","2018-07-19","85",3369,321083,23
"10601","허스토리","2018-07-20","38",1375,322458,24
"10602","허스토리","2018-07-21","38",1391,323849,25
"10603","허스토리","2018-07-22","30",1036,324885,26
"10604","허스토리","2018-07-23","40",928,325813,27
"10605","허스토리","2018-07-24","39",1096,326909,28
"10606","허스토리","2018-07-25","15",632,327541,29
"10607","허스토리","2018-07-26","10",259,327800,30
"10608","허스토리","2018-07-27","13",270,328070,31
"10609","허스토리","2018-07-28","12",556,328626,32
"10610","허스토리","2018-07-29","11",197,328823,33
"10611","허스토리","2018-07-30","8",203,329026,34
"10612","허스토리","2018-07-31","9",256,329282,35
"10613","허스토리","2018-08-01","5",84,329366,36
"10614","허스토리","2018-08-02","3",53,329419,37
"10615","허스토리","2018-08-03","2",45,329464,38
"10616","허스토리","2018-08-04","3",135,329599,39
"10617","허스토리","2018-08-05","3",51,329650,40
"10618","허스토리","2018-08-06","5",212,329862,41
"10619","허스토리","2018-08-07","2",41,329903,42
"10620","허스토리","2018-08-08","3",136,330039,43
"10621","허스토리","2018-08-09","2",180,330219,44
"10622","허스토리","2018-08-10","3",326,330545,45
"10623","허스토리","2018-08-11","3",161,330706,46
"10624","허스토리","2018-08-12","2",20,330726,47
"10625","허스토리","2018-08-13","3",320,331046,48
"10626","허스토리","2018-08-14","5",392,331438,49
"10627","허스토리","2018-08-15","2",283,331721,50
"10628","허스토리","2018-08-16","3",126,331847,51
"10629","허스토리","2018-08-17","3",112,331959,52
"10630","허스토리","2018-08-18","1",52,332011,53
"10631","허스토리","2018-08-19","3",37,332048,54
"10632","허스토리","2018-08-20","1",14,332062,55
"10633","허스토리","2018-08-21","4",177,332239,56
"10634","허스토리","2018-08-22","4",488,332727,57
"10635","허스토리","2018-08-23","2",99,332826,58
"10636","허스토리","2018-08-24","2",151,332977,59
"10637","허스토리","2018-08-25","1",10,332987,60
"10638","허스토리","2018-08-26","2",328,333315,61
"10639","허스토리","2018-08-27","1",10,333325,62
"10640","허스토리","2018-08-28","1",9,333334,63
"10641","허스토리","2018-08-29","1",107,333441,64
"10642","허스토리","2018-09-06","1",90,333531,65
"10643","허스토리","2018-09-10","1",120,333651,66
"10644","허스토리","2018-09-11","1",138,333789,67
"10645","허스토리","2018-09-12","1",123,333912,68
"10646","허스토리","2018-09-14","1",72,333984,69
"10647","허스토리","2018-09-20","2",70,334054,70
"10648","허스토리","2018-09-21","4",570,334624,71
"10649","허스토리","2018-10-01","1",200,334824,72
"10650","허스토리","2018-10-02","1",207,335031,73
"10651","허스토리","2018-10-11","1",157,335188,74
"10652","허스토리","2018-10-25","1",100,335288,75
"10653","허스토리","2018-11-03","2",252,335540,76
"10654","허스토리","2018-11-15","1",0,335540,77
"10655","허스토리","2018-11-17","1",0,335540,78
"10656","허스토리","2018-11-22","1",200,335740,79
"10657","허스토리","2018-11-25","1",78,335818,80
"10658","허스토리","2018-11-29","2",282,336100,81
"10659","허스토리","2018-12-10","1",174,336274,82
"10660","허스토리","2018-12-16","1",4,336278,83
"10661","허스토리","2018-12-17","1",4,336282,84
"10662","허스토리","2018-12-18","1",270,336552,85
"10663","허스토리","2018-12-20","1",270,336822,86
"10664","덕구","2018-03-07","9",2025,2025,0
"10665","덕구","2018-03-14","1",852,2877,0
"10666","덕구","2018-03-20","7",1065,3942,0
"10667","덕구","2018-03-27","8",2343,6285,0
"10668","덕구","2018-03-29","5",1472,7757,0
"10669","덕구","2018-04-02","6",1696,9453,0
"10670","덕구","2018-04-03","8",2206,11659,0
"10671","덕구","2018-04-04","1",104,11763,0
"10672","덕구","2018-04-05","463",17766,29529,1
"10673","덕구","2018-04-06","462",20919,50448,2
"10674","덕구","2018-04-07","509",40590,91038,3
"10675","덕구","2018-04-08","544",46814,137852,4
"10676","덕구","2018-04-09","467",16405,154257,5
"10677","덕구","2018-04-10","486",15888,170145,6
"10678","덕구","2018-04-11","505",19560,189705,7
"10679","덕구","2018-04-12","292",6415,196120,8
"10680","덕구","2018-04-13","339",9991,206111,9
"10681","덕구","2018-04-14","330",21745,227856,10
"10682","덕구","2018-04-15","354",19905,247761,11
"10683","덕구","2018-04-16","318",5565,253326,12
"10684","덕구","2018-04-17","307",5397,258723,13
"10685","덕구","2018-04-18","328",5713,264436,14
"10686","덕구","2018-04-19","219",4116,268552,15
"10687","덕구","2018-04-20","234",4983,273535,16
"10688","덕구","2018-04-21","249",9611,283146,17
"10689","덕구","2018-04-22","246",9658,292804,18
"10690","덕구","2018-04-23","224",3824,296628,19
"10691","덕구","2018-04-24","228",3739,300367,20
"10692","덕구","2018-04-25","55",1197,301564,21
"10693","덕구","2018-04-26","42",832,302396,22
"10694","덕구","2018-04-27","42",949,303345,23
"10695","덕구","2018-04-28","42",913,304258,24
"10696","덕구","2018-04-29","43",1213,305471,25
"10697","덕구","2018-04-30","47",717,306188,26
"10698","덕구","2018-05-01","32",841,307029,27
"10699","덕구","2018-05-02","23",329,307358,28
"10700","덕구","2018-05-03","18",603,307961,29
"10701","덕구","2018-05-04","20",591,308552,30
"10702","덕구","2018-05-05","14",225,308777,31
"10703","덕구","2018-05-06","13",213,308990,32
"10704","덕구","2018-05-07","14",333,309323,33
"10705","덕구","2018-05-08","37",869,310192,34
"10706","덕구","2018-05-09","15",244,310436,35
"10707","덕구","2018-05-10","9",159,310595,36
"10708","덕구","2018-05-11","8",143,310738,37
"10709","덕구","2018-05-12","6",38,310776,38
"10710","덕구","2018-05-13","8",357,311133,39
"10711","덕구","2018-05-14","5",157,311290,40
"10712","덕구","2018-05-15","9",437,311727,41
"10713","덕구","2018-05-16","8",386,312113,42
"10714","덕구","2018-05-18","3",78,312191,43
"10715","덕구","2018-05-20","1",3,312194,44
"10716","덕구","2018-05-21","1",4,312198,45
"10717","덕구","2018-05-23","3",154,312352,46
"10718","덕구","2018-05-24","3",148,312500,47
"10719","덕구","2018-05-26","1",45,312545,48
"10720","덕구","2018-05-28","3",183,312728,49
"10721","덕구","2018-05-29","3",175,312903,50
"10722","덕구","2018-05-30","5",273,313176,51
"10723","덕구","2018-05-31","1",55,313231,52
"10724","덕구","2018-06-05","1",28,313259,53
"10725","덕구","2018-06-26","1",80,313339,54
"10726","덕구","2018-07-12","1",270,313609,55
"10727","덕구","2018-07-19","1",137,313746,56
"10728","덕구","2018-07-20","1",137,313883,57
"10729","덕구","2018-10-24","2",400,314283,58
"10730","덕구","2018-11-12","2",265,314548,59
"10731","덕구","2018-11-13","2",125,314673,60
"10732","덕구","2018-11-30","4",491,315164,61
"10733","덕구","2018-12-06","1",195,315359,62
"10734","덕구","2018-12-11","3",245,315604,63
"10735","덕구","2018-12-13","1",59,315663,64
"10736","어벤져스: 인피니티 워","2018-04-24","1",624,624,0
"10737","어벤져스: 인피니티 워","2018-04-25","2,460",980042,980666,1
"10738","어벤져스: 인피니티 워","2018-04-26","2,394",595668,1576334,2
"10739","어벤져스: 인피니티 워","2018-04-27","2,460",739908,2316242,3
"10740","어벤져스: 인피니티 워","2018-04-28","2,553",1333307,3649549,4
"10741","어벤져스: 인피니티 워","2018-04-29","2,548",1114946,4764495,5
"10742","어벤져스: 인피니티 워","2018-04-30","2,462",495787,5260282,6
"10743","어벤져스: 인피니티 워","2018-05-01","2,141",717324,5977606,7
"10744","어벤져스: 인피니티 워","2018-05-02","2,114",276967,6254573,8
"10745","어벤져스: 인피니티 워","2018-05-03","2,138",265430,6520003,9
"10746","어벤져스: 인피니티 워","2018-05-04","2,156",419443,6939446,10
"10747","어벤져스: 인피니티 워","2018-05-05","2,224",820839,7760285,11
"10748","어벤져스: 인피니티 워","2018-05-06","2,186",737625,8497910,12
"10749","어벤져스: 인피니티 워","2018-05-07","2,122",516678,9014588,13
"10750","어벤져스: 인피니티 워","2018-05-08","2,056",125615,9140203,14
"10751","어벤져스: 인피니티 워","2018-05-09","1,615",109370,9249573,15
"10752","어벤져스: 인피니티 워","2018-05-10","1,554",101160,9350733,16
"10753","어벤져스: 인피니티 워","2018-05-11","1,551",144261,9494994,17
"10754","어벤져스: 인피니티 워","2018-05-12","1,602",348486,9843480,18
"10755","어벤져스: 인피니티 워","2018-05-13","1,583",290488,10133968,19
"10756","어벤져스: 인피니티 워","2018-05-14","1,508",79245,10213213,20
"10757","어벤져스: 인피니티 워","2018-05-15","1,529",83822,10297035,21
"10758","어벤져스: 인피니티 워","2018-05-16","943",47865,10344900,22
"10759","어벤져스: 인피니티 워","2018-05-17","690",41149,10386049,23
"10760","어벤져스: 인피니티 워","2018-05-18","691",59412,10445461,24
"10761","어벤져스: 인피니티 워","2018-05-19","742",128719,10574180,25
"10762","어벤져스: 인피니티 워","2018-05-20","760",115791,10689971,26
"10763","어벤져스: 인피니티 워","2018-05-21","734",92626,10782597,27
"10764","어벤져스: 인피니티 워","2018-05-22","590",90877,10873474,28
"10765","어벤져스: 인피니티 워","2018-05-23","532",18213,10891687,29
"10766","어벤져스: 인피니티 워","2018-05-24","491",14346,10906033,30
"10767","어벤져스: 인피니티 워","2018-05-25","511",19045,10925078,31
"10768","어벤져스: 인피니티 워","2018-05-26","541",46992,10972070,32
"10769","어벤져스: 인피니티 워","2018-05-27","546",42144,11014214,33
"10770","어벤져스: 인피니티 워","2018-05-28","492",12833,11027047,34
"10771","어벤져스: 인피니티 워","2018-05-29","509",11182,11038229,35
"10772","어벤져스: 인피니티 워","2018-05-30","422",16391,11054620,36
"10773","어벤져스: 인피니티 워","2018-05-31","399",10136,11064756,37
"10774","어벤져스: 인피니티 워","2018-06-01","419",13433,11078189,38
"10775","어벤져스: 인피니티 워","2018-06-02","445",31033,11109222,39
"10776","어벤져스: 인피니티 워","2018-06-03","451",27224,11136446,40
"10777","어벤져스: 인피니티 워","2018-06-04","407",8637,11145083,41
"10778","어벤져스: 인피니티 워","2018-06-05","421",12503,11157586,42
"10779","어벤져스: 인피니티 워","2018-06-06","133",7434,11165020,43
"10780","어벤져스: 인피니티 워","2018-06-07","125",2055,11167075,44
"10781","어벤져스: 인피니티 워","2018-06-08","118",2241,11169316,45
"10782","어벤져스: 인피니티 워","2018-06-09","110",4062,11173378,46
"10783","어벤져스: 인피니티 워","2018-06-10","110",3575,11176953,47
"10784","어벤져스: 인피니티 워","2018-06-11","134",1954,11178907,48
"10785","어벤져스: 인피니티 워","2018-06-12","125",2271,11181178,49
"10786","어벤져스: 인피니티 워","2018-06-13","40",1627,11182805,50
"10787","어벤져스: 인피니티 워","2018-06-14","42",521,11183326,51
"10788","어벤져스: 인피니티 워","2018-06-15","41",650,11183976,52
"10789","어벤져스: 인피니티 워","2018-06-16","40",1207,11185183,53
"10790","어벤져스: 인피니티 워","2018-06-17","41",1214,11186397,54
"10791","어벤져스: 인피니티 워","2018-06-18","37",411,11186808,55
"10792","어벤져스: 인피니티 워","2018-06-19","42",571,11187379,56
"10793","어벤져스: 인피니티 워","2018-06-20","33",524,11187903,57
"10794","어벤져스: 인피니티 워","2018-06-21","19",260,11188163,58
"10795","어벤져스: 인피니티 워","2018-06-22","20",272,11188435,59
"10796","어벤져스: 인피니티 워","2018-06-23","39",2904,11191339,60
"10797","어벤져스: 인피니티 워","2018-06-24","39",2774,11194113,61
"10798","어벤져스: 인피니티 워","2018-06-25","35",1201,11195314,62
"10799","어벤져스: 인피니티 워","2018-06-26","36",1169,11196483,63
"10800","어벤져스: 인피니티 워","2018-06-27","26",1193,11197676,64
"10801","어벤져스: 인피니티 워","2018-06-28","25",867,11198543,65
"10802","어벤져스: 인피니티 워","2018-06-29","25",1373,11199916,66
"10803","어벤져스: 인피니티 워","2018-06-30","24",2721,11202637,67
"10804","어벤져스: 인피니티 워","2018-07-01","25",2335,11204972,68
"10805","어벤져스: 인피니티 워","2018-07-02","26",1055,11206027,69
"10806","어벤져스: 인피니티 워","2018-07-03","27",1360,11207387,70
"10807","어벤져스: 인피니티 워","2018-07-04","7",101,11207488,71
"10808","어벤져스: 인피니티 워","2018-07-05","7",151,11207639,72
"10809","어벤져스: 인피니티 워","2018-07-06","6",128,11207767,73
"10810","어벤져스: 인피니티 워","2018-07-07","6",247,11208014,74
"10811","어벤져스: 인피니티 워","2018-07-08","5",220,11208234,75
"10812","어벤져스: 인피니티 워","2018-07-09","6",180,11208414,76
"10813","어벤져스: 인피니티 워","2018-07-10","6",193,11208607,77
"10814","어벤져스: 인피니티 워","2018-07-11","6",137,11208744,78
"10815","어벤져스: 인피니티 워","2018-07-12","6",145,11208889,79
"10816","어벤져스: 인피니티 워","2018-07-13","7",170,11209059,80
"10817","어벤져스: 인피니티 워","2018-07-14","6",250,11209309,81
"10818","어벤져스: 인피니티 워","2018-07-15","7",267,11209576,82
"10819","어벤져스: 인피니티 워","2018-07-16","5",156,11209732,83
"10820","어벤져스: 인피니티 워","2018-07-17","6",193,11209925,84
"10821","어벤져스: 인피니티 워","2018-07-18","5",149,11210074,85
"10822","어벤져스: 인피니티 워","2018-07-19","5",144,11210218,86
"10823","어벤져스: 인피니티 워","2018-07-20","5",108,11210326,87
"10824","어벤져스: 인피니티 워","2018-07-21","5",239,11210565,88
"10825","어벤져스: 인피니티 워","2018-07-22","5",234,11210799,89
"10826","어벤져스: 인피니티 워","2018-07-23","5",119,11210918,90
"10827","어벤져스: 인피니티 워","2018-07-24","5",125,11211043,91
"10828","어벤져스: 인피니티 워","2018-07-25","4",61,11211104,92
"10829","어벤져스: 인피니티 워","2018-07-26","2",82,11211186,93
"10830","어벤져스: 인피니티 워","2018-07-27","2",65,11211251,94
"10831","어벤져스: 인피니티 워","2018-07-28","2",88,11211339,95
"10832","어벤져스: 인피니티 워","2018-07-29","2",89,11211428,96
"10833","어벤져스: 인피니티 워","2018-07-30","2",49,11211477,97
"10834","어벤져스: 인피니티 워","2018-07-31","2",50,11211527,98
"10835","어벤져스: 인피니티 워","2018-08-01","2",40,11211567,99
"10836","어벤져스: 인피니티 워","2018-08-02","2",52,11211619,100
"10837","어벤져스: 인피니티 워","2018-08-03","2",50,11211669,101
"10838","어벤져스: 인피니티 워","2018-08-04","1",5,11211674,102
"10839","어벤져스: 인피니티 워","2018-08-05","1",10,11211684,103
"10840","어벤져스: 인피니티 워","2018-08-06","2",23,11211707,104
"10841","어벤져스: 인피니티 워","2018-08-07","2",38,11211745,105
"10842","어벤져스: 인피니티 워","2018-08-09","1",14,11211759,106
"10843","어벤져스: 인피니티 워","2018-08-11","1",19,11211778,107
"10844","어벤져스: 인피니티 워","2018-08-13","1",8,11211786,108
"10845","어벤져스: 인피니티 워","2018-08-15","1",12,11211798,109
"10846","어벤져스: 인피니티 워","2018-08-17","1",7,11211805,110
"10847","어벤져스: 인피니티 워","2018-08-20","1",7,11211812,111
"10848","어벤져스: 인피니티 워","2018-08-22","1",6,11211818,112
"10849","어벤져스: 인피니티 워","2018-08-24","1",6,11211824,113
"10850","어벤져스: 인피니티 워","2018-08-26","1",6,11211830,114
"10851","어벤져스: 인피니티 워","2018-08-28","1",5,11211835,115
"10852","어벤져스: 인피니티 워","2018-08-30","1",6,11211841,116
"10853","어벤져스: 인피니티 워","2018-09-01","1",4,11211845,117
"10854","어벤져스: 인피니티 워","2018-09-05","1",5,11211850,118
"10855","어벤져스: 인피니티 워","2018-09-08","1",4,11211854,119
"10856","어벤져스: 인피니티 워","2018-09-10","1",7,11211861,120
"10857","어벤져스: 인피니티 워","2018-09-12","1",2,11211863,121
"10858","어벤져스: 인피니티 워","2018-09-14","1",4,11211867,122
"10859","어벤져스: 인피니티 워","2018-09-15","1",3,11211870,123
"10860","어벤져스: 인피니티 워","2018-09-16","1",3,11211873,124
"10861","어벤져스: 인피니티 워","2018-09-17","1",5,11211878,125
"10862","어벤져스: 인피니티 워","2018-09-18","1",2,11211880,126
"10863","어벤져스: 인피니티 워","2018-10-26","1",13,11211893,127
"10864","어벤져스: 인피니티 워","2018-10-27","1",88,11211981,128
"10865","어벤져스: 인피니티 워","2018-10-28","1",76,11212057,129
"10866","어벤져스: 인피니티 워","2018-10-29","1",40,11212097,130
"10867","어벤져스: 인피니티 워","2018-10-30","1",9,11212106,131
"10868","어벤져스: 인피니티 워","2018-10-31","1",9,11212115,132
"10869","어벤져스: 인피니티 워","2018-11-01","1",32,11212147,133
"10870","어벤져스: 인피니티 워","2018-11-02","2",64,11212211,134
"10871","어벤져스: 인피니티 워","2018-11-03","2",140,11212351,135
"10872","어벤져스: 인피니티 워","2018-11-04","1",93,11212444,136
"10873","어벤져스: 인피니티 워","2018-11-05","2",75,11212519,137
"10874","어벤져스: 인피니티 워","2018-11-06","2",29,11212548,138
"10875","어벤져스: 인피니티 워","2018-11-07","3",162,11212710,139
"10876","보헤미안 랩소디","2018-10-24","5",1254,1254,0
"10877","보헤미안 랩소디","2018-10-25","4",1119,2373,0
"10878","보헤미안 랩소디","2018-10-26","1",174,2547,0
"10879","보헤미안 랩소디","2018-10-29","43",6919,9466,0
"10880","보헤미안 랩소디","2018-10-30","3",555,10021,0
"10881","보헤미안 랩소디","2018-10-31","811",110477,120498,1
"10882","보헤미안 랩소디","2018-11-01","777",65472,185970,2
"10883","보헤미안 랩소디","2018-11-02","838",99555,285525,3
"10884","보헤미안 랩소디","2018-11-03","910",219900,505425,4
"10885","보헤미안 랩소디","2018-11-04","936",203898,709323,5
"10886","보헤미안 랩소디","2018-11-05","882",80136,789459,6
"10887","보헤미안 랩소디","2018-11-06","898",85040,874499,7
"10888","보헤미안 랩소디","2018-11-07","874",89874,964373,8
"10889","보헤미안 랩소디","2018-11-08","891",94697,1059070,9
"10890","보헤미안 랩소디","2018-11-09","960",150117,1209187,10
"10891","보헤미안 랩소디","2018-11-10","1,040",322326,1531513,11
"10892","보헤미안 랩소디","2018-11-11","1,098",311652,1843165,12
"10893","보헤미안 랩소디","2018-11-12","1,002",109370,1952535,13
"10894","보헤미안 랩소디","2018-11-13","1,018",119031,2071566,14
"10895","보헤미안 랩소디","2018-11-14","735",119169,2190735,15
"10896","보헤미안 랩소디","2018-11-15","807",131138,2321873,16
"10897","보헤미안 랩소디","2018-11-16","888",170462,2492335,17
"10898","보헤미안 랩소디","2018-11-17","1,105",326368,2818703,18
"10899","보헤미안 랩소디","2018-11-18","1,179",319315,3138018,19
"10900","보헤미안 랩소디","2018-11-19","1,048",135596,3273614,20
"10901","보헤미안 랩소디","2018-11-20","1,109",130475,3404089,21
"10902","보헤미안 랩소디","2018-11-21","1,164",153271,3557360,22
"10903","보헤미안 랩소디","2018-11-22","1,026",131665,3689025,23
"10904","보헤미안 랩소디","2018-11-23","1,054",189644,3878669,24
"10905","보헤미안 랩소디","2018-11-24","1,136",395504,4274173,25
"10906","보헤미안 랩소디","2018-11-25","1,121",370278,4644451,26
"10907","보헤미안 랩소디","2018-11-26","1,062",135951,4780402,27
"10908","보헤미안 랩소디","2018-11-27","1,119",131835,4912237,28
"10909","보헤미안 랩소디","2018-11-28","928",202908,5115145,29
"10910","보헤미안 랩소디","2018-11-29","896",127482,5242627,30
"10911","보헤미안 랩소디","2018-11-30","998",184033,5426660,31
"10912","보헤미안 랩소디","2018-12-01","1,093",328050,5754710,32
"10913","보헤미안 랩소디","2018-12-02","1,103",292238,6046948,33
"10914","보헤미안 랩소디","2018-12-03","1,033",111720,6158668,34
"10915","보헤미안 랩소디","2018-12-04","1,060",114000,6272668,35
"10916","보헤미안 랩소디","2018-12-05","845",96185,6368853,36
"10917","보헤미안 랩소디","2018-12-06","832",94068,6462921,37
"10918","보헤미안 랩소디","2018-12-07","891",122108,6585029,38
"10919","보헤미안 랩소디","2018-12-08","953",250812,6835841,39
"10920","보헤미안 랩소디","2018-12-09","965",224342,7060183,40
"10921","보헤미안 랩소디","2018-12-10","914",78044,7138227,41
"10922","보헤미안 랩소디","2018-12-11","934",83529,7221756,42
"10923","보헤미안 랩소디","2018-12-12","845",82993,7304749,43
"10924","보헤미안 랩소디","2018-12-13","844",83962,7388711,44
"10925","보헤미안 랩소디","2018-12-14","917",114156,7502867,45
"10926","보헤미안 랩소디","2018-12-15","1,004",227048,7729915,46
"10927","보헤미안 랩소디","2018-12-16","979",212584,7942499,47
"10928","보헤미안 랩소디","2018-12-17","938",79174,8021673,48
"10929","보헤미안 랩소디","2018-12-18","972",86685,8108358,49
"10930","보헤미안 랩소디","2018-12-19","546",43581,8151939,50
"10931","보헤미안 랩소디","2018-12-20","567",44439,8196378,51
"10932","보헤미안 랩소디","2018-12-21","635",58848,8255226,52
"10933","보헤미안 랩소디","2018-12-22","713",118557,8373783,53
"10934","보헤미안 랩소디","2018-12-23","747",128343,8502126,54
"10935","보헤미안 랩소디","2018-12-24","784",119923,8622049,55
"10936","보헤미안 랩소디","2018-12-25","687",143949,8765998,56
"10937","보헤미안 랩소디","2018-12-26","551",53678,8819676,57
"10938","보헤미안 랩소디","2018-12-27","595",42277,8861953,58
"10939","보헤미안 랩소디","2018-12-28","636",52379,8914332,59
"10940","보헤미안 랩소디","2018-12-29","675",95696,9010028,60
"10941","보헤미안 랩소디","2018-12-30","674",108106,9118134,61
"10942","보헤미안 랩소디","2018-12-31","684",106448,9224582,62
"10943","보헤미안 랩소디","2019-01-01","732",135879,9360461,63
"10944","보헤미안 랩소디","2019-01-02","693",40954,9401415,64
"10945","보헤미안 랩소디","2019-01-03","652",32889,9434304,65
"10946","보헤미안 랩소디","2019-01-04","657",38528,9472832,66
"10947","보헤미안 랩소디","2019-01-05","708",74552,9547384,67
"10948","보헤미안 랩소디","2019-01-06","701",63005,9610389,68
"10949","보헤미안 랩소디","2019-01-07","635",26315,9636704,69
"10950","보헤미안 랩소디","2019-01-08","653",28415,9665119,70
"10951","보헤미안 랩소디","2019-01-09","517",18969,9684088,71
"10952","보헤미안 랩소디","2019-01-10","511",17054,9701142,72
"10953","보헤미안 랩소디","2019-01-11","521",19441,9720583,73
"10954","보헤미안 랩소디","2019-01-12","502",35064,9755647,74
"10955","보헤미안 랩소디","2019-01-13","504",30032,9785679,75
"10956","보헤미안 랩소디","2019-01-14","490",12508,9798187,76
"10957","보헤미안 랩소디","2019-01-15","505",13438,9811625,77
"10958","보헤미안 랩소디","2019-01-16","324",9316,9820941,78
"10959","보헤미안 랩소디","2019-01-17","241",6954,9827895,79
"10960","보헤미안 랩소디","2019-01-18","272",8529,9836424,80
"10961","보헤미안 랩소디","2019-01-19","285",16174,9852598,81
"10962","보헤미안 랩소디","2019-01-20","291",14212,9866810,82
"10963","보헤미안 랩소디","2019-01-21","304",7459,9874269,83
"10964","보헤미안 랩소디","2019-01-22","324",8363,9882632,84
"10965","보헤미안 랩소디","2019-01-23","228",5036,9887668,85
"10966","보헤미안 랩소디","2019-01-24","218",5890,9893558,86
"10967","보헤미안 랩소디","2019-01-25","212",5062,9898620,87
"10968","보헤미안 랩소디","2019-01-26","186",6607,9905227,88
"10969","보헤미안 랩소디","2019-01-27","186",5479,9910706,89
"10970","보헤미안 랩소디","2019-01-28","200",4122,9914828,90
"10971","보헤미안 랩소디","2019-01-29","207",5666,9920494,91
"10972","보헤미안 랩소디","2019-01-30","46",1206,9921700,92
"10973","보헤미안 랩소디","2019-01-31","39",1056,9922756,93
"10974","보헤미안 랩소디","2019-02-01","40",1243,9923999,94
"10975","보헤미안 랩소디","2019-02-02","34",1658,9925657,95
"10976","보헤미안 랩소디","2019-02-03","35",1756,9927413,96
"10977","보헤미안 랩소디","2019-02-04","44",2016,9929429,97
"10978","보헤미안 랩소디","2019-02-05","32",1581,9931010,98
"10979","보헤미안 랩소디","2019-02-06","34",1524,9932534,99
"10980","보헤미안 랩소디","2019-02-07","25",820,9933354,100
"10981","보헤미안 랩소디","2019-02-08","28",768,9934122,101
"10982","보헤미안 랩소디","2019-02-09","24",967,9935089,102
"10983","보헤미안 랩소디","2019-02-10","19",536,9935625,103
"10984","보헤미안 랩소디","2019-02-11","25",399,9936024,104
"10985","보헤미안 랩소디","2019-02-12","20",363,9936387,105
"10986","보헤미안 랩소디","2019-02-13","10",255,9936642,106
"10987","보헤미안 랩소디","2019-02-14","5",112,9936754,107
"10988","보헤미안 랩소디","2019-02-15","13",364,9937118,108
"10989","보헤미안 랩소디","2019-02-16","11",586,9937704,109
"10990","보헤미안 랩소디","2019-02-17","4",237,9937941,110
"10991","보헤미안 랩소디","2019-02-18","4",62,9938003,111
"10992","보헤미안 랩소디","2019-02-19","5",125,9938128,112
"10993","보헤미안 랩소디","2019-02-20","3",64,9938192,113
"10994","보헤미안 랩소디","2019-02-21","7",618,9938810,114
"10995","보헤미안 랩소디","2019-02-22","9",216,9939026,115
"10996","보헤미안 랩소디","2019-02-23","8",342,9939368,116
"10997","보헤미안 랩소디","2019-02-24","2",73,9939441,117
"10998","보헤미안 랩소디","2019-02-25","2",40,9939481,118
"10999","보헤미안 랩소디","2019-02-26","6",189,9939670,119
"11000","보헤미안 랩소디","2019-02-27","3",125,9939795,120
"11001","보헤미안 랩소디","2019-02-28","5",100,9939895,121
"11002","보헤미안 랩소디","2019-03-01","24",773,9940668,122
"11003","보헤미안 랩소디","2019-03-02","27",657,9941325,123
"11004","보헤미안 랩소디","2019-03-03","27",475,9941800,124
"11005","보헤미안 랩소디","2019-03-04","32",466,9942266,125
"11006","보헤미안 랩소디","2019-03-05","28",228,9942494,126
"11007","보헤미안 랩소디","2019-03-06","15",189,9942683,127
"11008","보헤미안 랩소디","2019-03-07","15",236,9942919,128
"11009","보헤미안 랩소디","2019-03-08","14",259,9943178,129
"11010","보헤미안 랩소디","2019-03-09","15",517,9943695,130
"11011","보헤미안 랩소디","2019-03-10","15",338,9944033,131
"11012","보헤미안 랩소디","2019-03-11","14",106,9944139,132
"11013","보헤미안 랩소디","2019-03-12","14",106,9944245,133
"11014","보헤미안 랩소디","2019-03-13","15",160,9944405,134
"11015","보헤미안 랩소디","2019-03-14","1",8,9944413,135
"11016","보헤미안 랩소디","2019-03-15","2",27,9944440,136
"11017","보헤미안 랩소디","2019-03-16","2",24,9944464,137
"11018","보헤미안 랩소디","2019-03-17","1",15,9944479,138
"11019","보헤미안 랩소디","2019-03-18","4",51,9944530,139
"11020","보헤미안 랩소디","2019-03-19","1",8,9944538,140
"11021","보헤미안 랩소디","2019-03-20","6",1218,9945756,141
"11022","보헤미안 랩소디","2019-03-21","3",72,9945828,142
"11023","보헤미안 랩소디","2019-03-22","2",17,9945845,143
"11024","보헤미안 랩소디","2019-03-23","2",17,9945862,144
"11025","미션 임파서블: 폴아웃","2018-07-16","8",3164,3164,0
"11026","미션 임파서블: 폴아웃","2018-07-17","1",563,3727,0
"11027","미션 임파서블: 폴아웃","2018-07-25","1,717",601935,605662,1
"11028","미션 임파서블: 폴아웃","2018-07-26","1,656",389360,995022,2
"11029","미션 임파서블: 폴아웃","2018-07-27","1,761",460648,1455670,3
"11030","미션 임파서블: 폴아웃","2018-07-28","1,937",941391,2397061,4
"11031","미션 임파서블: 폴아웃","2018-07-29","1,957",902518,3299579,5
"11032","미션 임파서블: 폴아웃","2018-07-30","1,861",432636,3732215,6
"11033","미션 임파서블: 폴아웃","2018-07-31","1,881",403697,4135912,7
"11034","미션 임파서블: 폴아웃","2018-08-01","998",258561,4394473,8
"11035","미션 임파서블: 폴아웃","2018-08-02","975",249826,4644299,9
"11036","미션 임파서블: 폴아웃","2018-08-03","916",258508,4902807,10
"11037","미션 임파서블: 폴아웃","2018-08-04","888",312699,5215506,11
"11038","미션 임파서블: 폴아웃","2018-08-05","916",279678,5495184,12
"11039","미션 임파서블: 폴아웃","2018-08-06","884",156811,5651995,13
"11040","미션 임파서블: 폴아웃","2018-08-07","908",137583,5789578,14
"11041","미션 임파서블: 폴아웃","2018-08-08","532",62786,5852364,15
"11042","미션 임파서블: 폴아웃","2018-08-09","531",56630,5908994,16
"11043","미션 임파서블: 폴아웃","2018-08-10","521",61392,5970386,17
"11044","미션 임파서블: 폴아웃","2018-08-11","494",94209,6064595,18
"11045","미션 임파서블: 폴아웃","2018-08-12","517",87968,6152563,19
"11046","미션 임파서블: 폴아웃","2018-08-13","510",47635,6200198,20
"11047","미션 임파서블: 폴아웃","2018-08-14","544",59020,6259218,21
"11048","미션 임파서블: 폴아웃","2018-08-15","358",50394,6309612,22
"11049","미션 임파서블: 폴아웃","2018-08-16","334",21364,6330976,23
"11050","미션 임파서블: 폴아웃","2018-08-17","343",24634,6355610,24
"11051","미션 임파서블: 폴아웃","2018-08-18","354",42726,6398336,25
"11052","미션 임파서블: 폴아웃","2018-08-19","355",35393,6433729,26
"11053","미션 임파서블: 폴아웃","2018-08-20","325",14385,6448114,27
"11054","미션 임파서블: 폴아웃","2018-08-21","341",13948,6462062,28
"11055","미션 임파서블: 폴아웃","2018-08-22","245",10135,6472197,29
"11056","미션 임파서블: 폴아웃","2018-08-23","229",7253,6479450,30
"11057","미션 임파서블: 폴아웃","2018-08-24","230",10879,6490329,31
"11058","미션 임파서블: 폴아웃","2018-08-25","263",20735,6511064,32
"11059","미션 임파서블: 폴아웃","2018-08-26","255",17778,6528842,33
"11060","미션 임파서블: 폴아웃","2018-08-27","244",6920,6535762,34
"11061","미션 임파서블: 폴아웃","2018-08-28","246",6985,6542747,35
"11062","미션 임파서블: 폴아웃","2018-08-29","147",4631,6547378,36
"11063","미션 임파서블: 폴아웃","2018-08-30","142",3618,6550996,37
"11064","미션 임파서블: 폴아웃","2018-08-31","142",4388,6555384,38
"11065","미션 임파서블: 폴아웃","2018-09-01","142",5811,6561195,39
"11066","미션 임파서블: 폴아웃","2018-09-02","142",5904,6567099,40
"11067","미션 임파서블: 폴아웃","2018-09-03","138",2398,6569497,41
"11068","미션 임파서블: 폴아웃","2018-09-04","136",2150,6571647,42
"11069","미션 임파서블: 폴아웃","2018-09-05","124",1865,6573512,43
"11070","미션 임파서블: 폴아웃","2018-09-06","85",967,6574479,44
"11071","미션 임파서블: 폴아웃","2018-09-07","86",1243,6575722,45
"11072","미션 임파서블: 폴아웃","2018-09-08","85",2510,6578232,46
"11073","미션 임파서블: 폴아웃","2018-09-09","83",2533,6580765,47
"11074","미션 임파서블: 폴아웃","2018-09-10","83",829,6581594,48
"11075","미션 임파서블: 폴아웃","2018-09-11","80",819,6582413,49
"11076","미션 임파서블: 폴아웃","2018-09-12","4",53,6582466,50
"11077","미션 임파서블: 폴아웃","2018-09-13","4",70,6582536,51
"11078","미션 임파서블: 폴아웃","2018-09-14","4",87,6582623,52
"11079","미션 임파서블: 폴아웃","2018-09-15","5",148,6582771,53
"11080","미션 임파서블: 폴아웃","2018-09-16","4",136,6582907,54
"11081","미션 임파서블: 폴아웃","2018-09-17","22",573,6583480,55
"11082","미션 임파서블: 폴아웃","2018-09-18","10",242,6583722,56
"11083","미션 임파서블: 폴아웃","2018-09-19","2",65,6583787,57
"11084","미션 임파서블: 폴아웃","2018-09-20","2",74,6583861,58
"11085","미션 임파서블: 폴아웃","2018-09-21","1",35,6583896,59
"11086","미션 임파서블: 폴아웃","2018-09-22","1",103,6583999,60
"11087","미션 임파서블: 폴아웃","2018-09-23","1",101,6584100,61
"11088","미션 임파서블: 폴아웃","2018-09-24","1",51,6584151,62
"11089","미션 임파서블: 폴아웃","2018-09-25","1",52,6584203,63
"11090","미션 임파서블: 폴아웃","2018-09-26","2",81,6584284,64
"11091","미션 임파서블: 폴아웃","2018-09-27","1",37,6584321,65
"11092","미션 임파서블: 폴아웃","2018-09-28","1",33,6584354,66
"11093","미션 임파서블: 폴아웃","2018-09-29","1",84,6584438,67
"11094","미션 임파서블: 폴아웃","2018-09-30","1",84,6584522,68
"11095","미션 임파서블: 폴아웃","2018-10-01","1",30,6584552,69
"11096","미션 임파서블: 폴아웃","2018-10-02","1",30,6584582,70
"11097","미션 임파서블: 폴아웃","2018-10-03","1",76,6584658,71
"11098","미션 임파서블: 폴아웃","2018-10-04","1",31,6584689,72
"11099","미션 임파서블: 폴아웃","2018-10-05","1",34,6584723,73
"11100","미션 임파서블: 폴아웃","2018-10-06","1",80,6584803,74
"11101","미션 임파서블: 폴아웃","2018-10-07","1",81,6584884,75
"11102","미션 임파서블: 폴아웃","2018-10-08","1",31,6584915,76
"11103","쥬라기 월드: 폴른 킹덤","2018-06-05","1",624,624,0
"11104","쥬라기 월드: 폴른 킹덤","2018-06-06","1,932",1183496,1184120,1
"11105","쥬라기 월드: 폴른 킹덤","2018-06-07","1,748",231824,1415944,2
"11106","쥬라기 월드: 폴른 킹덤","2018-06-08","1,801",312523,1728467,3
"11107","쥬라기 월드: 폴른 킹덤","2018-06-09","1,972",791322,2519789,4
"11108","쥬라기 월드: 폴른 킹덤","2018-06-10","1,949",703627,3223416,5
"11109","쥬라기 월드: 폴른 킹덤","2018-06-11","1,741",143980,3367396,6
"11110","쥬라기 월드: 폴른 킹덤","2018-06-12","1,772",185612,3553008,7
"11111","쥬라기 월드: 폴른 킹덤","2018-06-13","1,255",446878,3999886,8
"11112","쥬라기 월드: 폴른 킹덤","2018-06-14","1,170",85201,4085087,9
"11113","쥬라기 월드: 폴른 킹덤","2018-06-15","1,159",112623,4197710,10
"11114","쥬라기 월드: 폴른 킹덤","2018-06-16","1,231",298353,4496063,11
"11115","쥬라기 월드: 폴른 킹덤","2018-06-17","1,202",257100,4753163,12
"11116","쥬라기 월드: 폴른 킹덤","2018-06-18","1,087",44981,4798144,13
"11117","쥬라기 월드: 폴른 킹덤","2018-06-19","1,077",49101,4847245,14
"11118","쥬라기 월드: 폴른 킹덤","2018-06-20","930",53864,4901109,15
"11119","쥬라기 월드: 폴른 킹덤","2018-06-21","809",47104,4948213,16
"11120","쥬라기 월드: 폴른 킹덤","2018-06-22","823",62548,5010761,17
"11121","쥬라기 월드: 폴른 킹덤","2018-06-23","899",137047,5147808,18
"11122","쥬라기 월드: 폴른 킹덤","2018-06-24","888",135637,5283445,19
"11123","쥬라기 월드: 폴른 킹덤","2018-06-25","757",37327,5320772,20
"11124","쥬라기 월드: 폴른 킹덤","2018-06-26","771",35315,5356087,21
"11125","쥬라기 월드: 폴른 킹덤","2018-06-27","524",39713,5395800,22
"11126","쥬라기 월드: 폴른 킹덤","2018-06-28","494",19864,5415664,23
"11127","쥬라기 월드: 폴른 킹덤","2018-06-29","503",27547,5443211,24
"11128","쥬라기 월드: 폴른 킹덤","2018-06-30","570",75958,5519169,25
"11129","쥬라기 월드: 폴른 킹덤","2018-07-01","570",69330,5588499,26
"11130","쥬라기 월드: 폴른 킹덤","2018-07-02","477",15200,5603699,27
"11131","쥬라기 월드: 폴른 킹덤","2018-07-03","487",15378,5619077,28
"11132","쥬라기 월드: 폴른 킹덤","2018-07-04","119",2478,5621555,29
"11133","쥬라기 월드: 폴른 킹덤","2018-07-05","117",2732,5624287,30
"11134","쥬라기 월드: 폴른 킹덤","2018-07-06","120",3470,5627757,31
"11135","쥬라기 월드: 폴른 킹덤","2018-07-07","135",8238,5635995,32
"11136","쥬라기 월드: 폴른 킹덤","2018-07-08","141",8957,5644952,33
"11137","쥬라기 월드: 폴른 킹덤","2018-07-09","116",1977,5646929,34
"11138","쥬라기 월드: 폴른 킹덤","2018-07-10","123",2041,5648970,35
"11139","쥬라기 월드: 폴른 킹덤","2018-07-11","57",948,5649918,36
"11140","쥬라기 월드: 폴른 킹덤","2018-07-12","45",791,5650709,37
"11141","쥬라기 월드: 폴른 킹덤","2018-07-13","38",920,5651629,38
"11142","쥬라기 월드: 폴른 킹덤","2018-07-14","52",2687,5654316,39
"11143","쥬라기 월드: 폴른 킹덤","2018-07-15","48",3183,5657499,40
"11144","쥬라기 월드: 폴른 킹덤","2018-07-16","35",614,5658113,41
"11145","쥬라기 월드: 폴른 킹덤","2018-07-17","40",616,5658729,42
"11146","쥬라기 월드: 폴른 킹덤","2018-07-18","8",84,5658813,43
"11147","쥬라기 월드: 폴른 킹덤","2018-07-19","6",259,5659072,44
"11148","쥬라기 월드: 폴른 킹덤","2018-07-20","4",48,5659120,45
"11149","쥬라기 월드: 폴른 킹덤","2018-07-21","10",360,5659480,46
"11150","쥬라기 월드: 폴른 킹덤","2018-07-22","11",591,5660071,47
"11151","쥬라기 월드: 폴른 킹덤","2018-07-23","8",114,5660185,48
"11152","쥬라기 월드: 폴른 킹덤","2018-07-24","8",83,5660268,49
"11153","쥬라기 월드: 폴른 킹덤","2018-07-25","1",22,5660290,50
"11154","쥬라기 월드: 폴른 킹덤","2018-07-26","5",91,5660381,51
"11155","쥬라기 월드: 폴른 킹덤","2018-07-27","4",123,5660504,52
"11156","쥬라기 월드: 폴른 킹덤","2018-07-28","1",32,5660536,53
"11157","쥬라기 월드: 폴른 킹덤","2018-07-29","1",40,5660576,54
"11158","쥬라기 월드: 폴른 킹덤","2018-07-30","3",92,5660668,55
"11159","쥬라기 월드: 폴른 킹덤","2018-07-31","3",107,5660775,56
"11160","쥬라기 월드: 폴른 킹덤","2018-08-01","2",70,5660845,57
"11161","쥬라기 월드: 폴른 킹덤","2018-08-02","2",70,5660915,58
"11162","쥬라기 월드: 폴른 킹덤","2018-08-03","2",78,5660993,59
"11163","쥬라기 월드: 폴른 킹덤","2018-08-06","2",63,5661056,60
"11164","쥬라기 월드: 폴른 킹덤","2018-08-07","2",72,5661128,61
"11165","앤트맨과 와스프","2018-07-03","8",2794,2794,0
"11166","앤트맨과 와스프","2018-07-04","1,616",404151,406945,1
"11167","앤트맨과 와스프","2018-07-05","1,627",299650,706595,2
"11168","앤트맨과 와스프","2018-07-06","1,678",403553,1110148,3
"11169","앤트맨과 와스프","2018-07-07","1,775",821769,1931917,4
"11170","앤트맨과 와스프","2018-07-08","1,764",694125,2626042,5
"11171","앤트맨과 와스프","2018-07-09","1,579",192617,2818659,6
"11172","앤트맨과 와스프","2018-07-10","1,596",204068,3022727,7
"11173","앤트맨과 와스프","2018-07-11","1,391",163809,3186536,8
"11174","앤트맨과 와스프","2018-07-12","1,384",135312,3321848,9
"11175","앤트맨과 와스프","2018-07-13","1,340",194998,3516846,10
"11176","앤트맨과 와스프","2018-07-14","1,370",468418,3985264,11
"11177","앤트맨과 와스프","2018-07-15","1,355",399123,4384387,12
"11178","앤트맨과 와스프","2018-07-16","1,250",99047,4483434,13
"11179","앤트맨과 와스프","2018-07-17","1,260",84455,4567889,14
"11180","앤트맨과 와스프","2018-07-18","874",76147,4644036,15
"11181","앤트맨과 와스프","2018-07-19","861",66591,4710627,16
"11182","앤트맨과 와스프","2018-07-20","868",98563,4809190,17
"11183","앤트맨과 와스프","2018-07-21","897",211982,5021172,18
"11184","앤트맨과 와스프","2018-07-22","873",181723,5202895,19
"11185","앤트맨과 와스프","2018-07-23","831",57663,5260558,20
"11186","앤트맨과 와스프","2018-07-24","850",53359,5313917,21
"11187","앤트맨과 와스프","2018-07-25","379",20327,5334244,22
"11188","앤트맨과 와스프","2018-07-26","354",13624,5347868,23
"11189","앤트맨과 와스프","2018-07-27","350",15099,5362967,24
"11190","앤트맨과 와스프","2018-07-28","334",21543,5384510,25
"11191","앤트맨과 와스프","2018-07-29","357",20471,5404981,26
"11192","앤트맨과 와스프","2018-07-30","375",15919,5420900,27
"11193","앤트맨과 와스프","2018-07-31","387",17179,5438079,28
"11194","앤트맨과 와스프","2018-08-01","37",1475,5439554,29
"11195","앤트맨과 와스프","2018-08-02","40",1402,5440956,30
"11196","앤트맨과 와스프","2018-08-03","33",1513,5442469,31
"11197","앤트맨과 와스프","2018-08-04","29",1350,5443819,32
"11198","앤트맨과 와스프","2018-08-05","34",982,5444801,33
"11199","앤트맨과 와스프","2018-08-06","31",780,5445581,34
"11200","앤트맨과 와스프","2018-08-07","29",832,5446413,35
"11201","앤트맨과 와스프","2018-08-08","4",86,5446499,36
"11202","앤트맨과 와스프","2018-08-09","3",70,5446569,37
"11203","앤트맨과 와스프","2018-08-10","4",74,5446643,38
"11204","앤트맨과 와스프","2018-08-11","3",95,5446738,39
"11205","앤트맨과 와스프","2018-08-12","3",118,5446856,40
"11206","앤트맨과 와스프","2018-08-13","4",87,5446943,41
"11207","앤트맨과 와스프","2018-08-14","5",121,5447064,42
"11208","앤트맨과 와스프","2018-08-15","4",305,5447369,43
"11209","앤트맨과 와스프","2018-08-16","3",42,5447411,44
"11210","앤트맨과 와스프","2018-08-17","2",38,5447449,45
"11211","앤트맨과 와스프","2018-08-18","3",85,5447534,46
"11212","앤트맨과 와스프","2018-08-19","3",69,5447603,47
"11213","앤트맨과 와스프","2018-08-20","2",29,5447632,48
"11214","앤트맨과 와스프","2018-08-21","3",33,5447665,49
"11215","앤트맨과 와스프","2018-08-22","1",14,5447679,50
"11216","앤트맨과 와스프","2018-08-23","1",27,5447706,51
"11217","앤트맨과 와스프","2018-08-25","1",17,5447723,52
"11218","앤트맨과 와스프","2018-08-27","1",6,5447729,53
"11219","앤트맨과 와스프","2018-08-29","1",6,5447735,54
"11220","앤트맨과 와스프","2018-08-31","1",17,5447752,55
"11221","앤트맨과 와스프","2018-09-02","1",18,5447770,56
"11222","앤트맨과 와스프","2018-09-04","1",7,5447777,57
"11223","앤트맨과 와스프","2018-09-06","1",6,5447783,58
"11224","앤트맨과 와스프","2018-09-07","1",7,5447790,59
"11225","앤트맨과 와스프","2018-09-09","1",3,5447793,60
"11226","앤트맨과 와스프","2018-09-11","1",6,5447799,61
"11227","앤트맨과 와스프","2018-09-13","1",3,5447802,62
"11228","앤트맨과 와스프","2018-09-15","1",3,5447805,63
"11229","앤트맨과 와스프","2018-09-16","1",13,5447818,64
"11230","앤트맨과 와스프","2018-09-17","1",5,5447823,65
"11231","앤트맨과 와스프","2018-09-18","1",3,5447826,66
"11232","앤트맨과 와스프","2018-11-01","1",17,5447843,67
"11233","앤트맨과 와스프","2018-11-02","1",29,5447872,68
"11234","앤트맨과 와스프","2018-11-03","1",83,5447955,69
"11235","앤트맨과 와스프","2018-11-04","1",5,5447960,70
"11236","앤트맨과 와스프","2018-11-05","1",2,5447962,71
"11237","앤트맨과 와스프","2018-11-06","1",10,5447972,72
"11238","앤트맨과 와스프","2018-11-07","1",9,5447981,73
"11239","앤트맨과 와스프","2018-12-11","1",153,5448134,74
"11240","블랙 팬서","2018-02-02","2",822,822,0
"11241","블랙 팬서","2018-02-05","3",957,1779,0
"11242","블랙 팬서","2018-02-13","6",1244,3023,0
"11243","블랙 팬서","2018-02-14","1,449",630461,633484,1
"11244","블랙 팬서","2018-02-15","1,587",563855,1197339,2
"11245","블랙 팬서","2018-02-16","1,620",562493,1759832,3
"11246","블랙 팬서","2018-02-17","1,544",739447,2499279,4
"11247","블랙 팬서","2018-02-18","1,495",598424,3097703,5
"11248","블랙 팬서","2018-02-19","1,314",240651,3338354,6
"11249","블랙 팬서","2018-02-20","1,313",171156,3509510,7
"11250","블랙 팬서","2018-02-21","1,283",150599,3660109,8
"11251","블랙 팬서","2018-02-22","1,165",127342,3787451,9
"11252","블랙 팬서","2018-02-23","1,203",148541,3935992,10
"11253","블랙 팬서","2018-02-24","1,242",307400,4243392,11
"11254","블랙 팬서","2018-02-25","1,230",253217,4496609,12
"11255","블랙 팬서","2018-02-26","1,153",91512,4588121,13
"11256","블랙 팬서","2018-02-27","1,153",87081,4675202,14
"11257","블랙 팬서","2018-02-28","701",114218,4789420,15
"11258","블랙 팬서","2018-03-01","711",150161,4939581,16
"11259","블랙 팬서","2018-03-02","708",54702,4994283,17
"11260","블랙 팬서","2018-03-03","787",111713,5105996,18
"11261","블랙 팬서","2018-03-04","760",89979,5195975,19
"11262","블랙 팬서","2018-03-05","666",25595,5221570,20
"11263","블랙 팬서","2018-03-06","653",21350,5242920,21
"11264","블랙 팬서","2018-03-07","508",16010,5258930,22
"11265","블랙 팬서","2018-03-08","402",10437,5269367,23
"11266","블랙 팬서","2018-03-09","428",13524,5282891,24
"11267","블랙 팬서","2018-03-10","448",30631,5313522,25
"11268","블랙 팬서","2018-03-11","447",26725,5340247,26
"11269","블랙 팬서","2018-03-12","412",7536,5347783,27
"11270","블랙 팬서","2018-03-13","417",7218,5355001,28
"11271","블랙 팬서","2018-03-14","147",2311,5357312,29
"11272","블랙 팬서","2018-03-15","138",2184,5359496,30
"11273","블랙 팬서","2018-03-16","142",2910,5362406,31
"11274","블랙 팬서","2018-03-17","137",7371,5369777,32
"11275","블랙 팬서","2018-03-18","142",6683,5376460,33
"11276","블랙 팬서","2018-03-19","134",2223,5378683,34
"11277","블랙 팬서","2018-03-20","139",2314,5380997,35
"11278","블랙 팬서","2018-03-21","68",860,5381857,36
"11279","블랙 팬서","2018-03-22","46",611,5382468,37
"11280","블랙 팬서","2018-03-23","45",929,5383397,38
"11281","블랙 팬서","2018-03-24","47",2015,5385412,39
"11282","블랙 팬서","2018-03-25","43",1547,5386959,40
"11283","블랙 팬서","2018-03-26","51",617,5387576,41
"11284","블랙 팬서","2018-03-27","49",658,5388234,42
"11285","블랙 팬서","2018-03-28","9",116,5388350,43
"11286","블랙 팬서","2018-03-29","9",102,5388452,44
"11287","블랙 팬서","2018-03-30","8",115,5388567,45
"11288","블랙 팬서","2018-03-31","9",222,5388789,46
"11289","블랙 팬서","2018-04-01","7",195,5388984,47
"11290","블랙 팬서","2018-04-02","9",88,5389072,48
"11291","블랙 팬서","2018-04-03","9",78,5389150,49
"11292","블랙 팬서","2018-04-04","8",84,5389234,50
"11293","블랙 팬서","2018-04-05","3",52,5389286,51
"11294","블랙 팬서","2018-04-06","4",58,5389344,52
"11295","블랙 팬서","2018-04-07","4",125,5389469,53
"11296","블랙 팬서","2018-04-08","4",151,5389620,54
"11297","블랙 팬서","2018-04-09","3",35,5389655,55
"11298","블랙 팬서","2018-04-10","3",66,5389721,56
"11299","블랙 팬서","2018-04-11","4",77,5389798,57
"11300","블랙 팬서","2018-04-12","3",45,5389843,58
"11301","블랙 팬서","2018-04-13","3",73,5389916,59
"11302","블랙 팬서","2018-04-14","5",1763,5391679,60
"11303","블랙 팬서","2018-04-15","5",1412,5393091,61
"11304","블랙 팬서","2018-04-16","4",184,5393275,62
"11305","블랙 팬서","2018-04-17","4",92,5393367,63
"11306","블랙 팬서","2018-04-18","4",160,5393527,64
"11307","블랙 팬서","2018-04-19","6",152,5393679,65
"11308","블랙 팬서","2018-04-20","7",190,5393869,66
"11309","블랙 팬서","2018-04-21","6",383,5394252,67
"11310","블랙 팬서","2018-04-22","5",272,5394524,68
"11311","블랙 팬서","2018-04-23","3",206,5394730,69
"11312","블랙 팬서","2018-04-24","5",306,5395036,70
"11313","블랙 팬서","2018-04-25","3",59,5395095,71
"11314","블랙 팬서","2018-04-26","3",92,5395187,72
"11315","블랙 팬서","2018-04-27","3",240,5395427,73
"11316","블랙 팬서","2018-04-28","2",143,5395570,74
"11317","블랙 팬서","2018-04-29","2",158,5395728,75
"11318","블랙 팬서","2018-04-30","4",390,5396118,76
"11319","블랙 팬서","2018-05-01","5",475,5396593,77
"11320","블랙 팬서","2018-05-02","4",212,5396805,78
"11321","블랙 팬서","2018-05-03","6",232,5397037,79
"11322","블랙 팬서","2018-05-04","6",169,5397206,80
"11323","블랙 팬서","2018-05-05","7",303,5397509,81
"11324","블랙 팬서","2018-05-06","7",235,5397744,82
"11325","블랙 팬서","2018-05-07","7",311,5398055,83
"11326","블랙 팬서","2018-05-08","6",85,5398140,84
"11327","블랙 팬서","2018-05-09","6",132,5398272,85
"11328","블랙 팬서","2018-05-10","6",114,5398386,86
"11329","블랙 팬서","2018-05-11","6",111,5398497,87
"11330","블랙 팬서","2018-05-12","6",181,5398678,88
"11331","블랙 팬서","2018-05-13","5",108,5398786,89
"11332","블랙 팬서","2018-05-14","4",66,5398852,90
"11333","블랙 팬서","2018-05-15","4",66,5398918,91
"11334","블랙 팬서","2018-05-16","1",7,5398925,92
"11335","블랙 팬서","2018-05-17","2",20,5398945,93
"11336","블랙 팬서","2018-05-18","2",11,5398956,94
"11337","블랙 팬서","2018-05-20","1",4,5398960,95
"11338","블랙 팬서","2018-05-21","1",34,5398994,96
"11339","블랙 팬서","2018-07-30","1",0,5398994,97
"11340","블랙 팬서","2018-10-25","1",17,5399011,98
"11341","블랙 팬서","2018-10-29","1",29,5399040,99
"11342","블랙 팬서","2018-10-30","1",39,5399079,100
"11343","블랙 팬서","2018-10-31","1",3,5399082,101
"11344","블랙 팬서","2018-11-01","2",32,5399114,102
"11345","블랙 팬서","2018-11-02","1",11,5399125,103
"11346","블랙 팬서","2018-11-03","1",58,5399183,104
"11347","블랙 팬서","2018-11-04","1",11,5399194,105
"11348","블랙 팬서","2018-11-05","2",12,5399206,106
"11349","블랙 팬서","2018-11-06","1",2,5399208,107
"11350","블랙 팬서","2018-11-07","1",19,5399227,108
"11351","블랙 팬서","2019-02-14","1",20,5399247,109
"11352","블랙 팬서","2019-02-16","1",14,5399261,110
"11353","블랙 팬서","2019-02-20","1",6,5399267,111
"11354","블랙 팬서","2019-02-22","1",3,5399270,112
"11355","블랙 팬서","2019-02-26","1",7,5399277,113
"11356","블랙 팬서","2019-03-02","1",14,5399291,114
"11357","블랙 팬서","2019-03-04","1",12,5399303,115
"11358","블랙 팬서","2019-03-08","1",6,5399309,116
"11359","블랙 팬서","2019-03-12","1",7,5399316,117
"11360","블랙 팬서","2019-03-15","1",11,5399327,118
"11361","베놈","2018-10-02","1",406,406,0
"11362","베놈","2018-10-03","1,308",740661,741067,1
"11363","베놈","2018-10-04","1,164",181599,922666,2
"11364","베놈","2018-10-05","1,196",245748,1168414,3
"11365","베놈","2018-10-06","1,293",512744,1681158,4
"11366","베놈","2018-10-07","1,287",400044,2081202,5
"11367","베놈","2018-10-08","1,173",215343,2296545,6
"11368","베놈","2018-10-09","1,160",307832,2604377,7
"11369","베놈","2018-10-10","1,092",83246,2687623,8
"11370","베놈","2018-10-11","953",68127,2755750,9
"11371","베놈","2018-10-12","974",107382,2863132,10
"11372","베놈","2018-10-13","1,011",209283,3072415,11
"11373","베놈","2018-10-14","981",177044,3249459,12
"11374","베놈","2018-10-15","889",55809,3305268,13
"11375","베놈","2018-10-16","899",45277,3350545,14
"11376","베놈","2018-10-17","903",46736,3397281,15
"11377","베놈","2018-10-18","586",34024,3431305,16
"11378","베놈","2018-10-19","646",55248,3486553,17
"11379","베놈","2018-10-20","660",99671,3586224,18
"11380","베놈","2018-10-21","664",86249,3672473,19
"11381","베놈","2018-10-22","601",23988,3696461,20
"11382","베놈","2018-10-23","598",22232,3718693,21
"11383","베놈","2018-10-24","615",23952,3742645,22
"11384","베놈","2018-10-25","489",12981,3755626,23
"11385","베놈","2018-10-26","513",20882,3776508,24
"11386","베놈","2018-10-27","529",38613,3815121,25
"11387","베놈","2018-10-28","539",36288,3851409,26
"11388","베놈","2018-10-29","505",10942,3862351,27
"11389","베놈","2018-10-30","492",11318,3873669,28
"11390","베놈","2018-10-31","122",2556,3876225,29
"11391","베놈","2018-11-01","107",1466,3877691,30
"11392","베놈","2018-11-02","106",2195,3879886,31
"11393","베놈","2018-11-03","99",3382,3883268,32
"11394","베놈","2018-11-04","94",2877,3886145,33
"11395","베놈","2018-11-05","64",532,3886677,34
"11396","베놈","2018-11-06","65",493,3887170,35
"11397","베놈","2018-11-07","12",107,3887277,36
"11398","베놈","2018-11-08","8",50,3887327,37
"11399","베놈","2018-11-09","10",97,3887424,38
"11400","베놈","2018-11-10","9",202,3887626,39
"11401","베놈","2018-11-11","7",155,3887781,40
"11402","베놈","2018-11-12","8",60,3887841,41
"11403","베놈","2018-11-13","8",60,3887901,42
"11404","베놈","2018-11-14","2",12,3887913,43
"11405","베놈","2018-11-15","1",6,3887919,44
"11406","베놈","2018-11-16","1",19,3887938,45
"11407","베놈","2018-11-17","1",29,3887967,46
"11408","베놈","2018-11-18","1",30,3887997,47
"11409","베놈","2018-11-19","1",8,3888005,48
"11410","베놈","2018-11-20","1",15,3888020,49
"11411","베놈","2018-11-21","1",7,3888027,50
"11412","베놈","2018-11-22","1",11,3888038,51
"11413","베놈","2018-11-23","1",9,3888047,52
"11414","베놈","2018-11-24","1",13,3888060,53
"11415","베놈","2018-11-25","1",15,3888075,54
"11416","베놈","2018-11-26","1",5,3888080,55
"11417","베놈","2018-11-27","1",5,3888085,56
"11418","베놈","2018-11-28","1",11,3888096,57
"11419","데드풀 2","2018-05-09","1",247,247,0
"11420","데드풀 2","2018-05-11","1",1024,1271,0
"11421","데드풀 2","2018-05-15","1",231,1502,0
"11422","데드풀 2","2018-05-16","1,525",356445,357947,1
"11423","데드풀 2","2018-05-17","1,404",259782,617729,2
"11424","데드풀 2","2018-05-18","1,485",323152,940881,3
"11425","데드풀 2","2018-05-19","1,562",570341,1511222,4
"11426","데드풀 2","2018-05-20","1,576",462113,1973335,5
"11427","데드풀 2","2018-05-21","1,493",281698,2255033,6
"11428","데드풀 2","2018-05-22","1,101",317490,2572523,7
"11429","데드풀 2","2018-05-23","1,027",91779,2664302,8
"11430","데드풀 2","2018-05-24","938",75447,2739749,9
"11431","데드풀 2","2018-05-25","928",95108,2834857,10
"11432","데드풀 2","2018-05-26","933",186003,3020860,11
"11433","데드풀 2","2018-05-27","925",144836,3165696,12
"11434","데드풀 2","2018-05-28","886",52592,3218288,13
"11435","데드풀 2","2018-05-29","881",44281,3262569,14
"11436","데드풀 2","2018-05-30","848",81819,3344388,15
"11437","데드풀 2","2018-05-31","758",41960,3386348,16
"11438","데드풀 2","2018-06-01","758",51377,3437725,17
"11439","데드풀 2","2018-06-02","770",101866,3539591,18
"11440","데드풀 2","2018-06-03","743",77415,3617006,19
"11441","데드풀 2","2018-06-04","726",27515,3644521,20
"11442","데드풀 2","2018-06-05","742",35156,3679677,21
"11443","데드풀 2","2018-06-06","374",26547,3706224,22
"11444","데드풀 2","2018-06-07","362",8502,3714726,23
"11445","데드풀 2","2018-06-08","366",10419,3725145,24
"11446","데드풀 2","2018-06-09","291",15829,3740974,25
"11447","데드풀 2","2018-06-10","294",12481,3753455,26
"11448","데드풀 2","2018-06-11","345",6564,3760019,27
"11449","데드풀 2","2018-06-12","349",8218,3768237,28
"11450","데드풀 2","2018-06-13","53",2637,3770874,29
"11451","데드풀 2","2018-06-14","57",1246,3772120,30
"11452","데드풀 2","2018-06-15","63",1668,3773788,31
"11453","데드풀 2","2018-06-16","52",2136,3775924,32
"11454","데드풀 2","2018-06-17","50",1772,3777696,33
"11455","데드풀 2","2018-06-18","52",760,3778456,34
"11456","데드풀 2","2018-06-19","55",968,3779424,35
"11457","데드풀 2","2018-06-20","38",750,3780174,36
"11458","데드풀 2","2018-06-21","17",386,3780560,37
"11459","데드풀 2","2018-06-22","16",395,3780955,38
"11460","데드풀 2","2018-06-23","16",599,3781554,39
"11461","데드풀 2","2018-06-24","17",657,3782211,40
"11462","데드풀 2","2018-06-25","17",399,3782610,41
"11463","데드풀 2","2018-06-26","17",307,3782917,42
"11464","데드풀 2","2018-06-27","3",85,3783002,43
"11465","데드풀 2","2018-06-28","4",107,3783109,44
"11466","데드풀 2","2018-06-29","3",90,3783199,45
"11467","데드풀 2","2018-06-30","4",142,3783341,46
"11468","데드풀 2","2018-07-01","5",146,3783487,47
"11469","데드풀 2","2018-07-02","3",101,3783588,48
"11470","데드풀 2","2018-07-03","4",137,3783725,49
"11471","데드풀 2","2018-07-04","3",62,3783787,50
"11472","데드풀 2","2018-07-05","4",60,3783847,51
"11473","데드풀 2","2018-07-06","5",88,3783935,52
"11474","데드풀 2","2018-07-07","5",61,3783996,53
"11475","데드풀 2","2018-07-08","4",70,3784066,54
"11476","데드풀 2","2018-07-09","3",42,3784108,55
"11477","데드풀 2","2018-07-10","3",46,3784154,56
"11478","데드풀 2","2018-07-11","3",66,3784220,57
"11479","데드풀 2","2018-07-12","3",37,3784257,58
"11480","데드풀 2","2018-07-13","3",56,3784313,59
"11481","데드풀 2","2018-07-14","3",98,3784411,60
"11482","데드풀 2","2018-07-15","3",90,3784501,61
"11483","데드풀 2","2018-07-16","3",45,3784546,62
"11484","데드풀 2","2018-07-17","3",56,3784602,63
"11485","데드풀 2","2018-07-31","1",0,3784602,64
"11486","코코","2017-12-22","2",650,650,0
"11487","코코","2017-12-28","2",650,1300,0
"11488","코코","2017-12-29","4",1797,3097,0
"11489","코코","2018-01-03","5",1088,4185,0
"11490","코코","2018-01-04","4",1062,5247,0
"11491","코코","2018-01-06","4",950,6197,0
"11492","코코","2018-01-08","9",2110,8307,0
"11493","코코","2018-01-09","1",450,8757,0
"11494","코코","2018-01-10","17",1973,10730,0
"11495","코코","2018-01-11","937",106921,117651,1
"11496","코코","2018-01-12","978",114581,232232,2
"11497","코코","2018-01-13","1,163",306184,538416,3
"11498","코코","2018-01-14","1,177",311559,849975,4
"11499","코코","2018-01-15","1,000",105194,955169,5
"11500","코코","2018-01-16","1,009",114778,1069947,6
"11501","코코","2018-01-17","742",82114,1152061,7
"11502","코코","2018-01-18","753",85272,1237333,8
"11503","코코","2018-01-19","766",98539,1335872,9
"11504","코코","2018-01-20","927",235540,1571412,10
"11505","코코","2018-01-21","971",231610,1803022,11
"11506","코코","2018-01-22","788",68326,1871348,12
"11507","코코","2018-01-23","818",72957,1944305,13
"11508","코코","2018-01-24","723",62595,2006900,14
"11509","코코","2018-01-25","751",65984,2072884,15
"11510","코코","2018-01-26","812",76136,2149020,16
"11511","코코","2018-01-27","1,025",207860,2356880,17
"11512","코코","2018-01-28","1,021",199350,2556230,18
"11513","코코","2018-01-29","796",54634,2610864,19
"11514","코코","2018-01-30","814",55160,2666024,20
"11515","코코","2018-01-31","665",69621,2735645,21
"11516","코코","2018-02-01","602",34536,2770181,22
"11517","코코","2018-02-02","649",39372,2809553,23
"11518","코코","2018-02-03","805",122757,2932310,24
"11519","코코","2018-02-04","805",115294,3047604,25
"11520","코코","2018-02-05","628",26150,3073754,26
"11521","코코","2018-02-06","680",25451,3099205,27
"11522","코코","2018-02-07","645",26116,3125321,28
"11523","코코","2018-02-08","503",19310,3144631,29
"11524","코코","2018-02-09","544",23550,3168181,30
"11525","코코","2018-02-10","650",66167,3234348,31
"11526","코코","2018-02-11","642",60799,3295147,32
"11527","코코","2018-02-12","555",17116,3312263,33
"11528","코코","2018-02-13","560",18771,3331034,34
"11529","코코","2018-02-14","302",10161,3341195,35
"11530","코코","2018-02-15","353",20771,3361966,36
"11531","코코","2018-02-16","354",19351,3381317,37
"11532","코코","2018-02-17","345",27213,3408530,38
"11533","코코","2018-02-18","350",22739,3431269,39
"11534","코코","2018-02-19","324",8556,3439825,40
"11535","코코","2018-02-20","320",7967,3447792,41
"11536","코코","2018-02-21","305",7397,3455189,42
"11537","코코","2018-02-22","230",5957,3461146,43
"11538","코코","2018-02-23","232",5964,3467110,44
"11539","코코","2018-02-24","265",10825,3477935,45
"11540","코코","2018-02-25","272",11025,3488960,46
"11541","코코","2018-02-26","234",5478,3494438,47
"11542","코코","2018-02-27","237",7290,3501728,48
"11543","코코","2018-02-28","43",1358,3503086,49
"11544","코코","2018-03-01","54",3806,3506892,50
"11545","코코","2018-03-02","43",537,3507429,51
"11546","코코","2018-03-03","55",1625,3509054,52
"11547","코코","2018-03-04","58",1747,3510801,53
"11548","코코","2018-03-05","29",199,3511000,54
"11549","코코","2018-03-06","27",224,3511224,55
"11550","코코","2018-03-07","7",90,3511314,56
"11551","코코","2018-03-08","5",47,3511361,57
"11552","코코","2018-03-09","7",131,3511492,58
"11553","코코","2018-03-10","11",406,3511898,59
"11554","코코","2018-03-11","10",247,3512145,60
"11555","코코","2018-03-12","3",8,3512153,61
"11556","코코","2018-03-13","5",48,3512201,62
"11557","코코","2018-03-14","3",8,3512209,63
"11558","코코","2018-03-15","1",3,3512212,64
"11559","코코","2018-03-16","2",3,3512215,65
"11560","코코","2018-03-17","6",214,3512429,66
"11561","코코","2018-03-18","4",69,3512498,67
"11562","코코","2018-03-19","1",25,3512523,68
"11563","코코","2018-03-20","1",2,3512525,69
"11564","코코","2018-03-21","1",1,3512526,70
"11565","코코","2018-03-22","1",1,3512527,71
"11566","코코","2018-03-23","1",9,3512536,72
"11567","코코","2018-03-24","3",161,3512697,73
"11568","코코","2018-03-25","3",51,3512748,74
"11569","코코","2018-03-28","2",52,3512800,75
"11570","코코","2018-03-29","1",30,3512830,76
"11571","코코","2018-03-31","1",22,3512852,77
"11572","코코","2018-04-01","3",106,3512958,78
"11573","코코","2018-04-04","1",17,3512975,79
"11574","코코","2018-04-08","1",57,3513032,80
"11575","코코","2018-04-12","1",5,3513037,81
"11576","코코","2018-04-15","1",44,3513081,82
"11577","코코","2018-04-17","1",16,3513097,83
"11578","코코","2018-04-23","1",17,3513114,84
"11579","코코","2018-07-24","1",0,3513114,85
"11580","아쿠아맨","2018-12-12","1",175,175,0
"11581","아쿠아맨","2018-12-17","2",367,542,0
"11582","아쿠아맨","2018-12-18","21",5259,5801,0
"11583","아쿠아맨","2018-12-19","993",145383,151184,1
"11584","아쿠아맨","2018-12-20","1,060",132636,283820,2
"11585","아쿠아맨","2018-12-21","1,114",181806,465626,3
"11586","아쿠아맨","2018-12-22","1,192",378681,844307,4
"11587","아쿠아맨","2018-12-23","1,272",405753,1250060,5
"11588","아쿠아맨","2018-12-24","1,285",343758,1593818,6
"11589","아쿠아맨","2018-12-25","1,174",507940,2101758,7
"11590","아쿠아맨","2018-12-26","985",167392,2269150,8
"11591","아쿠아맨","2018-12-27","1,009",113341,2382491,9
"11592","아쿠아맨","2018-12-28","1,092",152165,2534656,10
"11593","아쿠아맨","2018-12-29","1,159",322870,2857526,11
"11594","아쿠아맨","2018-12-30","1,168",346637,3204163,12
"11595","아쿠아맨","2018-12-31","1,161",287694,3491857,13
"11596","아쿠아맨","2019-01-01","1,158",384106,3875963,14
"11597","아쿠아맨","2019-01-02","1,110",105089,3981052,15
"11598","아쿠아맨","2019-01-03","1,074",81399,4062451,16
"11599","아쿠아맨","2019-01-04","1,094",94390,4156841,17
"11600","아쿠아맨","2019-01-05","1,123",209224,4366065,18
"11601","아쿠아맨","2019-01-06","1,121",178306,4544371,19
"11602","아쿠아맨","2019-01-07","1,083",60679,4605050,20
"11603","아쿠아맨","2019-01-08","1,086",59260,4664310,21
"11604","아쿠아맨","2019-01-09","749",40815,4705125,22
"11605","아쿠아맨","2019-01-10","722",33396,4738521,23
"11606","아쿠아맨","2019-01-11","716",38741,4777262,24
"11607","아쿠아맨","2019-01-12","738",77639,4854901,25
"11608","아쿠아맨","2019-01-13","734",65834,4920735,26
"11609","아쿠아맨","2019-01-14","653",21105,4941840,27
"11610","아쿠아맨","2019-01-15","663",21064,4962904,28
"11611","아쿠아맨","2019-01-16","438",13701,4976605,29
"11612","아쿠아맨","2019-01-17","297",6784,4983389,30
"11613","아쿠아맨","2019-01-18","306",7576,4990965,31
"11614","아쿠아맨","2019-01-19","298",15300,5006265,32
"11615","아쿠아맨","2019-01-20","302",12970,5019235,33
"11616","아쿠아맨","2019-01-21","299",4694,5023929,34
"11617","아쿠아맨","2019-01-22","300",4572,5028501,35
"11618","아쿠아맨","2019-01-23","91",1375,5029876,36
"11619","아쿠아맨","2019-01-24","86",1253,5031129,37
"11620","아쿠아맨","2019-01-25","76",941,5032070,38
"11621","아쿠아맨","2019-01-26","70",1944,5034014,39
"11622","아쿠아맨","2019-01-27","63",1584,5035598,40
"11623","아쿠아맨","2019-01-28","64",855,5036453,41
"11624","아쿠아맨","2019-01-29","65",762,5037215,42
"11625","아쿠아맨","2019-01-30","2",31,5037246,43
"11626","아쿠아맨","2019-01-31","3",36,5037282,44
"11627","아쿠아맨","2019-02-01","2",54,5037336,45
"11628","아쿠아맨","2019-02-02","3",107,5037443,46
"11629","아쿠아맨","2019-02-03","3",66,5037509,47
"11630","아쿠아맨","2019-02-04","2",97,5037606,48
"11631","아쿠아맨","2019-02-05","2",64,5037670,49
"11632","아쿠아맨","2019-02-06","2",58,5037728,50
"11633","아쿠아맨","2019-02-07","2",19,5037747,51
"11634","아쿠아맨","2019-02-08","2",23,5037770,52
"11635","아쿠아맨","2019-02-09","3",40,5037810,53
"11636","아쿠아맨","2019-02-10","3",51,5037861,54
"11637","아쿠아맨","2019-02-11","4",23,5037884,55
"11638","아쿠아맨","2019-02-12","2",56,5037940,56
"11639","아쿠아맨","2019-02-13","2",194,5038134,57
"11640","인크레더블 2","2018-07-09","1",624,624,0
"11641","인크레더블 2","2018-07-11","1",624,1248,0
"11642","인크레더블 2","2018-07-13","7",1417,2665,0
"11643","인크레더블 2","2018-07-14","9",2156,4821,0
"11644","인크레더블 2","2018-07-15","2",402,5223,0
"11645","인크레더블 2","2018-07-17","4",1052,6275,0
"11646","인크레더블 2","2018-07-18","1,179",122594,128869,1
"11647","인크레더블 2","2018-07-19","1,190",113895,242764,2
"11648","인크레더블 2","2018-07-20","1,228",164820,407584,3
"11649","인크레더블 2","2018-07-21","1,550",477129,884713,4
"11650","인크레더블 2","2018-07-22","1,605",479789,1364502,5
"11651","인크레더블 2","2018-07-23","1,273",114940,1479442,6
"11652","인크레더블 2","2018-07-24","1,300",110999,1590441,7
"11653","인크레더블 2","2018-07-25","764",96978,1687419,8
"11654","인크레더블 2","2018-07-26","767",85590,1773009,9
"11655","인크레더블 2","2018-07-27","867",101879,1874888,10
"11656","인크레더블 2","2018-07-28","971",195044,2069932,11
"11657","인크레더블 2","2018-07-29","990",194293,2264225,12
"11658","인크레더블 2","2018-07-30","938",138068,2402293,13
"11659","인크레더블 2","2018-07-31","956",137023,2539316,14
"11660","인크레더블 2","2018-08-01","583",76950,2616266,15
"11661","인크레더블 2","2018-08-02","579",74011,2690277,16
"11662","인크레더블 2","2018-08-03","601",69504,2759781,17
"11663","인크레더블 2","2018-08-04","544",66556,2826337,18
"11664","인크레더블 2","2018-08-05","547",63091,2889428,19
"11665","인크레더블 2","2018-08-06","545",35772,2925200,20
"11666","인크레더블 2","2018-08-07","565",37942,2963142,21
"11667","인크레더블 2","2018-08-08","97",6124,2969266,22
"11668","인크레더블 2","2018-08-09","103",5634,2974900,23
"11669","인크레더블 2","2018-08-10","101",5287,2980187,24
"11670","인크레더블 2","2018-08-11","105",8809,2988996,25
"11671","인크레더블 2","2018-08-12","105",9019,2998015,26
"11672","인크레더블 2","2018-08-13","94",4027,3002042,27
"11673","인크레더블 2","2018-08-14","91",4045,3006087,28
"11674","인크레더블 2","2018-08-15","45",5710,3011797,29
"11675","인크레더블 2","2018-08-16","38",1948,3013745,30
"11676","인크레더블 2","2018-08-17","37",1623,3015368,31
"11677","인크레더블 2","2018-08-18","42",3788,3019156,32
"11678","인크레더블 2","2018-08-19","42",3302,3022458,33
"11679","인크레더블 2","2018-08-20","31",1044,3023502,34
"11680","인크레더블 2","2018-08-21","32",1144,3024646,35
"11681","인크레더블 2","2018-08-22","21",851,3025497,36
"11682","인크레더블 2","2018-08-23","13",265,3025762,37
"11683","인크레더블 2","2018-08-24","16",595,3026357,38
"11684","인크레더블 2","2018-08-25","27",1750,3028107,39
"11685","인크레더블 2","2018-08-26","27",1512,3029619,40
"11686","인크레더블 2","2018-08-27","14",466,3030085,41
"11687","인크레더블 2","2018-08-28","12",281,3030366,42
"11688","인크레더블 2","2018-08-29","9",166,3030532,43
"11689","인크레더블 2","2018-08-30","6",62,3030594,44
"11690","인크레더블 2","2018-08-31","6",77,3030671,45
"11691","인크레더블 2","2018-09-01","14",515,3031186,46
"11692","인크레더블 2","2018-09-02","14",548,3031734,47
"11693","인크레더블 2","2018-09-03","5",53,3031787,48
"11694","인크레더블 2","2018-09-04","6",42,3031829,49
"11695","인크레더블 2","2018-09-05","6",48,3031877,50
"11696","인크레더블 2","2018-09-06","1",9,3031886,51
"11697","인크레더블 2","2018-09-07","2",229,3032115,52
"11698","인크레더블 2","2018-09-08","5",129,3032244,53
"11699","인크레더블 2","2018-09-09","4",180,3032424,54
"11700","인크레더블 2","2018-09-10","1",8,3032432,55
"11701","인크레더블 2","2018-09-11","5",244,3032676,56
"11702","인크레더블 2","2018-09-12","1",2,3032678,57
"11703","인크레더블 2","2018-09-14","1",6,3032684,58
"11704","인크레더블 2","2018-09-15","2",70,3032754,59
"11705","인크레더블 2","2018-09-16","2",86,3032840,60
"11706","인크레더블 2","2018-09-17","1",130,3032970,61
"11707","인크레더블 2","2018-09-18","1",2,3032972,62
"11708","인크레더블 2","2018-10-14","1",80,3033052,63
"11709","인크레더블 2","2019-01-29","1",53,3033105,64
"11710","서치","2018-08-14","1",406,406,0
"11711","서치","2018-08-22","7",1682,2088,0
"11712","서치","2018-08-23","5",938,3026,0
"11713","서치","2018-08-27","19",4926,7952,0
"11714","서치","2018-08-28","15",1220,9172,0
"11715","서치","2018-08-29","586",61992,71164,1
"11716","서치","2018-08-30","563",52833,123997,2
"11717","서치","2018-08-31","587",87528,211525,3
"11718","서치","2018-09-01","692",153209,364734,4
"11719","서치","2018-09-02","780",206159,570893,5
"11720","서치","2018-09-03","720",88550,659443,6
"11721","서치","2018-09-04","816",95270,754713,7
"11722","서치","2018-09-05","845",111131,865844,8
"11723","서치","2018-09-06","837",102103,967947,9
"11724","서치","2018-09-07","899",149890,1117837,10
"11725","서치","2018-09-08","1,088",310395,1428232,11
"11726","서치","2018-09-09","1,097",307407,1735639,12
"11727","서치","2018-09-10","939",80416,1816055,13
"11728","서치","2018-09-11","950",69861,1885916,14
"11729","서치","2018-09-12","748",65115,1951031,15
"11730","서치","2018-09-13","778",61177,2012208,16
"11731","서치","2018-09-14","845",97668,2109876,17
"11732","서치","2018-09-15","957",219852,2329728,18
"11733","서치","2018-09-16","953",187762,2517490,19
"11734","서치","2018-09-17","876",53553,2571043,20
"11735","서치","2018-09-18","891",48778,2619821,21
"11736","서치","2018-09-19","404",15419,2635240,22
"11737","서치","2018-09-20","373",13921,2649161,23
"11738","서치","2018-09-21","381",23101,2672262,24
"11739","서치","2018-09-22","367",30519,2702781,25
"11740","서치","2018-09-23","400",33427,2736208,26
"11741","서치","2018-09-24","398",36756,2772964,27
"11742","서치","2018-09-25","415",44457,2817421,28
"11743","서치","2018-09-26","336",32734,2850155,29
"11744","서치","2018-09-27","272",9643,2859798,30
"11745","서치","2018-09-28","296",13041,2872839,31
"11746","서치","2018-09-29","316",24282,2897121,32
"11747","서치","2018-09-30","308",21100,2918221,33
"11748","서치","2018-10-01","280",6622,2924843,34
"11749","서치","2018-10-02","288",8853,2933696,35
"11750","서치","2018-10-03","66",3832,2937528,36
"11751","서치","2018-10-04","51",1078,2938606,37
"11752","서치","2018-10-05","51",1640,2940246,38
"11753","서치","2018-10-06","52",2241,2942487,39
"11754","서치","2018-10-07","50",1846,2944333,40
"11755","서치","2018-10-08","52",1382,2945715,41
"11756","서치","2018-10-09","23",1406,2947121,42
"11757","서치","2018-10-10","20",327,2947448,43
"11758","서치","2018-10-11","13",214,2947662,44
"11759","서치","2018-10-12","16",458,2948120,45
"11760","서치","2018-10-13","13",441,2948561,46
"11761","서치","2018-10-14","12",258,2948819,47
"11762","서치","2018-10-15","12",112,2948931,48
"11763","서치","2018-10-16","8",117,2949048,49
"11764","서치","2018-10-17","12",342,2949390,50
"11765","서치","2018-10-18","3",27,2949417,51
"11766","서치","2018-10-19","4",197,2949614,52
"11767","서치","2018-10-20","3",43,2949657,53
"11768","서치","2018-10-21","3",26,2949683,54
"11769","서치","2018-10-22","3",26,2949709,55
"11770","서치","2018-10-23","2",16,2949725,56
"11771","서치","2018-10-24","3",29,2949754,57
"11772","서치","2018-10-25","1",7,2949761,58
"11773","서치","2018-10-26","1",22,2949783,59
"11774","서치","2018-10-27","1",18,2949801,60
"11775","서치","2018-10-28","1",2,2949803,61
"11776","서치","2018-10-29","1",11,2949814,62
"11777","서치","2018-10-30","1",13,2949827,63
"11778","서치","2018-10-31","1",14,2949841,64
"11779","서치","2018-11-02","1",99,2949940,65
"11780","서치","2018-11-04","1",4,2949944,66
"11781","서치","2019-01-29","3",153,2950097,67
"11782","신비한 동물들과 그린델왈드의 범죄","2018-11-13","9",2713,2713,0
"11783","신비한 동물들과 그린델왈드의 범죄","2018-11-14","1,564",272339,275052,1
"11784","신비한 동물들과 그린델왈드의 범죄","2018-11-15","1,601",221661,496713,2
"11785","신비한 동물들과 그린델왈드의 범죄","2018-11-16","1,577",231881,728594,3
"11786","신비한 동물들과 그린델왈드의 범죄","2018-11-17","1,512",434010,1162604,4
"11787","신비한 동물들과 그린델왈드의 범죄","2018-11-18","1,461",357249,1519853,5
"11788","신비한 동물들과 그린델왈드의 범죄","2018-11-19","1,308",88565,1608418,6
"11789","신비한 동물들과 그린델왈드의 범죄","2018-11-20","1,322",72181,1680599,7
"11790","신비한 동물들과 그린델왈드의 범죄","2018-11-21","1,204",75571,1756170,8
"11791","신비한 동물들과 그린델왈드의 범죄","2018-11-22","839",51520,1807690,9
"11792","신비한 동물들과 그린델왈드의 범죄","2018-11-23","843",74067,1881757,10
"11793","신비한 동물들과 그린델왈드의 범죄","2018-11-24","825",152406,2034163,11
"11794","신비한 동물들과 그린델왈드의 범죄","2018-11-25","777",131581,2165744,12
"11795","신비한 동물들과 그린델왈드의 범죄","2018-11-26","714",35476,2201220,13
"11796","신비한 동물들과 그린델왈드의 범죄","2018-11-27","734",32107,2233327,14
"11797","신비한 동물들과 그린델왈드의 범죄","2018-11-28","449",25230,2258557,15
"11798","신비한 동물들과 그린델왈드의 범죄","2018-11-29","405",15663,2274220,16
"11799","신비한 동물들과 그린델왈드의 범죄","2018-11-30","411",20743,2294963,17
"11800","신비한 동물들과 그린델왈드의 범죄","2018-12-01","409",35764,2330727,18
"11801","신비한 동물들과 그린델왈드의 범죄","2018-12-02","401",31454,2362181,19
"11802","신비한 동물들과 그린델왈드의 범죄","2018-12-03","379",9165,2371346,20
"11803","신비한 동물들과 그린델왈드의 범죄","2018-12-04","385",9314,2380660,21
"11804","신비한 동물들과 그린델왈드의 범죄","2018-12-05","146",3982,2384642,22
"11805","신비한 동물들과 그린델왈드의 범죄","2018-12-06","107",3459,2388101,23
"11806","신비한 동물들과 그린델왈드의 범죄","2018-12-07","117",3558,2391659,24
"11807","신비한 동물들과 그린델왈드의 범죄","2018-12-08","106",6476,2398135,25
"11808","신비한 동물들과 그린델왈드의 범죄","2018-12-09","100",5551,2403686,26
"11809","신비한 동물들과 그린델왈드의 범죄","2018-12-10","95",1661,2405347,27
"11810","신비한 동물들과 그린델왈드의 범죄","2018-12-11","101",1991,2407338,28
"11811","신비한 동물들과 그린델왈드의 범죄","2018-12-12","34",1178,2408516,29
"11812","신비한 동물들과 그린델왈드의 범죄","2018-12-13","27",1379,2409895,30
"11813","신비한 동물들과 그린델왈드의 범죄","2018-12-14","28",915,2410810,31
"11814","신비한 동물들과 그린델왈드의 범죄","2018-12-15","25",1111,2411921,32
"11815","신비한 동물들과 그린델왈드의 범죄","2018-12-16","26",1161,2413082,33
"11816","신비한 동물들과 그린델왈드의 범죄","2018-12-17","22",362,2413444,34
"11817","신비한 동물들과 그린델왈드의 범죄","2018-12-18","20",383,2413827,35
"11818","신비한 동물들과 그린델왈드의 범죄","2018-12-19","2",92,2413919,36
"11819","신비한 동물들과 그린델왈드의 범죄","2018-12-20","2",143,2414062,37
"11820","메이즈 러너: 데스 큐어","2018-01-10","2",427,427,0
"11821","메이즈 러너: 데스 큐어","2018-01-12","21",3299,3726,0
"11822","메이즈 러너: 데스 큐어","2018-01-16","3",1235,4961,0
"11823","메이즈 러너: 데스 큐어","2018-01-17","919",225510,230471,1
"11824","메이즈 러너: 데스 큐어","2018-01-18","979",166420,396891,2
"11825","메이즈 러너: 데스 큐어","2018-01-19","1,020",181345,578236,3
"11826","메이즈 러너: 데스 큐어","2018-01-20","1,090",366720,944956,4
"11827","메이즈 러너: 데스 큐어","2018-01-21","1,061",321000,1265956,5
"11828","메이즈 러너: 데스 큐어","2018-01-22","971",102561,1368517,6
"11829","메이즈 러너: 데스 큐어","2018-01-23","969",92062,1460579,7
"11830","메이즈 러너: 데스 큐어","2018-01-24","765",70060,1530639,8
"11831","메이즈 러너: 데스 큐어","2018-01-25","728",61865,1592504,9
"11832","메이즈 러너: 데스 큐어","2018-01-26","729",71141,1663645,10
"11833","메이즈 러너: 데스 큐어","2018-01-27","771",153963,1817608,11
"11834","메이즈 러너: 데스 큐어","2018-01-28","756",136107,1953715,12
"11835","메이즈 러너: 데스 큐어","2018-01-29","695",45377,1999092,13
"11836","메이즈 러너: 데스 큐어","2018-01-30","693",41173,2040265,14
"11837","메이즈 러너: 데스 큐어","2018-01-31","502",40704,2080969,15
"11838","메이즈 러너: 데스 큐어","2018-02-01","464",19624,2100593,16
"11839","메이즈 러너: 데스 큐어","2018-02-02","472",23569,2124162,17
"11840","메이즈 러너: 데스 큐어","2018-02-03","508",43638,2167800,18
"11841","메이즈 러너: 데스 큐어","2018-02-04","499",38545,2206345,19
"11842","메이즈 러너: 데스 큐어","2018-02-05","471",14653,2220998,20
"11843","메이즈 러너: 데스 큐어","2018-02-06","477",13318,2234316,21
"11844","메이즈 러너: 데스 큐어","2018-02-07","461",13804,2248120,22
"11845","메이즈 러너: 데스 큐어","2018-02-08","208",6486,2254606,23
"11846","메이즈 러너: 데스 큐어","2018-02-09","212",7484,2262090,24
"11847","메이즈 러너: 데스 큐어","2018-02-10","196",12293,2274383,25
"11848","메이즈 러너: 데스 큐어","2018-02-11","193",11051,2285434,26
"11849","메이즈 러너: 데스 큐어","2018-02-12","189",5155,2290589,27
"11850","메이즈 러너: 데스 큐어","2018-02-13","195",6105,2296694,28
"11851","메이즈 러너: 데스 큐어","2018-02-14","8",116,2296810,29
"11852","메이즈 러너: 데스 큐어","2018-02-15","6",106,2296916,30
"11853","메이즈 러너: 데스 큐어","2018-02-16","5",104,2297020,31
"11854","메이즈 러너: 데스 큐어","2018-02-17","7",115,2297135,32
"11855","메이즈 러너: 데스 큐어","2018-02-18","5",49,2297184,33
"11856","메이즈 러너: 데스 큐어","2018-02-19","8",170,2297354,34
"11857","메이즈 러너: 데스 큐어","2018-02-20","8",108,2297462,35
"11858","메이즈 러너: 데스 큐어","2018-02-21","6",121,2297583,36
"11859","메이즈 러너: 데스 큐어","2018-02-22","1",20,2297603,37
"11860","메이즈 러너: 데스 큐어","2018-02-23","1",20,2297623,38
"11861","메이즈 러너: 데스 큐어","2018-02-24","1",20,2297643,39
"11862","메이즈 러너: 데스 큐어","2018-02-25","1",20,2297663,40
"11863","메이즈 러너: 데스 큐어","2018-02-26","5",100,2297763,41
"11864","메이즈 러너: 데스 큐어","2018-02-27","5",100,2297863,42
"11865","메이즈 러너: 데스 큐어","2018-02-28","5",100,2297963,43
"11866","메이즈 러너: 데스 큐어","2018-03-01","5",100,2298063,44
"11867","메이즈 러너: 데스 큐어","2018-03-02","5",100,2298163,45
"11868","메이즈 러너: 데스 큐어","2018-03-03","5",130,2298293,46
"11869","메이즈 러너: 데스 큐어","2018-03-04","6",253,2298546,47
"11870","메이즈 러너: 데스 큐어","2018-03-05","4",70,2298616,48
"11871","메이즈 러너: 데스 큐어","2018-03-06","4",70,2298686,49
"11872","메이즈 러너: 데스 큐어","2018-03-07","4",70,2298756,50
"11873","메이즈 러너: 데스 큐어","2018-03-08","4",70,2298826,51
"11874","메이즈 러너: 데스 큐어","2018-03-09","4",70,2298896,52
"11875","메이즈 러너: 데스 큐어","2018-03-10","4",100,2298996,53
"11876","메이즈 러너: 데스 큐어","2018-03-11","4",100,2299096,54
"11877","메이즈 러너: 데스 큐어","2018-03-12","3",40,2299136,55
"11878","메이즈 러너: 데스 큐어","2018-03-13","3",40,2299176,56
"11879","메이즈 러너: 데스 큐어","2018-03-14","3",40,2299216,57
"11880","메이즈 러너: 데스 큐어","2018-03-15","3",40,2299256,58
"11881","메이즈 러너: 데스 큐어","2018-03-16","3",40,2299296,59
"11882","메이즈 러너: 데스 큐어","2018-03-17","3",70,2299366,60
"11883","메이즈 러너: 데스 큐어","2018-03-18","3",70,2299436,61
"11884","메이즈 러너: 데스 큐어","2018-03-19","1",10,2299446,62
"11885","메이즈 러너: 데스 큐어","2018-03-20","1",10,2299456,63
"11886","메이즈 러너: 데스 큐어","2018-03-21","1",10,2299466,64
"11887","메이즈 러너: 데스 큐어","2018-03-22","1",10,2299476,65
"11888","메이즈 러너: 데스 큐어","2018-03-23","1",10,2299486,66
"11889","메이즈 러너: 데스 큐어","2018-03-24","1",25,2299511,67
"11890","메이즈 러너: 데스 큐어","2018-03-25","1",25,2299536,68
"11891","메이즈 러너: 데스 큐어","2018-04-16","1",196,2299732,69
"11892","맘마미아!2","2018-07-18","1",406,406,0
"11893","맘마미아!2","2018-07-19","4",876,1282,0
"11894","맘마미아!2","2018-07-26","9",2726,4008,0
"11895","맘마미아!2","2018-07-28","20",2679,6687,0
"11896","맘마미아!2","2018-07-31","10",2006,8693,0
"11897","맘마미아!2","2018-08-01","6",499,9192,0
"11898","맘마미아!2","2018-08-02","11",2584,11776,0
"11899","맘마미아!2","2018-08-04","259",32146,43922,0
"11900","맘마미아!2","2018-08-05","264",31292,75214,0
"11901","맘마미아!2","2018-08-06","1",362,75576,0
"11902","맘마미아!2","2018-08-07","4",1077,76653,0
"11903","맘마미아!2","2018-08-08","750",145931,222584,1
"11904","맘마미아!2","2018-08-09","731",120030,342614,2
"11905","맘마미아!2","2018-08-10","703",127110,469724,3
"11906","맘마미아!2","2018-08-11","724",206422,676146,4
"11907","맘마미아!2","2018-08-12","711",185310,861456,5
"11908","맘마미아!2","2018-08-13","668",101551,963007,6
"11909","맘마미아!2","2018-08-14","704",124874,1087881,7
"11910","맘마미아!2","2018-08-15","623",130254,1218135,8
"11911","맘마미아!2","2018-08-16","620",65332,1283467,9
"11912","맘마미아!2","2018-08-17","648",71732,1355199,10
"11913","맘마미아!2","2018-08-18","667",119389,1474588,11
"11914","맘마미아!2","2018-08-19","683",107622,1582210,12
"11915","맘마미아!2","2018-08-20","626",51695,1633905,13
"11916","맘마미아!2","2018-08-21","631",53826,1687731,14
"11917","맘마미아!2","2018-08-22","505",44329,1732060,15
"11918","맘마미아!2","2018-08-23","506",31731,1763791,16
"11919","맘마미아!2","2018-08-24","551",45494,1809285,17
"11920","맘마미아!2","2018-08-25","568",79854,1889139,18
"11921","맘마미아!2","2018-08-26","567",67902,1957041,19
"11922","맘마미아!2","2018-08-27","526",27361,1984402,20
"11923","맘마미아!2","2018-08-28","530",28803,2013205,21
"11924","맘마미아!2","2018-08-29","421",34294,2047499,22
"11925","맘마미아!2","2018-08-30","413",21332,2068831,23
"11926","맘마미아!2","2018-08-31","432",25767,2094598,24
"11927","맘마미아!2","2018-09-01","452",33560,2128158,25
"11928","맘마미아!2","2018-09-02","450",30967,2159125,26
"11929","맘마미아!2","2018-09-03","414",12286,2171411,27
"11930","맘마미아!2","2018-09-04","407",12240,2183651,28
"11931","맘마미아!2","2018-09-05","411",12031,2195682,29
"11932","맘마미아!2","2018-09-06","325",8283,2203965,30
"11933","맘마미아!2","2018-09-07","348",9208,2213173,31
"11934","맘마미아!2","2018-09-08","363",16087,2229260,32
"11935","맘마미아!2","2018-09-09","360",17024,2246284,33
"11936","맘마미아!2","2018-09-10","333",5049,2251333,34
"11937","맘마미아!2","2018-09-11","352",6002,2257335,35
"11938","맘마미아!2","2018-09-12","165",2880,2260215,36
"11939","맘마미아!2","2018-09-13","163",2982,2263197,37
"11940","맘마미아!2","2018-09-14","181",3578,2266775,38
"11941","맘마미아!2","2018-09-15","202",6761,2273536,39
"11942","맘마미아!2","2018-09-16","203",6584,2280120,40
"11943","맘마미아!2","2018-09-17","185",2688,2282808,41
"11944","맘마미아!2","2018-09-18","184",2880,2285688,42
"11945","맘마미아!2","2018-09-19","10",340,2286028,43
"11946","맘마미아!2","2018-09-20","12",320,2286348,44
"11947","맘마미아!2","2018-09-21","17",432,2286780,45
"11948","맘마미아!2","2018-09-22","12",420,2287200,46
"11949","맘마미아!2","2018-09-23","18",652,2287852,47
"11950","맘마미아!2","2018-09-24","15",953,2288805,48
"11951","맘마미아!2","2018-09-25","19",1074,2289879,49
"11952","맘마미아!2","2018-09-26","15",959,2290838,50
"11953","맘마미아!2","2018-09-27","9",195,2291033,51
"11954","맘마미아!2","2018-09-28","8",263,2291296,52
"11955","맘마미아!2","2018-09-29","9",240,2291536,53
"11956","맘마미아!2","2018-09-30","11",363,2291899,54
"11957","맘마미아!2","2018-10-01","10",110,2292009,55
"11958","맘마미아!2","2018-10-02","10",165,2292174,56
"11959","맘마미아!2","2018-10-03","7",193,2292367,57
"11960","맘마미아!2","2018-10-04","2",18,2292385,58
"11961","맘마미아!2","2018-10-05","3",61,2292446,59
"11962","맘마미아!2","2018-10-06","3",72,2292518,60
"11963","맘마미아!2","2018-10-07","3",78,2292596,61
"11964","맘마미아!2","2018-10-08","4",106,2292702,62
"11965","맘마미아!2","2018-10-09","3",51,2292753,63
"11966","맘마미아!2","2018-10-10","3",24,2292777,64
"11967","맘마미아!2","2018-10-11","3",90,2292867,65
"11968","맘마미아!2","2018-10-12","2",25,2292892,66
"11969","맘마미아!2","2018-10-13","2",28,2292920,67
"11970","맘마미아!2","2018-10-14","2",24,2292944,68
"11971","맘마미아!2","2018-10-15","2",18,2292962,69
"11972","맘마미아!2","2018-10-16","3",142,2293104,70
"11973","맘마미아!2","2018-10-17","2",14,2293118,71
"11974","맘마미아!2","2018-10-18","2",16,2293134,72
"11975","맘마미아!2","2018-10-19","2",10,2293144,73
"11976","맘마미아!2","2018-10-20","2",13,2293157,74
"11977","맘마미아!2","2018-10-21","2",15,2293172,75
"11978","맘마미아!2","2018-10-22","2",13,2293185,76
"11979","맘마미아!2","2018-10-23","2",12,2293197,77
"11980","맘마미아!2","2018-10-24","3",277,2293474,78
"11981","맘마미아!2","2018-10-30","1",57,2293531,79
"11982","맘마미아!2","2018-10-31","1",57,2293588,80
"11983","맘마미아!2","2018-11-08","1",248,2293836,81
"11984","맘마미아!2","2018-12-13","1",12,2293848,82
"11985","맘마미아!2","2018-12-15","1",36,2293884,83
"11986","레디 플레이어 원","2018-03-20","2",802,802,0
"11987","레디 플레이어 원","2018-03-21","3",1395,2197,0
"11988","레디 플레이어 원","2018-03-26","4",1350,3547,0
"11989","레디 플레이어 원","2018-03-28","985",149784,153331,1
"11990","레디 플레이어 원","2018-03-29","965",91641,244972,2
"11991","레디 플레이어 원","2018-03-30","980",134675,379647,3
"11992","레디 플레이어 원","2018-03-31","1,079",323881,703528,4
"11993","레디 플레이어 원","2018-04-01","1,058",283181,986709,5
"11994","레디 플레이어 원","2018-04-02","959",74329,1061038,6
"11995","레디 플레이어 원","2018-04-03","982",63033,1124071,7
"11996","레디 플레이어 원","2018-04-04","962",68144,1192215,8
"11997","레디 플레이어 원","2018-04-05","819",60436,1252651,9
"11998","레디 플레이어 원","2018-04-06","845",87037,1339688,10
"11999","레디 플레이어 원","2018-04-07","889",209751,1549439,11
"12000","레디 플레이어 원","2018-04-08","888",176623,1726062,12
"12001","레디 플레이어 원","2018-04-09","786",43926,1769988,13
"12002","레디 플레이어 원","2018-04-10","777",38108,1808096,14
"12003","레디 플레이어 원","2018-04-11","786",43136,1851232,15
"12004","레디 플레이어 원","2018-04-12","531",23446,1874678,16
"12005","레디 플레이어 원","2018-04-13","559",37051,1911729,17
"12006","레디 플레이어 원","2018-04-14","585",87743,1999472,18
"12007","레디 플레이어 원","2018-04-15","583",66630,2066102,19
"12008","레디 플레이어 원","2018-04-16","507",16533,2082635,20
"12009","레디 플레이어 원","2018-04-17","515",14694,2097329,21
"12010","레디 플레이어 원","2018-04-18","499",14871,2112200,22
"12011","레디 플레이어 원","2018-04-19","429",12565,2124765,23
"12012","레디 플레이어 원","2018-04-20","444",19446,2144211,24
"12013","레디 플레이어 원","2018-04-21","503",41303,2185514,25
"12014","레디 플레이어 원","2018-04-22","494",37070,2222584,26
"12015","레디 플레이어 원","2018-04-23","446",10166,2232750,27
"12016","레디 플레이어 원","2018-04-24","442",9697,2242447,28
"12017","레디 플레이어 원","2018-04-25","40",802,2243249,29
"12018","레디 플레이어 원","2018-04-26","37",808,2244057,30
"12019","레디 플레이어 원","2018-04-27","35",639,2244696,31
"12020","레디 플레이어 원","2018-04-28","22",643,2245339,32
"12021","레디 플레이어 원","2018-04-29","25",983,2246322,33
"12022","레디 플레이어 원","2018-04-30","27",857,2247179,34
"12023","레디 플레이어 원","2018-05-01","9",887,2248066,35
"12024","레디 플레이어 원","2018-05-02","42",219,2248285,36
"12025","레디 플레이어 원","2018-05-03","43",408,2248693,37
"12026","레디 플레이어 원","2018-05-04","40",174,2248867,38
"12027","레디 플레이어 원","2018-05-05","42",380,2249247,39
"12028","레디 플레이어 원","2018-05-06","41",422,2249669,40
"12029","레디 플레이어 원","2018-05-07","8",303,2249972,41
"12030","레디 플레이어 원","2018-05-08","7",80,2250052,42
"12031","레디 플레이어 원","2018-05-09","4",93,2250145,43
"12032","레디 플레이어 원","2018-05-10","4",60,2250205,44
"12033","레디 플레이어 원","2018-05-11","6",148,2250353,45
"12034","레디 플레이어 원","2018-05-12","6",286,2250639,46
"12035","레디 플레이어 원","2018-05-13","7",287,2250926,47
"12036","레디 플레이어 원","2018-05-14","4",69,2250995,48
"12037","레디 플레이어 원","2018-05-15","6",100,2251095,49
"12038","레디 플레이어 원","2018-05-16","1",5,2251100,50
"12039","레디 플레이어 원","2018-05-17","1",6,2251106,51
"12040","레디 플레이어 원","2018-05-18","1",42,2251148,52
"12041","레디 플레이어 원","2018-05-19","2",93,2251241,53
"12042","레디 플레이어 원","2018-05-20","1",19,2251260,54
"12043","레디 플레이어 원","2018-05-21","1",19,2251279,55
"12044","레디 플레이어 원","2018-05-24","1",6,2251285,56
"12045","레디 플레이어 원","2018-05-25","2",14,2251299,57
"12046","레디 플레이어 원","2018-05-28","1",4,2251303,58
"12047","레디 플레이어 원","2018-05-29","1",2,2251305,59
"12048","레디 플레이어 원","2018-06-23","14",584,2251889,60
"12049","레디 플레이어 원","2018-06-24","14",525,2252414,61
"12050","레디 플레이어 원","2018-06-25","14",178,2252592,62
"12051","레디 플레이어 원","2018-06-26","14",161,2252753,63
"12052","레디 플레이어 원","2018-06-27","12",184,2252937,64
"12053","레디 플레이어 원","2018-06-28","13",182,2253119,65
"12054","레디 플레이어 원","2018-06-29","14",196,2253315,66
"12055","레디 플레이어 원","2018-06-30","14",402,2253717,67
"12056","레디 플레이어 원","2018-07-01","14",309,2254026,68
"12057","레디 플레이어 원","2018-07-02","14",198,2254224,69
"12058","레디 플레이어 원","2018-07-03","12",206,2254430,70
"12059","레디 플레이어 원","2018-07-04","1",0,2254430,71
"12060","레디 플레이어 원","2018-07-16","1",0,2254430,72
"12061","쥬만지: 새로운 세계","2017-11-28","1",679,679,0
"12062","쥬만지: 새로운 세계","2017-12-21","1",401,1080,0
"12063","쥬만지: 새로운 세계","2017-12-26","4",991,2071,0
"12064","쥬만지: 새로운 세계","2017-12-27","3",503,2574,0
"12065","쥬만지: 새로운 세계","2018-01-03","724",124781,127355,1
"12066","쥬만지: 새로운 세계","2018-01-04","746",107670,235025,2
"12067","쥬만지: 새로운 세계","2018-01-05","750",135352,370377,3
"12068","쥬만지: 새로운 세계","2018-01-06","780",268765,639142,4
"12069","쥬만지: 새로운 세계","2018-01-07","791",255402,894544,5
"12070","쥬만지: 새로운 세계","2018-01-08","729",86321,980865,6
"12071","쥬만지: 새로운 세계","2018-01-09","736",80591,1061456,7
"12072","쥬만지: 새로운 세계","2018-01-10","715",73997,1135453,8
"12073","쥬만지: 새로운 세계","2018-01-11","586",55686,1191139,9
"12074","쥬만지: 새로운 세계","2018-01-12","622",65831,1256970,10
"12075","쥬만지: 새로운 세계","2018-01-13","662",133379,1390349,11
"12076","쥬만지: 새로운 세계","2018-01-14","677",128642,1518991,12
"12077","쥬만지: 새로운 세계","2018-01-15","618",42915,1561906,13
"12078","쥬만지: 새로운 세계","2018-01-16","632",40360,1602266,14
"12079","쥬만지: 새로운 세계","2018-01-17","388",14390,1616656,15
"12080","쥬만지: 새로운 세계","2018-01-18","398",13139,1629795,16
"12081","쥬만지: 새로운 세계","2018-01-19","372",12593,1642388,17
"12082","쥬만지: 새로운 세계","2018-01-20","340",22832,1665220,18
"12083","쥬만지: 새로운 세계","2018-01-21","325",19430,1684650,19
"12084","쥬만지: 새로운 세계","2018-01-22","321",7317,1691967,20
"12085","쥬만지: 새로운 세계","2018-01-23","318",7734,1699701,21
"12086","쥬만지: 새로운 세계","2018-01-24","76",1911,1701612,22
"12087","쥬만지: 새로운 세계","2018-01-25","47",1211,1702823,23
"12088","쥬만지: 새로운 세계","2018-01-26","49",1246,1704069,24
"12089","쥬만지: 새로운 세계","2018-01-27","45",1968,1706037,25
"12090","쥬만지: 새로운 세계","2018-01-28","49",2177,1708214,26
"12091","쥬만지: 새로운 세계","2018-01-29","41",719,1708933,27
"12092","쥬만지: 새로운 세계","2018-01-30","45",1200,1710133,28
"12093","쥬만지: 새로운 세계","2018-01-31","8",197,1710330,29
"12094","쥬만지: 새로운 세계","2018-02-01","3",34,1710364,30
"12095","쥬만지: 새로운 세계","2018-02-02","3",41,1710405,31
"12096","쥬만지: 새로운 세계","2018-02-03","2",33,1710438,32
"12097","쥬만지: 새로운 세계","2018-02-04","1",64,1710502,33
"12098","쥬만지: 새로운 세계","2018-02-05","2",12,1710514,34
"12099","쥬만지: 새로운 세계","2018-02-06","2",22,1710536,35
"12100","쥬만지: 새로운 세계","2018-02-07","1",10,1710546,36
"12101","쥬만지: 새로운 세계","2018-02-14","2",100,1710646,37
"12102","쥬만지: 새로운 세계","2018-02-15","2",100,1710746,38
"12103","쥬만지: 새로운 세계","2018-02-16","2",100,1710846,39
"12104","쥬만지: 새로운 세계","2018-02-17","2",100,1710946,40
"12105","쥬만지: 새로운 세계","2018-02-18","2",100,1711046,41
"12106","쥬만지: 새로운 세계","2018-02-19","2",100,1711146,42
"12107","쥬만지: 새로운 세계","2018-02-20","2",100,1711246,43
"12108","램페이지","2018-04-09","12",3430,3430,0
"12109","램페이지","2018-04-11","2",297,3727,0
"12110","램페이지","2018-04-12","784",74779,78506,1
"12111","램페이지","2018-04-13","836",104368,182874,2
"12112","램페이지","2018-04-14","895",274338,457212,3
"12113","램페이지","2018-04-15","909",229406,686618,4
"12114","램페이지","2018-04-16","829",59825,746443,5
"12115","램페이지","2018-04-17","836",51625,798068,6
"12116","램페이지","2018-04-18","857",53267,851335,7
"12117","램페이지","2018-04-19","737",44323,895658,8
"12118","램페이지","2018-04-20","781",66901,962559,9
"12119","램페이지","2018-04-21","887",149580,1112139,10
"12120","램페이지","2018-04-22","879",147341,1259480,11
"12121","램페이지","2018-04-23","799",43247,1302727,12
"12122","램페이지","2018-04-24","817",35186,1337913,13
"12123","램페이지","2018-04-25","362",7263,1345176,14
"12124","램페이지","2018-04-26","344",4402,1349578,15
"12125","램페이지","2018-04-27","343",5361,1354939,16
"12126","램페이지","2018-04-28","301",9122,1364061,17
"12127","램페이지","2018-04-29","287",8596,1372657,18
"12128","램페이지","2018-04-30","300",5614,1378271,19
"12129","램페이지","2018-05-01","110",2607,1380878,20
"12130","램페이지","2018-05-02","93",959,1381837,21
"12131","램페이지","2018-05-03","36",419,1382256,22
"12132","램페이지","2018-05-04","38",751,1383007,23
"12133","램페이지","2018-05-05","29",572,1383579,24
"12134","램페이지","2018-05-06","29",739,1384318,25
"12135","램페이지","2018-05-07","34",535,1384853,26
"12136","램페이지","2018-05-08","37",315,1385168,27
"12137","램페이지","2018-05-09","10",41,1385209,28
"12138","램페이지","2018-05-10","5",29,1385238,29
"12139","램페이지","2018-05-11","7",25,1385263,30
"12140","램페이지","2018-05-12","7",71,1385334,31
"12141","램페이지","2018-05-13","9",129,1385463,32
"12142","램페이지","2018-05-14","4",24,1385487,33
"12143","램페이지","2018-05-15","6",19,1385506,34
"12144","램페이지","2018-05-16","2",5,1385511,35
"12145","오션스8","2018-05-23","1",306,306,0
"12146","오션스8","2018-05-28","1",342,648,0
"12147","오션스8","2018-06-07","9",2824,3472,0
"12148","오션스8","2018-06-08","6",1259,4731,0
"12149","오션스8","2018-06-13","837",195523,200254,1
"12150","오션스8","2018-06-14","799",65614,265868,2
"12151","오션스8","2018-06-15","821",84362,350230,3
"12152","오션스8","2018-06-16","788",150590,500820,4
"12153","오션스8","2018-06-17","778",120240,621060,5
"12154","오션스8","2018-06-18","777",38237,659297,6
"12155","오션스8","2018-06-19","775",46821,706118,7
"12156","오션스8","2018-06-20","683",51431,757549,8
"12157","오션스8","2018-06-21","622",48008,805557,9
"12158","오션스8","2018-06-22","659",60297,865854,10
"12159","오션스8","2018-06-23","680",94855,960709,11
"12160","오션스8","2018-06-24","676",86728,1047437,12
"12161","오션스8","2018-06-25","656",39072,1086509,13
"12162","오션스8","2018-06-26","660",36906,1123415,14
"12163","오션스8","2018-06-27","451",40374,1163789,15
"12164","오션스8","2018-06-28","429",19837,1183626,16
"12165","오션스8","2018-06-29","438",25230,1208856,17
"12166","오션스8","2018-06-30","456",43517,1252373,18
"12167","오션스8","2018-07-01","461",32498,1284871,19
"12168","오션스8","2018-07-02","408",14222,1299093,20
"12169","오션스8","2018-07-03","418",14628,1313721,21
"12170","오션스8","2018-07-04","83",2416,1316137,22
"12171","오션스8","2018-07-05","81",2295,1318432,23
"12172","오션스8","2018-07-06","89",3188,1321620,24
"12173","오션스8","2018-07-07","70",2959,1324579,25
"12174","오션스8","2018-07-08","70",2213,1326792,26
"12175","오션스8","2018-07-09","84",1713,1328505,27
"12176","오션스8","2018-07-10","81",2435,1330940,28
"12177","오션스8","2018-07-11","30",922,1331862,29
"12178","오션스8","2018-07-12","25",535,1332397,30
"12179","오션스8","2018-07-13","21",583,1332980,31
"12180","오션스8","2018-07-14","19",784,1333764,32
"12181","오션스8","2018-07-15","18",710,1334474,33
"12182","오션스8","2018-07-16","20",398,1334872,34
"12183","오션스8","2018-07-17","23",403,1335275,35
"12184","오션스8","2018-07-18","5",85,1335360,36
"12185","오션스8","2018-07-19","4",42,1335402,37
"12186","오션스8","2018-07-20","4",62,1335464,38
"12187","오션스8","2018-07-21","4",100,1335564,39
"12188","오션스8","2018-07-22","4",66,1335630,40
"12189","오션스8","2018-07-23","4",41,1335671,41
"12190","오션스8","2018-07-24","4",75,1335746,42
"12191","오션스8","2018-07-26","1",83,1335829,43
"12192","범블비","2018-12-17","2",483,483,0
"12193","범블비","2018-12-19","4",1361,1844,0
"12194","범블비","2018-12-20","1",144,1988,0
"12195","범블비","2018-12-21","10",1348,3336,0
"12196","범블비","2018-12-22","2",365,3701,0
"12197","범블비","2018-12-24","722",85275,88976,0
"12198","범블비","2018-12-25","1,016",441893,530869,1
"12199","범블비","2018-12-26","898",100536,631405,2
"12200","범블비","2018-12-27","879",56449,687854,3
"12201","범블비","2018-12-28","843",72508,760362,4
"12202","범블비","2018-12-29","841",147031,907393,5
"12203","범블비","2018-12-30","815",148750,1056143,6
"12204","범블비","2018-12-31","799",111007,1167150,7
"12205","범블비","2019-01-01","766",132618,1299768,8
"12206","범블비","2019-01-02","719",35828,1335596,9
"12207","범블비","2019-01-03","656",25065,1360661,10
"12208","범블비","2019-01-04","657",29301,1389962,11
"12209","범블비","2019-01-05","662",54071,1444033,12
"12210","범블비","2019-01-06","678",46067,1490100,13
"12211","범블비","2019-01-07","632",16234,1506334,14
"12212","범블비","2019-01-08","632",16357,1522691,15
"12213","범블비","2019-01-09","357",6213,1528904,16
"12214","범블비","2019-01-10","300",4617,1533521,17
"12215","범블비","2019-01-11","279",4750,1538271,18
"12216","범블비","2019-01-12","266",8556,1546827,19
"12217","범블비","2019-01-13","251",6664,1553491,20
"12218","범블비","2019-01-14","244",2425,1555916,21
"12219","범블비","2019-01-15","243",2956,1558872,22
"12220","범블비","2019-01-16","23",576,1559448,23
"12221","범블비","2019-01-17","14",163,1559611,24
"12222","범블비","2019-01-18","21",172,1559783,25
"12223","범블비","2019-01-19","9",347,1560130,26
"12224","범블비","2019-01-20","7",255,1560385,27
"12225","범블비","2019-01-21","8",98,1560483,28
"12226","범블비","2019-01-22","7",117,1560600,29
"12227","범블비","2019-01-23","1",15,1560615,30
"12228","범블비","2019-01-24","2",37,1560652,31
"12229","범블비","2019-01-27","1",1,1560653,32
"12230","범블비","2019-01-29","1",21,1560674,33
"12231","범블비","2019-02-13","2",624,1561298,34
"12232","범블비","2019-02-14","1",345,1561643,35
"12233","퍼시픽 림: 업라이징","2018-03-16","1",200,200,0
"12234","퍼시픽 림: 업라이징","2018-03-21","1,105",114862,115062,1
"12235","퍼시픽 림: 업라이징","2018-03-22","1,064",87997,203059,2
"12236","퍼시픽 림: 업라이징","2018-03-23","1,092",119455,322514,3
"12237","퍼시픽 림: 업라이징","2018-03-24","1,145",296735,619249,4
"12238","퍼시픽 림: 업라이징","2018-03-25","1,125",239152,858401,5
"12239","퍼시픽 림: 업라이징","2018-03-26","1,027",48325,906726,6
"12240","퍼시픽 림: 업라이징","2018-03-27","1,038",39970,946696,7
"12241","퍼시픽 림: 업라이징","2018-03-28","550",23378,970074,8
"12242","퍼시픽 림: 업라이징","2018-03-29","521",11903,981977,9
"12243","퍼시픽 림: 업라이징","2018-03-30","502",14592,996569,10
"12244","퍼시픽 림: 업라이징","2018-03-31","486",30357,1026926,11
"12245","퍼시픽 림: 업라이징","2018-04-01","489",25460,1052386,12
"12246","퍼시픽 림: 업라이징","2018-04-02","427",6320,1058706,13
"12247","퍼시픽 림: 업라이징","2018-04-03","434",5016,1063722,14
"12248","퍼시픽 림: 업라이징","2018-04-04","353",4543,1068265,15
"12249","퍼시픽 림: 업라이징","2018-04-05","57",864,1069129,16
"12250","퍼시픽 림: 업라이징","2018-04-06","59",1082,1070211,17
"12251","퍼시픽 림: 업라이징","2018-04-07","45",1899,1072110,18
"12252","퍼시픽 림: 업라이징","2018-04-08","50",1753,1073863,19
"12253","퍼시픽 림: 업라이징","2018-04-09","42",409,1074272,20
"12254","퍼시픽 림: 업라이징","2018-04-10","43",334,1074606,21
"12255","퍼시픽 림: 업라이징","2018-04-11","44",457,1075063,22
"12256","퍼시픽 림: 업라이징","2018-04-12","6",19,1075082,23
"12257","퍼시픽 림: 업라이징","2018-04-13","9",159,1075241,24
"12258","퍼시픽 림: 업라이징","2018-04-14","6",195,1075436,25
"12259","퍼시픽 림: 업라이징","2018-04-15","5",173,1075609,26
"12260","퍼시픽 림: 업라이징","2018-04-16","4",16,1075625,27
"12261","퍼시픽 림: 업라이징","2018-04-17","3",20,1075645,28
"12262","퍼시픽 림: 업라이징","2018-04-18","20",462,1076107,29
"12263","퍼시픽 림: 업라이징","2018-04-19","3",292,1076399,30
"12264","퍼시픽 림: 업라이징","2018-04-20","2",40,1076439,31
"12265","퍼시픽 림: 업라이징","2018-04-21","7",95,1076534,32
"12266","퍼시픽 림: 업라이징","2018-04-22","6",91,1076625,33
"12267","퍼시픽 림: 업라이징","2018-04-23","3",49,1076674,34
"12268","퍼시픽 림: 업라이징","2018-04-24","3",41,1076715,35
"12269","퍼시픽 림: 업라이징","2018-04-25","2",40,1076755,36
"12270","퍼시픽 림: 업라이징","2018-04-26","2",40,1076795,37
"12271","퍼시픽 림: 업라이징","2018-04-27","2",40,1076835,38
"12272","퍼시픽 림: 업라이징","2018-04-28","2",40,1076875,39
"12273","퍼시픽 림: 업라이징","2018-04-29","2",40,1076915,40
"12274","퍼시픽 림: 업라이징","2018-04-30","2",40,1076955,41
"12275","퍼시픽 림: 업라이징","2018-05-01","2",40,1076995,42
"12276","퍼시픽 림: 업라이징","2018-05-02","2",40,1077035,43
"12277","퍼시픽 림: 업라이징","2018-05-03","2",40,1077075,44
"12278","퍼시픽 림: 업라이징","2018-05-04","2",40,1077115,45
"12279","퍼시픽 림: 업라이징","2018-05-05","2",40,1077155,46
"12280","퍼시픽 림: 업라이징","2018-05-06","2",40,1077195,47
"12281","퍼시픽 림: 업라이징","2018-05-07","2",40,1077235,48
"12282","몬스터 호텔 3","2018-07-25","1",214,214,0
"12283","몬스터 호텔 3","2018-08-06","3",516,730,0
"12284","몬스터 호텔 3","2018-08-08","632",86565,87295,1
"12285","몬스터 호텔 3","2018-08-09","649",77966,165261,2
"12286","몬스터 호텔 3","2018-08-10","687",69844,235105,3
"12287","몬스터 호텔 3","2018-08-11","715",138178,373283,4
"12288","몬스터 호텔 3","2018-08-12","710",138065,511348,5
"12289","몬스터 호텔 3","2018-08-13","640",51538,562886,6
"12290","몬스터 호텔 3","2018-08-14","665",53770,616656,7
"12291","몬스터 호텔 3","2018-08-15","572",114535,731191,8
"12292","몬스터 호텔 3","2018-08-16","489",29632,760823,9
"12293","몬스터 호텔 3","2018-08-17","493",28355,789178,10
"12294","몬스터 호텔 3","2018-08-18","559",59905,849083,11
"12295","몬스터 호텔 3","2018-08-19","534",55423,904506,12
"12296","몬스터 호텔 3","2018-08-20","451",14934,919440,13
"12297","몬스터 호텔 3","2018-08-21","459",16300,935740,14
"12298","몬스터 호텔 3","2018-08-22","335",11347,947087,15
"12299","몬스터 호텔 3","2018-08-23","250",5857,952944,16
"12300","몬스터 호텔 3","2018-08-24","274",12923,965867,17
"12301","몬스터 호텔 3","2018-08-25","400",27736,993603,18
"12302","몬스터 호텔 3","2018-08-26","408",30027,1023630,19
"12303","몬스터 호텔 3","2018-08-27","218",2788,1026418,20
"12304","몬스터 호텔 3","2018-08-28","226",2903,1029321,21
"12305","몬스터 호텔 3","2018-08-29","109",2090,1031411,22
"12306","몬스터 호텔 3","2018-08-30","100",1768,1033179,23
"12307","몬스터 호텔 3","2018-08-31","108",2167,1035346,24
"12308","몬스터 호텔 3","2018-09-01","209",10865,1046211,25
"12309","몬스터 호텔 3","2018-09-02","204",10618,1056829,26
"12310","몬스터 호텔 3","2018-09-03","76",388,1057217,27
"12311","몬스터 호텔 3","2018-09-04","75",471,1057688,28
"12312","몬스터 호텔 3","2018-09-05","66",410,1058098,29
"12313","몬스터 호텔 3","2018-09-06","25",178,1058276,30
"12314","몬스터 호텔 3","2018-09-07","38",283,1058559,31
"12315","몬스터 호텔 3","2018-09-08","100",3877,1062436,32
"12316","몬스터 호텔 3","2018-09-09","108",5738,1068174,33
"12317","몬스터 호텔 3","2018-09-10","28",136,1068310,34
"12318","몬스터 호텔 3","2018-09-11","23",91,1068401,35
"12319","몬스터 호텔 3","2018-09-12","5",121,1068522,36
"12320","몬스터 호텔 3","2018-09-13","5",107,1068629,37
"12321","몬스터 호텔 3","2018-09-14","7",185,1068814,38
"12322","몬스터 호텔 3","2018-09-15","40",1631,1070445,39
"12323","몬스터 호텔 3","2018-09-16","44",1674,1072119,40
"12324","몬스터 호텔 3","2018-09-17","3",34,1072153,41
"12325","몬스터 호텔 3","2018-09-18","5",50,1072203,42
"12326","몬스터 호텔 3","2018-09-19","3",17,1072220,43
"12327","더 넌","2018-09-06","1",306,306,0
"12328","더 넌","2018-09-13","17",3175,3481,0
"12329","더 넌","2018-09-14","1",170,3651,0
"12330","더 넌","2018-09-19","682",98719,102370,1
"12331","더 넌","2018-09-20","701",76112,178482,2
"12332","더 넌","2018-09-21","760",118624,297106,3
"12333","더 넌","2018-09-22","824",150142,447248,4
"12334","더 넌","2018-09-23","775",97586,544834,5
"12335","더 넌","2018-09-24","698",82000,626834,6
"12336","더 넌","2018-09-25","679",104359,731193,7
"12337","더 넌","2018-09-26","603",89503,820696,8
"12338","더 넌","2018-09-27","544",26735,847431,9
"12339","더 넌","2018-09-28","562",30279,877710,10
"12340","더 넌","2018-09-29","557",49428,927138,11
"12341","더 넌","2018-09-30","562",37516,964654,12
"12342","더 넌","2018-10-01","499",12348,977002,13
"12343","더 넌","2018-10-02","510",15950,992952,14
"12344","더 넌","2018-10-03","121",4166,997118,15
"12345","더 넌","2018-10-04","120",1656,998774,16
"12346","더 넌","2018-10-05","118",3352,1002126,17
"12347","더 넌","2018-10-06","97",2854,1004980,18
"12348","더 넌","2018-10-07","93",2386,1007366,19
"12349","더 넌","2018-10-08","106",2061,1009427,20
"12350","더 넌","2018-10-09","38",906,1010333,21
"12351","더 넌","2018-10-10","25",305,1010638,22
"12352","더 넌","2018-10-11","5",52,1010690,23
"12353","더 넌","2018-10-12","10",179,1010869,24
"12354","더 넌","2018-10-13","11",166,1011035,25
"12355","더 넌","2018-10-14","9",136,1011171,26
"12356","더 넌","2018-10-15","6",42,1011213,27
"12357","더 넌","2018-10-16","8",49,1011262,28
"12358","더 넌","2018-10-17","5",19,1011281,29
"12359","더 넌","2018-10-19","1",1,1011282,30
"12360","더 넌","2018-10-20","1",1,1011283,31
"12361","더 넌","2018-10-21","1",1,1011284,32
"12362","더 넌","2018-10-22","1",1,1011285,33
"12363","더 넌","2018-10-23","1",1,1011286,34
"12364","더 넌","2018-10-24","1",1,1011287,35
"12365","더 넌","2018-10-30","1",98,1011385,36
"12366","더 넌","2018-10-31","1",98,1011483,37
"12367","더 넌","2018-11-01","1",97,1011580,38
"12368","스카이스크래퍼","2018-07-05","2",846,846,0
"12369","스카이스크래퍼","2018-07-10","1",262,1108,0
"12370","스카이스크래퍼","2018-07-11","808",78615,79723,1
"12371","스카이스크래퍼","2018-07-12","831",71383,151106,2
"12372","스카이스크래퍼","2018-07-13","812",90555,241661,3
"12373","스카이스크래퍼","2018-07-14","793",193028,434689,4
"12374","스카이스크래퍼","2018-07-15","791",181248,615937,5
"12375","스카이스크래퍼","2018-07-16","771",56277,672214,6
"12376","스카이스크래퍼","2018-07-17","777",50327,722541,7
"12377","스카이스크래퍼","2018-07-18","609",35234,757775,8
"12378","스카이스크래퍼","2018-07-19","595",29197,786972,9
"12379","스카이스크래퍼","2018-07-20","607",38283,825255,10
"12380","스카이스크래퍼","2018-07-21","606",65048,890303,11
"12381","스카이스크래퍼","2018-07-22","628",61385,951688,12
"12382","스카이스크래퍼","2018-07-23","586",22790,974478,13
"12383","스카이스크래퍼","2018-07-24","602",21621,996099,14
"12384","스카이스크래퍼","2018-07-25","65",979,997078,15
"12385","스카이스크래퍼","2018-07-26","64",711,997789,16
"12386","스카이스크래퍼","2018-07-27","56",613,998402,17
"12387","스카이스크래퍼","2018-07-28","54",746,999148,18
"12388","스카이스크래퍼","2018-07-29","45",830,999978,19
"12389","스카이스크래퍼","2018-07-30","39",461,1000439,20
"12390","스카이스크래퍼","2018-07-31","48",612,1001051,21
"12391","스카이스크래퍼","2018-08-01","3",41,1001092,22
"12392","스카이스크래퍼","2018-08-02","3",21,1001113,23
"12393","스카이스크래퍼","2018-08-03","3",21,1001134,24
"12394","스카이스크래퍼","2018-08-04","2",19,1001153,25
"12395","스카이스크래퍼","2018-08-05","1",7,1001160,26
"12396","스카이스크래퍼","2018-08-08","10",345,1001505,27
"12397","스카이스크래퍼","2018-08-09","2",60,1001565,28
"12398","스카이스크래퍼","2018-08-10","2",69,1001634,29
"12399","스카이스크래퍼","2018-08-11","2",103,1001737,30
"12400","스카이스크래퍼","2018-08-12","2",93,1001830,31
"12401","스카이스크래퍼","2018-08-13","2",61,1001891,32
"12402","스카이스크래퍼","2018-08-14","2",61,1001952,33
"12403","스카이스크래퍼","2018-08-15","2",92,1002044,34
"12404","스카이스크래퍼","2018-08-16","2",60,1002104,35
"12405","스카이스크래퍼","2018-08-17","2",64,1002168,36
"12406","스카이스크래퍼","2018-08-18","2",63,1002231,37
"12407","스카이스크래퍼","2018-08-19","2",65,1002296,38
"12408","스카이스크래퍼","2018-08-20","2",61,1002357,39
"12409","스카이스크래퍼","2018-08-21","2",60,1002417,40
"12410","스카이스크래퍼","2018-08-22","2",61,1002478,41
"12411","스카이스크래퍼","2018-08-23","2",63,1002541,42
"12412","스카이스크래퍼","2018-08-24","2",65,1002606,43
"12413","스카이스크래퍼","2018-08-25","2",66,1002672,44
"12414","스카이스크래퍼","2018-08-26","2",65,1002737,45
"12415","스카이스크래퍼","2018-08-27","2",61,1002798,46
"12416","스카이스크래퍼","2018-08-28","2",60,1002858,47
"12417","월요일이 사라졌다","2018-02-14","1",126,126,0
"12418","월요일이 사라졌다","2018-02-19","1",99,225,0
"12419","월요일이 사라졌다","2018-02-20","19",2449,2674,0
"12420","월요일이 사라졌다","2018-02-22","245",26575,29249,1
"12421","월요일이 사라졌다","2018-02-23","267",44364,73613,2
"12422","월요일이 사라졌다","2018-02-24","309",91326,164939,3
"12423","월요일이 사라졌다","2018-02-25","355",102956,267895,4
"12424","월요일이 사라졌다","2018-02-26","339",62049,329944,5
"12425","월요일이 사라졌다","2018-02-27","353",58433,388377,6
"12426","월요일이 사라졌다","2018-02-28","321",81308,469685,7
"12427","월요일이 사라졌다","2018-03-01","381",105146,574831,8
"12428","월요일이 사라졌다","2018-03-02","353",41821,616652,9
"12429","월요일이 사라졌다","2018-03-03","371",80484,697136,10
"12430","월요일이 사라졌다","2018-03-04","351",65563,762699,11
"12431","월요일이 사라졌다","2018-03-05","304",19965,782664,12
"12432","월요일이 사라졌다","2018-03-06","306",16109,798773,13
"12433","월요일이 사라졌다","2018-03-07","220",11643,810416,14
"12434","월요일이 사라졌다","2018-03-08","182",8725,819141,15
"12435","월요일이 사라졌다","2018-03-09","183",10652,829793,16
"12436","월요일이 사라졌다","2018-03-10","195",23249,853042,17
"12437","월요일이 사라졌다","2018-03-11","186",19139,872181,18
"12438","월요일이 사라졌다","2018-03-12","175",5164,877345,19
"12439","월요일이 사라졌다","2018-03-13","181",4656,882001,20
"12440","월요일이 사라졌다","2018-03-14","112",2387,884388,21
"12441","월요일이 사라졌다","2018-03-15","112",2133,886521,22
"12442","월요일이 사라졌다","2018-03-16","116",2643,889164,23
"12443","월요일이 사라졌다","2018-03-17","123",4975,894139,24
"12444","월요일이 사라졌다","2018-03-18","117",4249,898388,25
"12445","월요일이 사라졌다","2018-03-19","106",1707,900095,26
"12446","월요일이 사라졌다","2018-03-20","110",1277,901372,27
"12447","월요일이 사라졌다","2018-03-21","42",362,901734,28
"12448","월요일이 사라졌다","2018-03-22","25",144,901878,29
"12449","월요일이 사라졌다","2018-03-23","27",198,902076,30
"12450","월요일이 사라졌다","2018-03-24","19",273,902349,31
"12451","월요일이 사라졌다","2018-03-25","19",244,902593,32
"12452","월요일이 사라졌다","2018-03-26","24",163,902756,33
"12453","월요일이 사라졌다","2018-03-27","25",178,902934,34
"12454","월요일이 사라졌다","2018-03-28","2",7,902941,35
"12455","월요일이 사라졌다","2018-03-29","5",23,902964,36
"12456","월요일이 사라졌다","2018-03-30","3",16,902980,37
"12457","월요일이 사라졌다","2018-03-31","4",29,903009,38
"12458","월요일이 사라졌다","2018-04-01","2",6,903015,39
"12459","월요일이 사라졌다","2018-04-02","4",16,903031,40
"12460","월요일이 사라졌다","2018-04-03","3",6,903037,41
"12461","월요일이 사라졌다","2018-04-04","1",2,903039,42
"12462","월요일이 사라졌다","2018-04-05","1",1,903040,43
"12463","월요일이 사라졌다","2018-04-08","1",2,903042,44
"12464","월요일이 사라졌다","2018-04-12","1",11,903053,45
"12465","월요일이 사라졌다","2018-04-13","1",3,903056,46
"12466","월요일이 사라졌다","2018-04-14","1",5,903061,47
"12467","월요일이 사라졌다","2018-04-19","1",8,903069,48
"12468","월요일이 사라졌다","2018-04-20","1",1,903070,49
"12469","월요일이 사라졌다","2018-04-21","1",3,903073,50
"12470","월요일이 사라졌다","2018-04-27","1",3,903076,51
"12471","월요일이 사라졌다","2018-05-01","1",99,903175,52
"12472","퍼스트맨","2018-10-11","1",624,624,0
"12473","퍼스트맨","2018-10-17","17",1803,2427,0
"12474","퍼스트맨","2018-10-18","1,137",70842,73269,1
"12475","퍼스트맨","2018-10-19","1,190",85151,158420,2
"12476","퍼스트맨","2018-10-20","1,131",145686,304106,3
"12477","퍼스트맨","2018-10-21","1,101",119086,423192,4
"12478","퍼스트맨","2018-10-22","999",33950,457142,5
"12479","퍼스트맨","2018-10-23","993",29040,486182,6
"12480","퍼스트맨","2018-10-24","969",33203,519385,7
"12481","퍼스트맨","2018-10-25","578",16455,535840,8
"12482","퍼스트맨","2018-10-26","609",25637,561477,9
"12483","퍼스트맨","2018-10-27","568",37173,598650,10
"12484","퍼스트맨","2018-10-28","556",31820,630470,11
"12485","퍼스트맨","2018-10-29","517",9331,639801,12
"12486","퍼스트맨","2018-10-30","506",10537,650338,13
"12487","퍼스트맨","2018-10-31","116",3856,654194,14
"12488","퍼스트맨","2018-11-01","94",1549,655743,15
"12489","퍼스트맨","2018-11-02","89",1456,657199,16
"12490","퍼스트맨","2018-11-03","66",1819,659018,17
"12491","퍼스트맨","2018-11-04","62",1541,660559,18
"12492","퍼스트맨","2018-11-05","56",896,661455,19
"12493","퍼스트맨","2018-11-06","53",591,662046,20
"12494","퍼스트맨","2018-11-07","10",376,662422,21
"12495","퍼스트맨","2018-11-08","4",154,662576,22
"12496","퍼스트맨","2018-11-09","10",605,663181,23
"12497","퍼스트맨","2018-11-10","3",134,663315,24
"12498","퍼스트맨","2018-11-11","3",82,663397,25
"12499","퍼스트맨","2018-11-12","3",48,663445,26
"12500","퍼스트맨","2018-11-13","3",33,663478,27
"12501","퍼스트맨","2018-11-14","1",32,663510,28
"12502","퍼스트맨","2018-11-15","6",320,663830,29
"12503","퍼스트맨","2018-11-16","2",100,663930,30
"12504","퍼스트맨","2018-11-17","3",313,664243,31
"12505","퍼스트맨","2018-11-18","2",93,664336,32
"12506","퍼스트맨","2018-11-19","2",65,664401,33
"12507","퍼스트맨","2018-11-20","2",70,664471,34
"12508","퍼스트맨","2018-11-21","2",71,664542,35
"12509","퍼스트맨","2018-11-22","2",69,664611,36
"12510","퍼스트맨","2018-11-23","2",71,664682,37
"12511","퍼스트맨","2018-11-24","2",86,664768,38
"12512","퍼스트맨","2018-11-25","2",88,664856,39
"12513","퍼스트맨","2018-11-26","2",67,664923,40
"12514","퍼스트맨","2018-11-27","2",65,664988,41
"12515","퍼스트맨","2018-11-28","2",65,665053,42
"12516","퍼스트맨","2018-11-29","2",65,665118,43
"12517","퍼스트맨","2018-11-30","2",63,665181,44
"12518","퍼스트맨","2018-12-01","1",6,665187,45
"12519","퍼스트맨","2018-12-02","1",4,665191,46
"12520","퍼스트맨","2018-12-03","1",4,665195,47
"12521","퍼스트맨","2018-12-04","1",3,665198,48
"12522","퍼스트맨","2018-12-05","1",2,665200,49
"12523","퍼스트맨","2018-12-14","1",13,665213,50
"12524","퍼스트맨","2018-12-31","1",151,665364,51
"12525","퍼스트맨","2019-02-02","1",50,665414,52
"12526","퍼스트맨","2019-02-03","1",39,665453,53
"12527","퍼스트맨","2019-02-04","1",17,665470,54
"12528","퍼스트맨","2019-02-06","1",27,665497,55
"12529","퍼스트맨","2019-02-08","2",25,665522,56
"12530","퍼스트맨","2019-02-09","5",154,665676,57
"12531","퍼스트맨","2019-02-10","2",35,665711,58
"12532","퍼스트맨","2019-02-11","1",10,665721,59
"12533","퍼스트맨","2019-02-12","2",31,665752,60
"12534","퍼스트맨","2019-02-13","1",28,665780,61
"12535","퍼스트맨","2019-02-14","1",3,665783,62
"12536","퍼스트맨","2019-02-17","1",8,665791,63
"12537","퍼스트맨","2019-02-18","7",82,665873,64
"12538","퍼스트맨","2019-02-19","2",32,665905,65
"12539","퍼스트맨","2019-02-21","1",29,665934,66
"12540","퍼스트맨","2019-02-28","5",37,665971,67
"12541","퍼스트맨","2019-03-06","1",13,665984,68
"12542","스파이더맨: 뉴 유니버스","2018-12-05","2",795,795,0
"12543","스파이더맨: 뉴 유니버스","2018-12-08","7",1610,2405,0
"12544","스파이더맨: 뉴 유니버스","2018-12-09","6",1030,3435,0
"12545","스파이더맨: 뉴 유니버스","2018-12-10","301",5706,9141,0
"12546","스파이더맨: 뉴 유니버스","2018-12-11","303",6459,15600,0
"12547","스파이더맨: 뉴 유니버스","2018-12-12","676",40476,56076,1
"12548","스파이더맨: 뉴 유니버스","2018-12-13","688",36083,92159,2
"12549","스파이더맨: 뉴 유니버스","2018-12-14","705",51009,143168,3
"12550","스파이더맨: 뉴 유니버스","2018-12-15","703",127349,270517,4
"12551","스파이더맨: 뉴 유니버스","2018-12-16","722",119810,390327,5
"12552","스파이더맨: 뉴 유니버스","2018-12-17","638",33838,424165,6
"12553","스파이더맨: 뉴 유니버스","2018-12-18","677",39170,463335,7
"12554","스파이더맨: 뉴 유니버스","2018-12-19","156",6511,469846,8
"12555","스파이더맨: 뉴 유니버스","2018-12-20","173",8345,478191,9
"12556","스파이더맨: 뉴 유니버스","2018-12-21","212",11593,489784,10
"12557","스파이더맨: 뉴 유니버스","2018-12-22","264",25134,514918,11
"12558","스파이더맨: 뉴 유니버스","2018-12-23","287",26876,541794,12
"12559","스파이더맨: 뉴 유니버스","2018-12-24","259",17677,559471,13
"12560","스파이더맨: 뉴 유니버스","2018-12-25","166",20956,580427,14
"12561","스파이더맨: 뉴 유니버스","2018-12-26","133",8298,588725,15
"12562","스파이더맨: 뉴 유니버스","2018-12-27","133",5933,594658,16
"12563","스파이더맨: 뉴 유니버스","2018-12-28","149",7997,602655,17
"12564","스파이더맨: 뉴 유니버스","2018-12-29","148",12648,615303,18
"12565","스파이더맨: 뉴 유니버스","2018-12-30","152",13024,628327,19
"12566","스파이더맨: 뉴 유니버스","2018-12-31","152",11607,639934,20
"12567","스파이더맨: 뉴 유니버스","2019-01-01","134",13287,653221,21
"12568","스파이더맨: 뉴 유니버스","2019-01-02","133",5889,659110,22
"12569","스파이더맨: 뉴 유니버스","2019-01-03","92",3137,662247,23
"12570","스파이더맨: 뉴 유니버스","2019-01-04","100",3929,666176,24
"12571","스파이더맨: 뉴 유니버스","2019-01-05","99",6262,672438,25
"12572","스파이더맨: 뉴 유니버스","2019-01-06","109",5662,678100,26
"12573","스파이더맨: 뉴 유니버스","2019-01-07","90",3214,681314,27
"12574","스파이더맨: 뉴 유니버스","2019-01-08","95",3452,684766,28
"12575","스파이더맨: 뉴 유니버스","2019-01-09","47",1675,686441,29
"12576","스파이더맨: 뉴 유니버스","2019-01-10","43",1443,687884,30
"12577","스파이더맨: 뉴 유니버스","2019-01-11","55",1939,689823,31
"12578","스파이더맨: 뉴 유니버스","2019-01-12","59",3320,693143,32
"12579","스파이더맨: 뉴 유니버스","2019-01-13","52",2789,695932,33
"12580","스파이더맨: 뉴 유니버스","2019-01-14","45",1191,697123,34
"12581","스파이더맨: 뉴 유니버스","2019-01-15","49",1288,698411,35
"12582","스파이더맨: 뉴 유니버스","2019-01-16","27",1263,699674,36
"12583","스파이더맨: 뉴 유니버스","2019-01-17","23",1160,700834,37
"12584","스파이더맨: 뉴 유니버스","2019-01-18","24",1340,702174,38
"12585","스파이더맨: 뉴 유니버스","2019-01-19","27",2233,704407,39
"12586","스파이더맨: 뉴 유니버스","2019-01-20","27",2116,706523,40
"12587","스파이더맨: 뉴 유니버스","2019-01-21","30",1085,707608,41
"12588","스파이더맨: 뉴 유니버스","2019-01-22","30",1014,708622,42
"12589","스파이더맨: 뉴 유니버스","2019-01-23","21",742,709364,43
"12590","스파이더맨: 뉴 유니버스","2019-01-24","14",677,710041,44
"12591","스파이더맨: 뉴 유니버스","2019-01-25","17",806,710847,45
"12592","스파이더맨: 뉴 유니버스","2019-01-26","16",1053,711900,46
"12593","스파이더맨: 뉴 유니버스","2019-01-27","16",991,712891,47
"12594","스파이더맨: 뉴 유니버스","2019-01-28","14",501,713392,48
"12595","스파이더맨: 뉴 유니버스","2019-01-29","16",517,713909,49
"12596","스파이더맨: 뉴 유니버스","2019-01-30","8",472,714381,50
"12597","스파이더맨: 뉴 유니버스","2019-01-31","7",123,714504,51
"12598","스파이더맨: 뉴 유니버스","2019-02-01","5",251,714755,52
"12599","스파이더맨: 뉴 유니버스","2019-02-02","5",123,714878,53
"12600","스파이더맨: 뉴 유니버스","2019-02-03","8",389,715267,54
"12601","스파이더맨: 뉴 유니버스","2019-02-04","5",200,715467,55
"12602","스파이더맨: 뉴 유니버스","2019-02-05","5",103,715570,56
"12603","스파이더맨: 뉴 유니버스","2019-02-06","7",232,715802,57
"12604","스파이더맨: 뉴 유니버스","2019-02-07","3",60,715862,58
"12605","스파이더맨: 뉴 유니버스","2019-02-08","3",61,715923,59
"12606","스파이더맨: 뉴 유니버스","2019-02-09","14",727,716650,60
"12607","스파이더맨: 뉴 유니버스","2019-02-10","6",362,717012,61
"12608","스파이더맨: 뉴 유니버스","2019-02-11","4",92,717104,62
"12609","스파이더맨: 뉴 유니버스","2019-02-12","5",96,717200,63
"12610","스파이더맨: 뉴 유니버스","2019-02-13","14",435,717635,64
"12611","스파이더맨: 뉴 유니버스","2019-02-14","8",355,717990,65
"12612","스파이더맨: 뉴 유니버스","2019-02-15","1",23,718013,66
"12613","스파이더맨: 뉴 유니버스","2019-02-16","16",1011,719024,67
"12614","스파이더맨: 뉴 유니버스","2019-02-17","6",297,719321,68
"12615","스파이더맨: 뉴 유니버스","2019-02-18","4",122,719443,69
"12616","스파이더맨: 뉴 유니버스","2019-02-19","3",101,719544,70
"12617","스파이더맨: 뉴 유니버스","2019-02-20","16",591,720135,71
"12618","스파이더맨: 뉴 유니버스","2019-02-21","4",115,720250,72
"12619","스파이더맨: 뉴 유니버스","2019-02-22","3",91,720341,73
"12620","스파이더맨: 뉴 유니버스","2019-02-23","2",73,720414,74
"12621","스파이더맨: 뉴 유니버스","2019-02-25","4",123,720537,75
"12622","스파이더맨: 뉴 유니버스","2019-02-27","3",130,720667,76
"12623","스파이더맨: 뉴 유니버스","2019-02-28","2",101,720768,77
"12624","스파이더맨: 뉴 유니버스","2019-03-01","31",868,721636,78
"12625","스파이더맨: 뉴 유니버스","2019-03-02","26",569,722205,79
"12626","스파이더맨: 뉴 유니버스","2019-03-03","24",456,722661,80
"12627","스파이더맨: 뉴 유니버스","2019-03-04","20",205,722866,81
"12628","스파이더맨: 뉴 유니버스","2019-03-05","22",236,723102,82
"12629","스파이더맨: 뉴 유니버스","2019-03-06","6",107,723209,83
"12630","스파이더맨: 뉴 유니버스","2019-03-07","1",12,723221,84
"12631","스파이더맨: 뉴 유니버스","2019-03-08","1",35,723256,85
"12632","스파이더맨: 뉴 유니버스","2019-03-09","1",25,723281,86
"12633","스파이더맨: 뉴 유니버스","2019-03-10","1",43,723324,87
"12634","스파이더맨: 뉴 유니버스","2019-03-11","2",15,723339,88
"12635","스파이더맨: 뉴 유니버스","2019-03-12","3",45,723384,89
"12636","스파이더맨: 뉴 유니버스","2019-03-13","2",31,723415,90
"12637","스파이더맨: 뉴 유니버스","2019-03-15","1",2,723417,91
"12638","스파이더맨: 뉴 유니버스","2019-03-16","1",17,723434,92
"12639","스파이더맨: 뉴 유니버스","2019-03-19","1",16,723450,93
"12838","인시디어스4: 라스트 키","2018-01-18","1",178,178,0
"12839","인시디어스4: 라스트 키","2018-01-25","1",200,378,0
"12840","인시디어스4: 라스트 키","2018-01-31","601",102991,103369,1
"12841","인시디어스4: 라스트 키","2018-02-01","632",47745,151114,2
"12842","인시디어스4: 라스트 키","2018-02-02","674",51261,202375,3
"12843","인시디어스4: 라스트 키","2018-02-03","769",89015,291390,4
"12844","인시디어스4: 라스트 키","2018-02-04","732",71834,363224,5
"12845","인시디어스4: 라스트 키","2018-02-05","623",27338,390562,6
"12846","인시디어스4: 라스트 키","2018-02-06","610",24381,414943,7
"12847","인시디어스4: 라스트 키","2018-02-07","575",23077,438020,8
"12848","인시디어스4: 라스트 키","2018-02-08","409",15372,453392,9
"12849","인시디어스4: 라스트 키","2018-02-09","447",18715,472107,10
"12850","인시디어스4: 라스트 키","2018-02-10","457",26183,498290,11
"12851","인시디어스4: 라스트 키","2018-02-11","453",22120,520410,12
"12852","인시디어스4: 라스트 키","2018-02-12","422",11923,532333,13
"12853","인시디어스4: 라스트 키","2018-02-13","424",11410,543743,14
"12854","인시디어스4: 라스트 키","2018-02-14","62",1620,545363,15
"12855","인시디어스4: 라스트 키","2018-02-15","59",1312,546675,16
"12856","인시디어스4: 라스트 키","2018-02-16","44",1107,547782,17
"12857","인시디어스4: 라스트 키","2018-02-17","41",1313,549095,18
"12858","인시디어스4: 라스트 키","2018-02-18","42",1144,550239,19
"12859","인시디어스4: 라스트 키","2018-02-19","45",805,551044,20
"12860","인시디어스4: 라스트 키","2018-02-20","44",747,551791,21
"12861","인시디어스4: 라스트 키","2018-02-21","40",580,552371,22
"12862","인시디어스4: 라스트 키","2018-02-22","9",146,552517,23
"12863","인시디어스4: 라스트 키","2018-02-23","7",95,552612,24
"12864","인시디어스4: 라스트 키","2018-02-24","8",187,552799,25
"12865","인시디어스4: 라스트 키","2018-02-25","7",110,552909,26
"12866","인시디어스4: 라스트 키","2018-02-26","9",101,553010,27
"12867","인시디어스4: 라스트 키","2018-02-27","9",111,553121,28
"12868","인시디어스4: 라스트 키","2018-03-02","2",100,553221,29
"12869","인시디어스4: 라스트 키","2018-03-03","2",100,553321,30
"12870","인시디어스4: 라스트 키","2018-03-04","2",100,553421,31
"12871","인시디어스4: 라스트 키","2018-03-05","2",100,553521,32
"12872","인시디어스4: 라스트 키","2018-03-06","2",100,553621,33
"12873","인시디어스4: 라스트 키","2018-03-07","2",100,553721,34
"12874","인시디어스4: 라스트 키","2018-03-08","2",100,553821,35
"12875","인시디어스4: 라스트 키","2018-03-09","2",100,553921,36
"12876","인시디어스4: 라스트 키","2018-03-10","2",100,554021,37
"12877","인시디어스4: 라스트 키","2018-03-11","2",100,554121,38
"12878","인시디어스4: 라스트 키","2018-03-12","2",100,554221,39
"12879","인시디어스4: 라스트 키","2018-03-13","2",100,554321,40
"12880","인시디어스4: 라스트 키","2018-03-14","2",100,554421,41
"12881","인시디어스4: 라스트 키","2018-03-15","2",100,554521,42
"12882","툼레이더","2018-03-06","1",499,499,0
"12883","툼레이더","2018-03-07","5",452,951,0
"12884","툼레이더","2018-03-08","758",59418,60369,1
"12885","툼레이더","2018-03-09","782",60062,120431,2
"12886","툼레이더","2018-03-10","806",138253,258684,3
"12887","툼레이더","2018-03-11","795",116283,374967,4
"12888","툼레이더","2018-03-12","710",27976,402943,5
"12889","툼레이더","2018-03-13","715",23955,426898,6
"12890","툼레이더","2018-03-14","494",13774,440672,7
"12891","툼레이더","2018-03-15","499",13022,453694,8
"12892","툼레이더","2018-03-16","497",12786,466480,9
"12893","툼레이더","2018-03-17","511",26552,493032,10
"12894","툼레이더","2018-03-18","508",23013,516045,11
"12895","툼레이더","2018-03-19","462",7919,523964,12
"12896","툼레이더","2018-03-20","446",6429,530393,13
"12897","툼레이더","2018-03-21","204",1986,532379,14
"12898","툼레이더","2018-03-22","128",1061,533440,15
"12899","툼레이더","2018-03-23","120",1023,534463,16
"12900","툼레이더","2018-03-24","113",1844,536307,17
"12901","툼레이더","2018-03-25","112",2027,538334,18
"12902","툼레이더","2018-03-26","130",681,539015,19
"12903","툼레이더","2018-03-27","127",807,539822,20
"12904","툼레이더","2018-03-28","12",68,539890,21
"12905","툼레이더","2018-03-29","11",41,539931,22
"12906","툼레이더","2018-03-30","11",36,539967,23
"12907","툼레이더","2018-03-31","3",27,539994,24
"12908","툼레이더","2018-04-01","2",3,539997,25
"12909","툼레이더","2018-04-02","3",10,540007,26
"12910","툼레이더","2018-04-03","1",5,540012,27
"12911","툼레이더","2018-04-04","2",13,540025,28
"12912","툼레이더","2018-04-19","1",385,540410,29
"12913","페르디난드","2017-12-20","1",170,170,0
"12914","페르디난드","2017-12-23","6",1190,1360,0
"12915","페르디난드","2017-12-28","1",298,1658,0
"12916","페르디난드","2018-01-03","496",55641,57299,1
"12917","페르디난드","2018-01-04","578",51461,108760,2
"12918","페르디난드","2018-01-05","631",48424,157184,3
"12919","페르디난드","2018-01-06","698",100205,257389,4
"12920","페르디난드","2018-01-07","689",98378,355767,5
"12921","페르디난드","2018-01-08","568",25711,381478,6
"12922","페르디난드","2018-01-09","566",26788,408266,7
"12923","페르디난드","2018-01-10","534",23334,431600,8
"12924","페르디난드","2018-01-11","325",10633,442233,9
"12925","페르디난드","2018-01-12","332",10533,452766,10
"12926","페르디난드","2018-01-13","343",21373,474139,11
"12927","페르디난드","2018-01-14","341",21862,496001,12
"12928","페르디난드","2018-01-15","299",5214,501215,13
"12929","페르디난드","2018-01-16","318",7477,508692,14
"12930","페르디난드","2018-01-17","95",3476,512168,15
"12931","페르디난드","2018-01-18","72",2541,514709,16
"12932","페르디난드","2018-01-19","72",2469,517178,17
"12933","페르디난드","2018-01-20","72",3123,520301,18
"12934","페르디난드","2018-01-21","67",2945,523246,19
"12935","페르디난드","2018-01-22","54",891,524137,20
"12936","페르디난드","2018-01-23","62",1579,525716,21
"12937","페르디난드","2018-01-24","33",1594,527310,22
"12938","페르디난드","2018-01-25","23",1009,528319,23
"12939","페르디난드","2018-01-26","26",1058,529377,24
"12940","페르디난드","2018-01-27","20",1170,530547,25
"12941","페르디난드","2018-01-28","15",898,531445,26
"12942","페르디난드","2018-01-29","17",424,531869,27
"12943","페르디난드","2018-01-30","17",299,532168,28
"12944","페르디난드","2018-01-31","12",258,532426,29
"12945","페르디난드","2018-02-01","7",209,532635,30
"12946","페르디난드","2018-02-02","6",95,532730,31
"12947","페르디난드","2018-02-03","11",299,533029,32
"12948","페르디난드","2018-02-04","9",216,533245,33
"12949","페르디난드","2018-02-05","5",94,533339,34
"12950","페르디난드","2018-02-06","10",147,533486,35
"12951","페르디난드","2018-02-07","10",172,533658,36
"12952","페르디난드","2018-02-08","8",174,533832,37
"12953","페르디난드","2018-02-09","5",90,533922,38
"12954","페르디난드","2018-02-10","5",120,534042,39
"12955","페르디난드","2018-02-11","5",120,534162,40
"12956","페르디난드","2018-02-12","5",90,534252,41
"12957","페르디난드","2018-02-13","6",178,534430,42
"12958","페르디난드","2018-02-14","4",60,534490,43
"12959","페르디난드","2018-02-15","4",60,534550,44
"12960","페르디난드","2018-02-16","4",60,534610,45
"12961","페르디난드","2018-02-17","4",90,534700,46
"12962","페르디난드","2018-02-18","4",90,534790,47
"12963","페르디난드","2018-02-19","4",60,534850,48
"12964","페르디난드","2018-02-20","3",40,534890,49
"12965","페르디난드","2018-02-21","3",40,534930,50
"12966","페르디난드","2018-02-22","4",184,535114,51
"12967","페르디난드","2018-02-23","3",40,535154,52
"12968","페르디난드","2018-02-24","3",70,535224,53
"12969","페르디난드","2018-02-25","3",70,535294,54
"12970","페르디난드","2018-02-26","3",40,535334,55
"12971","페르디난드","2018-02-27","1",10,535344,56
"12972","페르디난드","2018-02-28","1",10,535354,57
"12973","페르디난드","2018-03-01","1",10,535364,58
"12974","페르디난드","2018-03-02","1",10,535374,59
"12975","페르디난드","2018-03-03","1",25,535399,60
"12976","페르디난드","2018-03-04","1",25,535424,61
"12977","페르디난드","2018-03-05","1",10,535434,62
"12978","메가로돈","2018-08-14","14",3018,3018,0
"12979","메가로돈","2018-08-15","601",157303,160321,1
"12980","메가로돈","2018-08-16","595",52752,213073,2
"12981","메가로돈","2018-08-17","597",48008,261081,3
"12982","메가로돈","2018-08-18","570",81822,342903,4
"12983","메가로돈","2018-08-19","568",70523,413426,5
"12984","메가로돈","2018-08-20","544",24240,437666,6
"12985","메가로돈","2018-08-21","549",21531,459197,7
"12986","메가로돈","2018-08-22","375",10229,469426,8
"12987","메가로돈","2018-08-23","312",6703,476129,9
"12988","메가로돈","2018-08-24","309",9490,485619,10
"12989","메가로돈","2018-08-25","291",15911,501530,11
"12990","메가로돈","2018-08-26","287",14006,515536,12
"12991","메가로돈","2018-08-27","273",3957,519493,13
"12992","메가로돈","2018-08-28","278",4046,523539,14
"12993","메가로돈","2018-08-29","44",852,524391,15
"12994","메가로돈","2018-08-30","37",343,524734,16
"12995","메가로돈","2018-08-31","37",518,525252,17
"12996","메가로돈","2018-09-01","30",657,525909,18
"12997","메가로돈","2018-09-02","28",660,526569,19
"12998","메가로돈","2018-09-03","20",143,526712,20
"12999","메가로돈","2018-09-04","21",144,526856,21
"13000","메가로돈","2018-09-05","22",180,527036,22
"13001","메가로돈","2018-09-06","2",17,527053,23
"13002","메가로돈","2018-09-07","2",19,527072,24
"13003","메가로돈","2018-09-08","5",79,527151,25
"13004","메가로돈","2018-09-09","5",52,527203,26
"13005","메가로돈","2018-09-10","2",5,527208,27
"13006","메가로돈","2018-09-11","3",117,527325,28
"13007","메가로돈","2018-09-12","1",6,527331,29
"13008","메가로돈","2018-10-29","1",177,527508,30
"13009","메가로돈","2018-10-30","1",133,527641,31
"13010","메가로돈","2018-10-31","1",133,527774,32
"13011","메가로돈","2018-11-01","1",133,527907,33
"13012","메가로돈","2018-12-17","1",55,527962,34
"13013","콰이어트 플레이스","2018-04-04","15",3207,3207,0
"13014","콰이어트 플레이스","2018-04-05","6",1381,4588,0
"13015","콰이어트 플레이스","2018-04-07","203",8031,12619,0
"13016","콰이어트 플레이스","2018-04-08","206",9169,21788,0
"13017","콰이어트 플레이스","2018-04-10","2",506,22294,0
"13018","콰이어트 플레이스","2018-04-12","542",35950,58244,1
"13019","콰이어트 플레이스","2018-04-13","589",48722,106966,2
"13020","콰이어트 플레이스","2018-04-14","677",88480,195446,3
"13021","콰이어트 플레이스","2018-04-15","659",70250,265696,4
"13022","콰이어트 플레이스","2018-04-16","553",25204,290900,5
"13023","콰이어트 플레이스","2018-04-17","560",22294,313194,6
"13024","콰이어트 플레이스","2018-04-18","553",22451,335645,7
"13025","콰이어트 플레이스","2018-04-19","457",16085,351730,8
"13026","콰이어트 플레이스","2018-04-20","471",24396,376126,9
"13027","콰이어트 플레이스","2018-04-21","513",45273,421399,10
"13028","콰이어트 플레이스","2018-04-22","515",39103,460502,11
"13029","콰이어트 플레이스","2018-04-23","464",13131,473633,12
"13030","콰이어트 플레이스","2018-04-24","478",11854,485487,13
"13031","콰이어트 플레이스","2018-04-25","147",2869,488356,14
"13032","콰이어트 플레이스","2018-04-26","151",2639,490995,15
"13033","콰이어트 플레이스","2018-04-27","139",3467,494462,16
"13034","콰이어트 플레이스","2018-04-28","133",4766,499228,17
"13035","콰이어트 플레이스","2018-04-29","117",3647,502875,18
"13036","콰이어트 플레이스","2018-04-30","127",2928,505803,19
"13037","콰이어트 플레이스","2018-05-01","64",1392,507195,20
"13038","콰이어트 플레이스","2018-05-02","57",821,508016,21
"13039","콰이어트 플레이스","2018-05-03","46",862,508878,22
"13040","콰이어트 플레이스","2018-05-04","55",1377,510255,23
"13041","콰이어트 플레이스","2018-05-05","56",2327,512582,24
"13042","콰이어트 플레이스","2018-05-06","70",2927,515509,25
"13043","콰이어트 플레이스","2018-05-07","63",2685,518194,26
"13044","콰이어트 플레이스","2018-05-08","62",845,519039,27
"13045","콰이어트 플레이스","2018-05-09","35",529,519568,28
"13046","콰이어트 플레이스","2018-05-10","32",403,519971,29
"13047","콰이어트 플레이스","2018-05-11","45",737,520708,30
"13048","콰이어트 플레이스","2018-05-12","47",1820,522528,31
"13049","콰이어트 플레이스","2018-05-13","47",1363,523891,32
"13050","콰이어트 플레이스","2018-05-14","39",373,524264,33
"13051","콰이어트 플레이스","2018-05-15","43",529,524793,34
"13052","콰이어트 플레이스","2018-05-16","22",158,524951,35
"13053","콰이어트 플레이스","2018-05-17","9",42,524993,36
"13054","콰이어트 플레이스","2018-05-18","14",175,525168,37
"13055","콰이어트 플레이스","2018-05-19","12",277,525445,38
"13056","콰이어트 플레이스","2018-05-20","12",238,525683,39
"13057","콰이어트 플레이스","2018-05-21","13",290,525973,40
"13058","콰이어트 플레이스","2018-05-22","3",39,526012,41
"13059","콰이어트 플레이스","2018-05-23","2",21,526033,42
"13060","콰이어트 플레이스","2018-05-25","1",2,526035,43
"13061","콰이어트 플레이스","2018-05-26","2",15,526050,44
"13062","콰이어트 플레이스","2018-05-27","1",4,526054,45
"13063","콰이어트 플레이스","2018-05-28","2",15,526069,46
"13064","콰이어트 플레이스","2018-05-29","1",4,526073,47
"13065","호두까기 인형과 4개의 왕국","2018-12-01","1",170,170,0
"13066","호두까기 인형과 4개의 왕국","2018-12-03","2",244,414,0
"13067","호두까기 인형과 4개의 왕국","2018-12-05","2",359,773,0
"13068","호두까기 인형과 4개의 왕국","2018-12-06","265",36136,36909,1
"13069","호두까기 인형과 4개의 왕국","2018-12-07","277",36331,73240,2
"13070","호두까기 인형과 4개의 왕국","2018-12-08","294",82644,155884,3
"13071","호두까기 인형과 4개의 왕국","2018-12-09","275",74052,229936,4
"13072","호두까기 인형과 4개의 왕국","2018-12-10","253",19211,249147,5
"13073","호두까기 인형과 4개의 왕국","2018-12-11","252",18498,267645,6
"13074","호두까기 인형과 4개의 왕국","2018-12-12","221",19781,287426,7
"13075","호두까기 인형과 4개의 왕국","2018-12-13","223",16136,303562,8
"13076","호두까기 인형과 4개의 왕국","2018-12-14","245",22364,325926,9
"13077","호두까기 인형과 4개의 왕국","2018-12-15","260",44601,370527,10
"13078","호두까기 인형과 4개의 왕국","2018-12-16","257",37898,408425,11
"13079","호두까기 인형과 4개의 왕국","2018-12-17","221",11845,420270,12
"13080","호두까기 인형과 4개의 왕국","2018-12-18","235",13509,433779,13
"13081","호두까기 인형과 4개의 왕국","2018-12-19","138",6032,439811,14
"13082","호두까기 인형과 4개의 왕국","2018-12-20","128",4380,444191,15
"13083","호두까기 인형과 4개의 왕국","2018-12-21","132",5133,449324,16
"13084","호두까기 인형과 4개의 왕국","2018-12-22","138",10717,460041,17
"13085","호두까기 인형과 4개의 왕국","2018-12-23","142",11576,471617,18
"13086","호두까기 인형과 4개의 왕국","2018-12-24","154",9698,481315,19
"13087","호두까기 인형과 4개의 왕국","2018-12-25","116",16264,497579,20
"13088","호두까기 인형과 4개의 왕국","2018-12-26","58",2258,499837,21
"13089","호두까기 인형과 4개의 왕국","2018-12-27","54",1906,501743,22
"13090","호두까기 인형과 4개의 왕국","2018-12-28","56",2031,503774,23
"13091","호두까기 인형과 4개의 왕국","2018-12-29","62",3502,507276,24
"13092","호두까기 인형과 4개의 왕국","2018-12-30","57",3256,510532,25
"13093","호두까기 인형과 4개의 왕국","2018-12-31","55",3235,513767,26
"13094","호두까기 인형과 4개의 왕국","2019-01-01","36",2050,515817,27
"13095","호두까기 인형과 4개의 왕국","2019-01-02","38",1100,516917,28
"13096","호두까기 인형과 4개의 왕국","2019-01-03","12",205,517122,29
"13097","호두까기 인형과 4개의 왕국","2019-01-04","14",261,517383,30
"13098","호두까기 인형과 4개의 왕국","2019-01-05","11",302,517685,31
"13099","호두까기 인형과 4개의 왕국","2019-01-06","11",242,517927,32
"13100","호두까기 인형과 4개의 왕국","2019-01-07","7",102,518029,33
"13101","호두까기 인형과 4개의 왕국","2019-01-08","10",133,518162,34
"13102","호두까기 인형과 4개의 왕국","2019-01-09","1",14,518176,35
"13103","호두까기 인형과 4개의 왕국","2019-01-10","1",17,518193,36
"13104","호두까기 인형과 4개의 왕국","2019-01-11","1",9,518202,37
"13105","호두까기 인형과 4개의 왕국","2019-01-12","1",26,518228,38
"13106","호두까기 인형과 4개의 왕국","2019-01-13","1",20,518248,39
"13107","호두까기 인형과 4개의 왕국","2019-01-14","1",11,518259,40
"13108","호두까기 인형과 4개의 왕국","2019-01-15","1",7,518266,41
"13109","호두까기 인형과 4개의 왕국","2019-01-16","1",6,518272,42
"13110","셰이프 오브 워터: 사랑의 모양","2018-01-08","1",226,226,0
"13111","셰이프 오브 워터: 사랑의 모양","2018-02-01","1",214,440,0
"13112","셰이프 오브 워터: 사랑의 모양","2018-02-10","11",1007,1447,0
"13113","셰이프 오브 워터: 사랑의 모양","2018-02-12","6",897,2344,0
"13114","셰이프 오브 워터: 사랑의 모양","2018-02-13","9",1259,3603,0
"13115","셰이프 오브 워터: 사랑의 모양","2018-02-15","2",358,3961,0
"13116","셰이프 오브 워터: 사랑의 모양","2018-02-16","2",163,4124,0
"13117","셰이프 오브 워터: 사랑의 모양","2018-02-17","1",266,4390,0
"13118","셰이프 오브 워터: 사랑의 모양","2018-02-18","5",579,4969,0
"13119","셰이프 오브 워터: 사랑의 모양","2018-02-20","17",2130,7099,0
"13120","셰이프 오브 워터: 사랑의 모양","2018-02-21","1",187,7286,0
"13121","셰이프 오브 워터: 사랑의 모양","2018-02-22","252",22660,29946,1
"13122","셰이프 오브 워터: 사랑의 모양","2018-02-23","275",27688,57634,2
"13123","셰이프 오브 워터: 사랑의 모양","2018-02-24","404",55749,113383,3
"13124","셰이프 오브 워터: 사랑의 모양","2018-02-25","397",49177,162560,4
"13125","셰이프 오브 워터: 사랑의 모양","2018-02-26","351",25254,187814,5
"13126","셰이프 오브 워터: 사랑의 모양","2018-02-27","349",24650,212464,6
"13127","셰이프 오브 워터: 사랑의 모양","2018-02-28","266",23504,235968,7
"13128","셰이프 오브 워터: 사랑의 모양","2018-03-01","287",29442,265410,8
"13129","셰이프 오브 워터: 사랑의 모양","2018-03-02","295",15536,280946,9
"13130","셰이프 오브 워터: 사랑의 모양","2018-03-03","280",25213,306159,10
"13131","셰이프 오브 워터: 사랑의 모양","2018-03-04","291",21712,327871,11
"13132","셰이프 오브 워터: 사랑의 모양","2018-03-05","267",11205,339076,12
"13133","셰이프 오브 워터: 사랑의 모양","2018-03-06","303",14555,353631,13
"13134","셰이프 오브 워터: 사랑의 모양","2018-03-07","258",11064,364695,14
"13135","셰이프 오브 워터: 사랑의 모양","2018-03-08","268",8891,373586,15
"13136","셰이프 오브 워터: 사랑의 모양","2018-03-09","294",12226,385812,16
"13137","셰이프 오브 워터: 사랑의 모양","2018-03-10","301",23746,409558,17
"13138","셰이프 오브 워터: 사랑의 모양","2018-03-11","294",19583,429141,18
"13139","셰이프 오브 워터: 사랑의 모양","2018-03-12","275",7172,436313,19
"13140","셰이프 오브 워터: 사랑의 모양","2018-03-13","279",7181,443494,20
"13141","셰이프 오브 워터: 사랑의 모양","2018-03-14","183",4927,448421,21
"13142","셰이프 오브 워터: 사랑의 모양","2018-03-15","178",4194,452615,22
"13143","셰이프 오브 워터: 사랑의 모양","2018-03-16","191",5396,458011,23
"13144","셰이프 오브 워터: 사랑의 모양","2018-03-17","193",10007,468018,24
"13145","셰이프 오브 워터: 사랑의 모양","2018-03-18","193",8133,476151,25
"13146","셰이프 오브 워터: 사랑의 모양","2018-03-19","180",3389,479540,26
"13147","셰이프 오브 워터: 사랑의 모양","2018-03-20","179",3484,483024,27
"13148","셰이프 오브 워터: 사랑의 모양","2018-03-21","131",2203,485227,28
"13149","셰이프 오브 워터: 사랑의 모양","2018-03-22","95",1744,486971,29
"13150","셰이프 오브 워터: 사랑의 모양","2018-03-23","101",2368,489339,30
"13151","셰이프 오브 워터: 사랑의 모양","2018-03-24","99",3990,493329,31
"13152","셰이프 오브 워터: 사랑의 모양","2018-03-25","101",3225,496554,32
"13153","셰이프 오브 워터: 사랑의 모양","2018-03-26","95",1320,497874,33
"13154","셰이프 오브 워터: 사랑의 모양","2018-03-27","96",1546,499420,34
"13155","셰이프 오브 워터: 사랑의 모양","2018-03-28","25",523,499943,35
"13156","셰이프 오브 워터: 사랑의 모양","2018-03-29","22",359,500302,36
"13157","셰이프 오브 워터: 사랑의 모양","2018-03-30","26",445,500747,37
"13158","셰이프 오브 워터: 사랑의 모양","2018-03-31","25",682,501429,38
"13159","셰이프 오브 워터: 사랑의 모양","2018-04-01","23",713,502142,39
"13160","셰이프 오브 워터: 사랑의 모양","2018-04-02","22",310,502452,40
"13161","셰이프 오브 워터: 사랑의 모양","2018-04-03","24",310,502762,41
"13162","셰이프 오브 워터: 사랑의 모양","2018-04-04","20",202,502964,42
"13163","셰이프 오브 워터: 사랑의 모양","2018-04-05","11",165,503129,43
"13164","셰이프 오브 워터: 사랑의 모양","2018-04-06","9",109,503238,44
"13165","셰이프 오브 워터: 사랑의 모양","2018-04-07","10",227,503465,45
"13166","셰이프 오브 워터: 사랑의 모양","2018-04-08","10",242,503707,46
"13167","셰이프 오브 워터: 사랑의 모양","2018-04-09","9",147,503854,47
"13168","셰이프 오브 워터: 사랑의 모양","2018-04-10","10",174,504028,48
"13169","셰이프 오브 워터: 사랑의 모양","2018-04-11","10",135,504163,49
"13170","셰이프 오브 워터: 사랑의 모양","2018-04-12","7",114,504277,50
"13171","셰이프 오브 워터: 사랑의 모양","2018-04-13","8",157,504434,51
"13172","셰이프 오브 워터: 사랑의 모양","2018-04-14","7",139,504573,52
"13173","셰이프 오브 워터: 사랑의 모양","2018-04-15","8",179,504752,53
"13174","셰이프 오브 워터: 사랑의 모양","2018-04-16","4",52,504804,54
"13175","셰이프 오브 워터: 사랑의 모양","2018-04-17","6",91,504895,55
"13176","셰이프 오브 워터: 사랑의 모양","2018-04-18","6",95,504990,56
"13177","셰이프 오브 워터: 사랑의 모양","2018-04-19","4",36,505026,57
"13178","셰이프 오브 워터: 사랑의 모양","2018-04-20","4",38,505064,58
"13179","셰이프 오브 워터: 사랑의 모양","2018-04-21","5",145,505209,59
"13180","셰이프 오브 워터: 사랑의 모양","2018-04-22","4",83,505292,60
"13181","셰이프 오브 워터: 사랑의 모양","2018-04-23","2",20,505312,61
"13182","셰이프 오브 워터: 사랑의 모양","2018-04-24","2",20,505332,62
"13183","셰이프 오브 워터: 사랑의 모양","2018-04-25","3",33,505365,63
"13184","셰이프 오브 워터: 사랑의 모양","2018-04-26","2",11,505376,64
"13185","셰이프 오브 워터: 사랑의 모양","2018-04-27","3",43,505419,65
"13186","셰이프 오브 워터: 사랑의 모양","2018-04-28","2",43,505462,66
"13187","셰이프 오브 워터: 사랑의 모양","2018-04-29","3",92,505554,67
"13188","셰이프 오브 워터: 사랑의 모양","2018-04-30","2",21,505575,68
"13189","셰이프 오브 워터: 사랑의 모양","2018-05-01","3",32,505607,69
"13190","셰이프 오브 워터: 사랑의 모양","2018-05-02","1",10,505617,70
"13191","셰이프 오브 워터: 사랑의 모양","2018-05-03","1",10,505627,71
"13192","셰이프 오브 워터: 사랑의 모양","2018-05-05","2",26,505653,72
"13193","셰이프 오브 워터: 사랑의 모양","2018-05-06","1",6,505659,73
"13194","셰이프 오브 워터: 사랑의 모양","2018-05-07","1",23,505682,74
"13195","셰이프 오브 워터: 사랑의 모양","2018-05-09","1",7,505689,75
"13196","셰이프 오브 워터: 사랑의 모양","2018-05-10","1",2,505691,76
"13197","셰이프 오브 워터: 사랑의 모양","2018-05-12","1",21,505712,77
"13198","셰이프 오브 워터: 사랑의 모양","2018-05-15","1",2,505714,78
"13199","셰이프 오브 워터: 사랑의 모양","2018-05-19","1",10,505724,79
"13200","셰이프 오브 워터: 사랑의 모양","2018-05-21","1",33,505757,80
"13201","셰이프 오브 워터: 사랑의 모양","2018-05-22","1",21,505778,81
"13202","셰이프 오브 워터: 사랑의 모양","2018-05-27","1",8,505786,82
"13203","셰이프 오브 워터: 사랑의 모양","2018-05-30","2",85,505871,83
"13204","셰이프 오브 워터: 사랑의 모양","2018-05-31","6",80,505951,84
"13205","셰이프 오브 워터: 사랑의 모양","2018-06-05","6",185,506136,85
"13206","셰이프 오브 워터: 사랑의 모양","2018-06-07","1",28,506164,86
"13207","셰이프 오브 워터: 사랑의 모양","2018-06-08","2",49,506213,87
"13208","셰이프 오브 워터: 사랑의 모양","2018-06-10","1",18,506231,88
"13209","셰이프 오브 워터: 사랑의 모양","2018-06-11","2",61,506292,89
"13210","셰이프 오브 워터: 사랑의 모양","2018-06-12","1",20,506312,90
"13211","셰이프 오브 워터: 사랑의 모양","2018-06-14","3",38,506350,91
"13212","셰이프 오브 워터: 사랑의 모양","2018-06-18","1",12,506362,92
"13213","셰이프 오브 워터: 사랑의 모양","2018-06-19","1",14,506376,93
"13214","셰이프 오브 워터: 사랑의 모양","2018-06-20","1",32,506408,94
"13215","셰이프 오브 워터: 사랑의 모양","2018-07-04","1",0,506408,95
"13216","셰이프 오브 워터: 사랑의 모양","2018-07-06","1",19,506427,96
"13217","셰이프 오브 워터: 사랑의 모양","2018-07-10","1",0,506427,97
"13218","셰이프 오브 워터: 사랑의 모양","2018-07-11","1",44,506471,98
"13219","셰이프 오브 워터: 사랑의 모양","2018-07-12","1",16,506487,99
"13220","셰이프 오브 워터: 사랑의 모양","2018-12-16","7",615,507102,100
"13221","셰이프 오브 워터: 사랑의 모양","2019-02-03","1",68,507170,101
"13222","셰이프 오브 워터: 사랑의 모양","2019-02-16","1",46,507216,102
"13223","곰돌이 푸 다시 만나 행복해","2018-09-17","1",375,375,0
"13224","곰돌이 푸 다시 만나 행복해","2018-09-20","6",1519,1894,0
"13225","곰돌이 푸 다시 만나 행복해","2018-10-01","1",621,2515,0
"13226","곰돌이 푸 다시 만나 행복해","2018-10-02","9",1261,3776,0
"13227","곰돌이 푸 다시 만나 행복해","2018-10-03","536",78478,82254,1
"13228","곰돌이 푸 다시 만나 행복해","2018-10-04","483",18136,100390,2
"13229","곰돌이 푸 다시 만나 행복해","2018-10-05","483",23534,123924,3
"13230","곰돌이 푸 다시 만나 행복해","2018-10-06","526",55430,179354,4
"13231","곰돌이 푸 다시 만나 행복해","2018-10-07","527",48343,227697,5
"13232","곰돌이 푸 다시 만나 행복해","2018-10-08","492",33625,261322,6
"13233","곰돌이 푸 다시 만나 행복해","2018-10-09","494",52064,313386,7
"13234","곰돌이 푸 다시 만나 행복해","2018-10-10","426",11332,324718,8
"13235","곰돌이 푸 다시 만나 행복해","2018-10-11","353",8301,333019,9
"13236","곰돌이 푸 다시 만나 행복해","2018-10-12","389",11225,344244,10
"13237","곰돌이 푸 다시 만나 행복해","2018-10-13","453",26896,371140,11
"13238","곰돌이 푸 다시 만나 행복해","2018-10-14","468",24724,395864,12
"13239","곰돌이 푸 다시 만나 행복해","2018-10-15","383",7001,402865,13
"13240","곰돌이 푸 다시 만나 행복해","2018-10-16","385",6813,409678,14
"13241","곰돌이 푸 다시 만나 행복해","2018-10-17","385",8060,417738,15
"13242","곰돌이 푸 다시 만나 행복해","2018-10-18","215",4810,422548,16
"13243","곰돌이 푸 다시 만나 행복해","2018-10-19","232",7100,429648,17
"13244","곰돌이 푸 다시 만나 행복해","2018-10-20","294",14836,444484,18
"13245","곰돌이 푸 다시 만나 행복해","2018-10-21","300",14412,458896,19
"13246","곰돌이 푸 다시 만나 행복해","2018-10-22","229",3746,462642,20
"13247","곰돌이 푸 다시 만나 행복해","2018-10-23","235",3847,466489,21
"13248","곰돌이 푸 다시 만나 행복해","2018-10-24","227",4226,470715,22
"13249","곰돌이 푸 다시 만나 행복해","2018-10-25","85",1995,472710,23
"13250","곰돌이 푸 다시 만나 행복해","2018-10-26","89",2200,474910,24
"13251","곰돌이 푸 다시 만나 행복해","2018-10-27","119",5371,480281,25
"13252","곰돌이 푸 다시 만나 행복해","2018-10-28","121",5757,486038,26
"13253","곰돌이 푸 다시 만나 행복해","2018-10-29","79",1093,487131,27
"13254","곰돌이 푸 다시 만나 행복해","2018-10-30","83",1663,488794,28
"13255","곰돌이 푸 다시 만나 행복해","2018-10-31","9",168,488962,29
"13256","곰돌이 푸 다시 만나 행복해","2018-11-01","7",49,489011,30
"13257","곰돌이 푸 다시 만나 행복해","2018-11-02","9",228,489239,31
"13258","곰돌이 푸 다시 만나 행복해","2018-11-03","11",240,489479,32
"13259","곰돌이 푸 다시 만나 행복해","2018-11-04","12",188,489667,33
"13260","곰돌이 푸 다시 만나 행복해","2018-11-05","5",58,489725,34
"13261","곰돌이 푸 다시 만나 행복해","2018-11-06","8",192,489917,35
"13262","곰돌이 푸 다시 만나 행복해","2018-11-07","2",77,489994,36
"13263","곰돌이 푸 다시 만나 행복해","2018-11-08","3",235,490229,37
"13264","곰돌이 푸 다시 만나 행복해","2018-11-09","2",105,490334,38
"13265","곰돌이 푸 다시 만나 행복해","2018-11-10","2",129,490463,39
"13266","곰돌이 푸 다시 만나 행복해","2018-11-11","2",84,490547,40
"13267","곰돌이 푸 다시 만나 행복해","2018-11-12","11",61,490608,41
"13268","곰돌이 푸 다시 만나 행복해","2018-11-13","11",67,490675,42
"13269","곰돌이 푸 다시 만나 행복해","2018-11-14","10",50,490725,43
"13270","곰돌이 푸 다시 만나 행복해","2018-11-15","11",200,490925,44
"13271","곰돌이 푸 다시 만나 행복해","2018-11-16","10",50,490975,45
"13272","곰돌이 푸 다시 만나 행복해","2018-11-17","11",182,491157,46
"13273","곰돌이 푸 다시 만나 행복해","2018-11-18","10",50,491207,47
"13274","곰돌이 푸 다시 만나 행복해","2018-11-19","11",150,491357,48
"13275","곰돌이 푸 다시 만나 행복해","2018-11-20","10",50,491407,49
"13276","곰돌이 푸 다시 만나 행복해","2018-11-21","10",50,491457,50
"13277","곰돌이 푸 다시 만나 행복해","2018-11-22","10",50,491507,51
"13278","곰돌이 푸 다시 만나 행복해","2018-11-23","10",50,491557,52
"13279","곰돌이 푸 다시 만나 행복해","2018-11-24","10",50,491607,53
"13280","곰돌이 푸 다시 만나 행복해","2018-11-25","10",50,491657,54
"13281","곰돌이 푸 다시 만나 행복해","2018-11-26","10",50,491707,55
"13282","곰돌이 푸 다시 만나 행복해","2018-11-27","10",50,491757,56
"13283","곰돌이 푸 다시 만나 행복해","2018-11-28","10",50,491807,57
"13284","곰돌이 푸 다시 만나 행복해","2018-11-29","1",245,492052,58
"13285","곰돌이 푸 다시 만나 행복해","2018-12-11","1",149,492201,59
"13286","그린치","2018-11-23","1",8,8,0
"13287","그린치","2018-12-08","2",540,548,0
"13288","그린치","2018-12-10","1",175,723,0
"13289","그린치","2018-12-11","2",367,1090,0
"13290","그린치","2018-12-13","1",126,1216,0
"13291","그린치","2018-12-14","1",8,1224,0
"13292","그린치","2018-12-15","19",2462,3686,0
"13293","그린치","2018-12-17","1",178,3864,0
"13294","그린치","2018-12-18","1",306,4170,0
"13295","그린치","2018-12-19","515",11938,16108,1
"13296","그린치","2018-12-20","561",20348,36456,2
"13297","그린치","2018-12-21","557",19125,55581,3
"13298","그린치","2018-12-22","722",71288,126869,4
"13299","그린치","2018-12-23","724",72512,199381,5
"13300","그린치","2018-12-24","694",33923,233304,6
"13301","그린치","2018-12-25","664",119185,352489,7
"13302","그린치","2018-12-26","394",14384,366873,8
"13303","그린치","2018-12-27","369",12131,379004,9
"13304","그린치","2018-12-28","399",14286,393290,10
"13305","그린치","2018-12-29","506",33821,427111,11
"13306","그린치","2018-12-30","501",31703,458814,12
"13307","그린치","2018-12-31","446",26250,485064,13
"13308","그린치","2019-01-01","449",32824,517888,14
"13309","그린치","2019-01-02","370",10527,528415,15
"13310","그린치","2019-01-03","177",3805,532220,16
"13311","그린치","2019-01-04","182",3463,535683,17
"13312","그린치","2019-01-05","181",4374,540057,18
"13313","그린치","2019-01-06","189",3756,543813,19
"13314","그린치","2019-01-07","139",1551,545364,20
"13315","그린치","2019-01-08","144",2087,547451,21
"13316","그린치","2019-01-09","38",836,548287,22
"13317","그린치","2019-01-10","14",380,548667,23
"13318","그린치","2019-01-11","16",433,549100,24
"13319","그린치","2019-01-12","13",383,549483,25
"13320","그린치","2019-01-13","13",397,549880,26
"13321","그린치","2019-01-14","11",261,550141,27
"13322","그린치","2019-01-15","12",209,550350,28
"13323","그린치","2019-01-16","9",540,550890,29
"13324","그린치","2019-01-17","3",117,551007,30
"13325","그린치","2019-01-18","2",140,551147,31
"13326","그린치","2019-01-19","3",102,551249,32
"13327","그린치","2019-01-20","2",70,551319,33
"13328","그린치","2019-01-21","2",64,551383,34
"13329","그린치","2019-01-22","1",60,551443,35
"13330","그린치","2019-01-23","1",60,551503,36
"13331","그린치","2019-01-24","1",60,551563,37
"13332","그린치","2019-01-25","1",60,551623,38
"13333","그린치","2019-01-26","1",60,551683,39
"13334","그린치","2019-01-27","1",60,551743,40
"13335","그린치","2019-01-28","1",60,551803,41
"13336","그린치","2019-01-29","2",150,551953,42
"13337","그린치","2019-02-13","1",306,552259,43
"13338","그린치","2019-02-14","3",711,552970,44
"13339","스타 이즈 본","2018-09-19","1",450,450,0
"13340","스타 이즈 본","2018-09-28","1",450,900,0
"13341","스타 이즈 본","2018-10-02","3",1024,1924,0
"13342","스타 이즈 본","2018-10-08","1",621,2545,0
"13343","스타 이즈 본","2018-10-09","525",35127,37672,1
"13344","스타 이즈 본","2018-10-10","515",15485,53157,2
"13345","스타 이즈 본","2018-10-11","495",13479,66636,3
"13346","스타 이즈 본","2018-10-12","510",18525,85161,4
"13347","스타 이즈 본","2018-10-13","552",35649,120810,5
"13348","스타 이즈 본","2018-10-14","555",32585,153395,6
"13349","스타 이즈 본","2018-10-15","526",15805,169200,7
"13350","스타 이즈 본","2018-10-16","521",15977,185177,8
"13351","스타 이즈 본","2018-10-17","543",17859,203036,9
"13352","스타 이즈 본","2018-10-18","283",7776,210812,10
"13353","스타 이즈 본","2018-10-19","305",11890,222702,11
"13354","스타 이즈 본","2018-10-20","379",22844,245546,12
"13355","스타 이즈 본","2018-10-21","397",22155,267701,13
"13356","스타 이즈 본","2018-10-22","370",9869,277570,14
"13357","스타 이즈 본","2018-10-23","377",10754,288324,15
"13358","스타 이즈 본","2018-10-24","384",12813,301137,16
"13359","스타 이즈 본","2018-10-25","221",7595,308732,17
"13360","스타 이즈 본","2018-10-26","234",11644,320376,18
"13361","스타 이즈 본","2018-10-27","269",22452,342828,19
"13362","스타 이즈 본","2018-10-28","292",24137,366965,20
"13363","스타 이즈 본","2018-10-29","263",10676,377641,21
"13364","스타 이즈 본","2018-10-30","272",12055,389696,22
"13365","스타 이즈 본","2018-10-31","140",7048,396744,23
"13366","스타 이즈 본","2018-11-01","142",4889,401633,24
"13367","스타 이즈 본","2018-11-02","154",5833,407466,25
"13368","스타 이즈 본","2018-11-03","152",9583,417049,26
"13369","스타 이즈 본","2018-11-04","145",8091,425140,27
"13370","스타 이즈 본","2018-11-05","160",4591,429731,28
"13371","스타 이즈 본","2018-11-06","160",4802,434533,29
"13372","스타 이즈 본","2018-11-07","115",4045,438578,30
"13373","스타 이즈 본","2018-11-08","105",3243,441821,31
"13374","스타 이즈 본","2018-11-09","103",4379,446200,32
"13375","스타 이즈 본","2018-11-10","101",6574,452774,33
"13376","스타 이즈 본","2018-11-11","100",6143,458917,34
"13377","스타 이즈 본","2018-11-12","99",2579,461496,35
"13378","스타 이즈 본","2018-11-13","100",2963,464459,36
"13379","스타 이즈 본","2018-11-14","39",1363,465822,37
"13380","스타 이즈 본","2018-11-15","35",1081,466903,38
"13381","스타 이즈 본","2018-11-16","35",1295,468198,39
"13382","스타 이즈 본","2018-11-17","31",1572,469770,40
"13383","스타 이즈 본","2018-11-18","32",1494,471264,41
"13384","스타 이즈 본","2018-11-19","36",928,472192,42
"13385","스타 이즈 본","2018-11-20","38",1153,473345,43
"13386","스타 이즈 본","2018-11-21","23",628,473973,44
"13387","스타 이즈 본","2018-11-22","14",426,474399,45
"13388","스타 이즈 본","2018-11-23","19",766,475165,46
"13389","스타 이즈 본","2018-11-24","16",1346,476511,47
"13390","스타 이즈 본","2018-11-25","17",966,477477,48
"13391","스타 이즈 본","2018-11-26","15",394,477871,49
"13392","스타 이즈 본","2018-11-27","17",631,478502,50
"13393","스타 이즈 본","2018-11-28","7",385,478887,51
"13394","스타 이즈 본","2018-11-29","6",209,479096,52
"13395","스타 이즈 본","2018-11-30","8",389,479485,53
"13396","스타 이즈 본","2018-12-01","7",496,479981,54
"13397","스타 이즈 본","2018-12-02","7",503,480484,55
"13398","스타 이즈 본","2018-12-03","10",226,480710,56
"13399","스타 이즈 본","2018-12-04","8",211,480921,57
"13400","스타 이즈 본","2018-12-05","6",121,481042,58
"13401","스타 이즈 본","2018-12-06","6",414,481456,59
"13402","스타 이즈 본","2018-12-07","7",181,481637,60
"13403","스타 이즈 본","2018-12-08","4",229,481866,61
"13404","스타 이즈 본","2018-12-09","7",288,482154,62
"13405","스타 이즈 본","2018-12-10","5",142,482296,63
"13406","스타 이즈 본","2018-12-11","5",139,482435,64
"13407","스타 이즈 본","2018-12-12","4",86,482521,65
"13408","스타 이즈 본","2018-12-13","3",64,482585,66
"13409","스타 이즈 본","2018-12-14","3",77,482662,67
"13410","스타 이즈 본","2018-12-15","4",256,482918,68
"13411","스타 이즈 본","2018-12-16","4",213,483131,69
"13412","스타 이즈 본","2018-12-17","3",45,483176,70
"13413","스타 이즈 본","2018-12-18","4",102,483278,71
"13414","스타 이즈 본","2018-12-19","1",30,483308,72
"13415","스타 이즈 본","2018-12-20","2",39,483347,73
"13416","스타 이즈 본","2018-12-21","2",62,483409,74
"13417","스타 이즈 본","2018-12-22","1",35,483444,75
"13418","스타 이즈 본","2018-12-23","2",80,483524,76
"13419","스타 이즈 본","2018-12-24","1",44,483568,77
"13420","스타 이즈 본","2018-12-25","1",82,483650,78
"13421","스타 이즈 본","2018-12-26","1",46,483696,79
"13422","스타 이즈 본","2018-12-27","1",19,483715,80
"13423","스타 이즈 본","2018-12-28","1",24,483739,81
"13424","스타 이즈 본","2018-12-29","1",34,483773,82
"13425","스타 이즈 본","2018-12-30","1",37,483810,83
"13426","스타 이즈 본","2018-12-31","1",42,483852,84
"13427","스타 이즈 본","2019-01-01","1",25,483877,85
"13428","스타 이즈 본","2019-01-02","1",15,483892,86
"13429","스타 이즈 본","2019-01-03","1",14,483906,87
"13430","스타 이즈 본","2019-01-04","1",41,483947,88
"13431","스타 이즈 본","2019-01-05","1",46,483993,89
"13432","스타 이즈 본","2019-01-06","1",48,484041,90
"13433","스타 이즈 본","2019-01-07","1",24,484065,91
"13434","스타 이즈 본","2019-01-08","1",34,484099,92
"13435","스타 이즈 본","2019-01-09","1",28,484127,93
"13436","스타 이즈 본","2019-01-10","1",27,484154,94
"13437","스타 이즈 본","2019-01-11","1",28,484182,95
"13438","스타 이즈 본","2019-01-12","1",37,484219,96
"13439","스타 이즈 본","2019-01-13","1",16,484235,97
"13440","스타 이즈 본","2019-01-14","1",20,484255,98
"13441","스타 이즈 본","2019-01-15","11",716,484971,99
"13442","스타 이즈 본","2019-01-16","1",29,485000,100
"13443","스타 이즈 본","2019-01-17","1",9,485009,101
"13444","스타 이즈 본","2019-01-18","1",21,485030,102
"13445","스타 이즈 본","2019-01-19","1",21,485051,103
"13446","스타 이즈 본","2019-01-20","1",29,485080,104
"13447","스타 이즈 본","2019-01-21","1",12,485092,105
"13448","스타 이즈 본","2019-01-22","1",17,485109,106
"13449","스타 이즈 본","2019-01-23","1",26,485135,107
"13450","스타 이즈 본","2019-01-24","1",18,485153,108
"13451","스타 이즈 본","2019-01-25","1",35,485188,109
"13452","스타 이즈 본","2019-01-26","1",35,485223,110
"13453","스타 이즈 본","2019-01-27","1",28,485251,111
"13454","스타 이즈 본","2019-01-28","1",11,485262,112
"13455","스타 이즈 본","2019-01-29","1",12,485274,113
"13456","스타 이즈 본","2019-01-30","1",43,485317,114
"13457","스타 이즈 본","2019-01-31","2",61,485378,115
"13458","스타 이즈 본","2019-02-01","4",73,485451,116
"13459","스타 이즈 본","2019-02-02","1",37,485488,117
"13460","스타 이즈 본","2019-02-03","3",129,485617,118
"13461","스타 이즈 본","2019-02-04","2",168,485785,119
"13462","스타 이즈 본","2019-02-05","3",134,485919,120
"13463","스타 이즈 본","2019-02-06","5",372,486291,121
"13464","스타 이즈 본","2019-02-07","3",75,486366,122
"13465","스타 이즈 본","2019-02-08","14",440,486806,123
"13466","스타 이즈 본","2019-02-09","2",137,486943,124
"13467","스타 이즈 본","2019-02-10","6",387,487330,125
"13468","스타 이즈 본","2019-02-11","13",391,487721,126
"13469","스타 이즈 본","2019-02-12","3",57,487778,127
"13470","스타 이즈 본","2019-02-13","5",245,488023,128
"13471","스타 이즈 본","2019-02-14","11",246,488269,129
"13472","스타 이즈 본","2019-02-15","2",53,488322,130
"13473","스타 이즈 본","2019-02-16","1",44,488366,131
"13474","스타 이즈 본","2019-02-17","5",340,488706,132
"13475","스타 이즈 본","2019-02-18","11",252,488958,133
"13476","스타 이즈 본","2019-02-19","2",72,489030,134
"13477","스타 이즈 본","2019-02-20","2",53,489083,135
"13478","스타 이즈 본","2019-02-21","2",75,489158,136
"13479","스타 이즈 본","2019-02-22","6",67,489225,137
"13480","스타 이즈 본","2019-02-23","1",25,489250,138
"13481","스타 이즈 본","2019-02-24","1",17,489267,139
"13482","스타 이즈 본","2019-02-25","2",44,489311,140
"13483","스타 이즈 본","2019-02-26","3",128,489439,141
"13484","스타 이즈 본","2019-02-27","3",181,489620,142
"13485","스타 이즈 본","2019-02-28","2",40,489660,143
"13486","스타 이즈 본","2019-03-01","16",485,490145,144
"13487","스타 이즈 본","2019-03-02","15",442,490587,145
"13488","스타 이즈 본","2019-03-03","16",313,490900,146
"13489","스타 이즈 본","2019-03-04","12",92,490992,147
"13490","스타 이즈 본","2019-03-05","14",146,491138,148
"13491","스타 이즈 본","2019-03-06","4",69,491207,149
"13492","스타 이즈 본","2019-03-07","2",68,491275,150
"13493","스타 이즈 본","2019-03-08","1",14,491289,151
"13494","스타 이즈 본","2019-03-09","1",33,491322,152
"13495","스타 이즈 본","2019-03-10","2",198,491520,153
"13496","스타 이즈 본","2019-03-11","1",34,491554,154
"13497","스타 이즈 본","2019-03-12","1",16,491570,155
"13498","스타 이즈 본","2019-03-13","2",32,491602,156
"13499","스타 이즈 본","2019-03-14","1",25,491627,157
"13500","스타 이즈 본","2019-03-15","1",20,491647,158
"13501","스타 이즈 본","2019-03-17","1",69,491716,159
"13502","스타 이즈 본","2019-03-19","1",34,491750,160
"13503","명탐정 코난 : 제로의 집행인","2018-07-31","3",822,822,0
"13504","명탐정 코난 : 제로의 집행인","2018-08-07","10",2000,2822,0
"13505","명탐정 코난 : 제로의 집행인","2018-08-08","542",87322,90144,1
"13506","명탐정 코난 : 제로의 집행인","2018-08-09","538",45711,135855,2
"13507","명탐정 코난 : 제로의 집행인","2018-08-10","510",33277,169132,3
"13508","명탐정 코난 : 제로의 집행인","2018-08-11","494",57645,226777,4
"13509","명탐정 코난 : 제로의 집행인","2018-08-12","497",55372,282149,5
"13510","명탐정 코난 : 제로의 집행인","2018-08-13","451",20978,303127,6
"13511","명탐정 코난 : 제로의 집행인","2018-08-14","431",21528,324655,7
"13512","명탐정 코난 : 제로의 집행인","2018-08-15","184",18833,343488,8
"13513","명탐정 코난 : 제로의 집행인","2018-08-16","169",5715,349203,9
"13514","명탐정 코난 : 제로의 집행인","2018-08-17","175",5329,354532,10
"13515","명탐정 코난 : 제로의 집행인","2018-08-18","190",11195,365727,11
"13516","명탐정 코난 : 제로의 집행인","2018-08-19","185",11530,377257,12
"13517","명탐정 코난 : 제로의 집행인","2018-08-20","172",3657,380914,13
"13518","명탐정 코난 : 제로의 집행인","2018-08-21","173",3541,384455,14
"13519","명탐정 코난 : 제로의 집행인","2018-08-22","84",1626,386081,15
"13520","명탐정 코난 : 제로의 집행인","2018-08-23","49",673,386754,16
"13521","명탐정 코난 : 제로의 집행인","2018-08-24","49",1247,388001,17
"13522","명탐정 코난 : 제로의 집행인","2018-08-25","70",2863,390864,18
"13523","명탐정 코난 : 제로의 집행인","2018-08-26","66",2342,393206,19
"13524","명탐정 코난 : 제로의 집행인","2018-08-27","44",413,393619,20
"13525","명탐정 코난 : 제로의 집행인","2018-08-28","43",604,394223,21
"13526","명탐정 코난 : 제로의 집행인","2018-08-29","9",187,394410,22
"13527","명탐정 코난 : 제로의 집행인","2018-08-30","10",382,394792,23
"13528","명탐정 코난 : 제로의 집행인","2018-08-31","9",121,394913,24
"13529","명탐정 코난 : 제로의 집행인","2018-09-01","15",336,395249,25
"13530","명탐정 코난 : 제로의 집행인","2018-09-02","16",434,395683,26
"13531","명탐정 코난 : 제로의 집행인","2018-09-03","7",61,395744,27
"13532","명탐정 코난 : 제로의 집행인","2018-09-04","8",51,395795,28
"13533","명탐정 코난 : 제로의 집행인","2018-09-05","8",57,395852,29
"13534","명탐정 코난 : 제로의 집행인","2018-09-06","2",36,395888,30
"13535","명탐정 코난 : 제로의 집행인","2018-09-07","1",19,395907,31
"13536","명탐정 코난 : 제로의 집행인","2018-09-08","6",148,396055,32
"13537","명탐정 코난 : 제로의 집행인","2018-09-09","6",105,396160,33
"13538","명탐정 코난 : 제로의 집행인","2018-09-10","3",7,396167,34
"13539","명탐정 코난 : 제로의 집행인","2018-09-11","3",29,396196,35
"13540","명탐정 코난 : 제로의 집행인","2018-09-12","2",20,396216,36
"13541","명탐정 코난 : 제로의 집행인","2018-09-13","1",5,396221,37
"13542","명탐정 코난 : 제로의 집행인","2018-09-17","1",3,396224,38
"13543","명탐정 코난 : 제로의 집행인","2018-09-18","1",6,396230,39
"13544","명탐정 코난 : 제로의 집행인","2019-01-02","1",144,396374,40
"13545","명탐정 코난 : 제로의 집행인","2019-01-03","1",120,396494,41
"13546","명탐정 코난 : 제로의 집행인","2019-01-09","31",6438,402932,42
"13547","명탐정 코난 : 제로의 집행인","2019-01-10","31",2806,405738,43
"13548","명탐정 코난 : 제로의 집행인","2019-01-11","31",2127,407865,44
"13549","명탐정 코난 : 제로의 집행인","2019-01-12","31",3630,411495,45
"13550","명탐정 코난 : 제로의 집행인","2019-01-13","31",3011,414506,46
"13551","명탐정 코난 : 제로의 집행인","2019-01-14","31",1087,415593,47
"13552","명탐정 코난 : 제로의 집행인","2019-01-15","30",1077,416670,48
"13553","명탐정 코난 : 제로의 집행인","2019-01-16","26",903,417573,49
"13554","명탐정 코난 : 제로의 집행인","2019-01-17","17",346,417919,50
"13555","명탐정 코난 : 제로의 집행인","2019-01-18","16",307,418226,51
"13556","명탐정 코난 : 제로의 집행인","2019-01-19","12",432,418658,52
"13557","명탐정 코난 : 제로의 집행인","2019-01-20","12",559,419217,53
"13558","명탐정 코난 : 제로의 집행인","2019-01-21","13",159,419376,54
"13559","명탐정 코난 : 제로의 집행인","2019-01-22","14",225,419601,55
"13560","명탐정 코난 : 제로의 집행인","2019-01-23","1",26,419627,56
"13561","명탐정 코난 : 제로의 집행인","2019-01-24","1",4,419631,57
"13562","명탐정 코난 : 제로의 집행인","2019-01-25","1",5,419636,58
"13563","명탐정 코난 : 제로의 집행인","2019-01-26","1",51,419687,59
"13564","명탐정 코난 : 제로의 집행인","2019-01-27","1",18,419705,60
"13565","명탐정 코난 : 제로의 집행인","2019-01-28","1",29,419734,61
"13566","명탐정 코난 : 제로의 집행인","2019-01-29","1",41,419775,62
"13567","피터 래빗","2018-05-07","1",170,170,0
"13568","피터 래빗","2018-05-08","6",1475,1645,0
"13569","피터 래빗","2018-05-10","1",172,1817,0
"13570","피터 래빗","2018-05-16","383",4019,5836,1
"13571","피터 래빗","2018-05-17","338",4253,10089,2
"13572","피터 래빗","2018-05-18","378",4790,14879,3
"13573","피터 래빗","2018-05-19","575",46914,61793,4
"13574","피터 래빗","2018-05-20","599",50693,112486,5
"13575","피터 래빗","2018-05-21","523",37859,150345,6
"13576","피터 래빗","2018-05-22","595",80134,230479,7
"13577","피터 래빗","2018-05-23","296",2907,233386,8
"13578","피터 래빗","2018-05-24","212",1854,235240,9
"13579","피터 래빗","2018-05-25","237",2602,237842,10
"13580","피터 래빗","2018-05-26","542",34278,272120,11
"13581","피터 래빗","2018-05-27","540",37804,309924,12
"13582","피터 래빗","2018-05-28","233",1589,311513,13
"13583","피터 래빗","2018-05-29","224",1937,313450,14
"13584","피터 래빗","2018-05-30","187",3208,316658,15
"13585","피터 래빗","2018-05-31","164",1814,318472,16
"13586","피터 래빗","2018-06-01","191",1970,320442,17
"13587","피터 래빗","2018-06-02","426",21367,341809,18
"13588","피터 래빗","2018-06-03","429",22828,364637,19
"13589","피터 래빗","2018-06-04","186",1410,366047,20
"13590","피터 래빗","2018-06-05","204",1900,367947,21
"13591","피터 래빗","2018-06-06","85",7234,375181,22
"13592","피터 래빗","2018-06-07","22",176,375357,23
"13593","피터 래빗","2018-06-08","29",350,375707,24
"13594","피터 래빗","2018-06-09","69",2685,378392,25
"13595","피터 래빗","2018-06-10","74",3173,381565,26
"13596","피터 래빗","2018-06-11","17",143,381708,27
"13597","피터 래빗","2018-06-12","22",206,381914,28
"13598","피터 래빗","2018-06-13","28",1762,383676,29
"13599","피터 래빗","2018-06-14","6",63,383739,30
"13600","피터 래빗","2018-06-15","7",114,383853,31
"13601","피터 래빗","2018-06-16","30",907,384760,32
"13602","피터 래빗","2018-06-17","30",1109,385869,33
"13603","피터 래빗","2018-06-18","8",128,385997,34
"13604","피터 래빗","2018-06-19","7",100,386097,35
"13605","피터 래빗","2018-06-20","8",126,386223,36
"13606","피터 래빗","2018-06-21","3",11,386234,37
"13607","피터 래빗","2018-06-22","5",38,386272,38
"13608","피터 래빗","2018-06-23","18",582,386854,39
"13609","피터 래빗","2018-06-24","17",688,387542,40
"13610","피터 래빗","2018-06-25","3",12,387554,41
"13611","피터 래빗","2018-06-26","2",7,387561,42
"13612","피터 래빗","2018-06-27","1",7,387568,43
"13613","피터 래빗","2018-06-28","3",43,387611,44
"13614","피터 래빗","2018-06-29","1",13,387624,45
"13615","피터 래빗","2018-06-30","4",170,387794,46
"13616","피터 래빗","2018-07-01","6",199,387993,47
"13617","피터 래빗","2018-07-02","1",14,388007,48
"13618","피터 래빗","2018-07-03","2",13,388020,49
"13619","피터 래빗","2018-07-05","1",32,388052,50
"13620","피터 래빗","2018-07-06","1",6,388058,51
"13621","피터 래빗","2018-07-07","1",25,388083,52
"13622","피터 래빗","2018-07-08","1",37,388120,53
"13623","피터 래빗","2018-07-19","1",180,388300,54
"13624","패딩턴 2","2018-01-26","5",1794,1794,0
"13625","패딩턴 2","2018-01-29","3",300,2094,0
"13626","패딩턴 2","2018-01-30","5",500,2594,0
"13627","패딩턴 2","2018-01-31","4",399,2993,0
"13628","패딩턴 2","2018-02-01","7",800,3793,0
"13629","패딩턴 2","2018-02-02","9",1841,5634,0
"13630","패딩턴 2","2018-02-03","1",248,5882,0
"13631","패딩턴 2","2018-02-06","11",1244,7126,0
"13632","패딩턴 2","2018-02-07","2",536,7662,0
"13633","패딩턴 2","2018-02-08","498",13670,21332,1
"13634","패딩턴 2","2018-02-09","510",14351,35683,2
"13635","패딩턴 2","2018-02-10","625",44831,80514,3
"13636","패딩턴 2","2018-02-11","629",45668,126182,4
"13637","패딩턴 2","2018-02-12","516",11442,137624,5
"13638","패딩턴 2","2018-02-13","539",17214,154838,6
"13639","패딩턴 2","2018-02-14","256",7572,162410,7
"13640","패딩턴 2","2018-02-15","282",14382,176792,8
"13641","패딩턴 2","2018-02-16","280",10963,187755,9
"13642","패딩턴 2","2018-02-17","290",20418,208173,10
"13643","패딩턴 2","2018-02-18","301",19341,227514,11
"13644","패딩턴 2","2018-02-19","269",6719,234233,12
"13645","패딩턴 2","2018-02-20","270",7861,242094,13
"13646","패딩턴 2","2018-02-21","249",7405,249499,14
"13647","패딩턴 2","2018-02-22","184",6333,255832,15
"13648","패딩턴 2","2018-02-23","197",7099,262931,16
"13649","패딩턴 2","2018-02-24","258",12545,275476,17
"13650","패딩턴 2","2018-02-25","252",12400,287876,18
"13651","패딩턴 2","2018-02-26","204",6724,294600,19
"13652","패딩턴 2","2018-02-27","205",8513,303113,20
"13653","패딩턴 2","2018-02-28","104",5029,308142,21
"13654","패딩턴 2","2018-03-01","148",11990,320132,22
"13655","패딩턴 2","2018-03-02","112",1467,321599,23
"13656","패딩턴 2","2018-03-03","148",5247,326846,24
"13657","패딩턴 2","2018-03-04","150",5430,332276,25
"13658","패딩턴 2","2018-03-05","60",289,332565,26
"13659","패딩턴 2","2018-03-06","64",294,332859,27
"13660","패딩턴 2","2018-03-07","31",137,332996,28
"13661","패딩턴 2","2018-03-08","13",71,333067,29
"13662","패딩턴 2","2018-03-09","14",579,333646,30
"13663","패딩턴 2","2018-03-10","63",2068,335714,31
"13664","패딩턴 2","2018-03-11","65",2197,337911,32
"13665","패딩턴 2","2018-03-12","13",62,337973,33
"13666","패딩턴 2","2018-03-13","16",82,338055,34
"13667","패딩턴 2","2018-03-14","4",9,338064,35
"13668","패딩턴 2","2018-03-15","1",2,338066,36
"13669","패딩턴 2","2018-03-17","8",221,338287,37
"13670","패딩턴 2","2018-03-18","10",368,338655,38
"13671","패딩턴 2","2018-03-19","1",2,338657,39
"13672","패딩턴 2","2018-03-20","1",7,338664,40
"13673","패딩턴 2","2018-03-21","2",35,338699,41
"13674","패딩턴 2","2018-03-24","2",68,338767,42
"13675","패딩턴 2","2018-03-25","2",54,338821,43
"13676","패딩턴 2","2018-03-28","1",0,338821,44
"13677","패딩턴 2","2018-03-31","1",50,338871,45
"13678","패딩턴 2","2018-04-01","1",28,338899,46
"13679","패딩턴 2","2018-04-23","1",0,338899,47
"13680","패딩턴 2","2018-04-24","1",0,338899,48
"13681","패딩턴 2","2018-07-04","2",115,339014,49
"13682","패딩턴 2","2018-07-07","1",0,339014,50
"13683","미드나잇 선","2018-06-01","1",120,120,0
"13684","미드나잇 선","2018-06-08","3",1003,1123,0
"13685","미드나잇 선","2018-06-10","1",40,1163,0
"13686","미드나잇 선","2018-06-11","5",764,1927,0
"13687","미드나잇 선","2018-06-12","4",594,2521,0
"13688","미드나잇 선","2018-06-14","5",1674,4195,0
"13689","미드나잇 선","2018-06-15","1",107,4302,0
"13690","미드나잇 선","2018-06-19","15",2116,6418,0
"13691","미드나잇 선","2018-06-20","6",1018,7436,0
"13692","미드나잇 선","2018-06-21","450",12067,19503,1
"13693","미드나잇 선","2018-06-22","442",13507,33010,2
"13694","미드나잇 선","2018-06-23","466",19181,52191,3
"13695","미드나잇 선","2018-06-24","472",21852,74043,4
"13696","미드나잇 선","2018-06-25","457",15929,89972,5
"13697","미드나잇 선","2018-06-26","462",16392,106364,6
"13698","미드나잇 선","2018-06-27","216",11394,117758,7
"13699","미드나잇 선","2018-06-28","189",7311,125069,8
"13700","미드나잇 선","2018-06-29","210",9877,134946,9
"13701","미드나잇 선","2018-06-30","268",16762,151708,10
"13702","미드나잇 선","2018-07-01","263",15070,166778,11
"13703","미드나잇 선","2018-07-02","253",9803,176581,12
"13704","미드나잇 선","2018-07-03","247",10034,186615,13
"13705","미드나잇 선","2018-07-04","122",4525,191140,14
"13706","미드나잇 선","2018-07-05","127",4958,196098,15
"13707","미드나잇 선","2018-07-06","134",6656,202754,16
"13708","미드나잇 선","2018-07-07","137",8466,211220,17
"13709","미드나잇 선","2018-07-08","138",8302,219522,18
"13710","미드나잇 선","2018-07-09","153",5012,224534,19
"13711","미드나잇 선","2018-07-10","153",7042,231576,20
"13712","미드나잇 선","2018-07-11","99",4425,236001,21
"13713","미드나잇 선","2018-07-12","96",3141,239142,22
"13714","미드나잇 선","2018-07-13","99",3691,242833,23
"13715","미드나잇 선","2018-07-14","136",8762,251595,24
"13716","미드나잇 선","2018-07-15","143",9246,260841,25
"13717","미드나잇 선","2018-07-16","145",4474,265315,26
"13718","미드나잇 선","2018-07-17","151",5455,270770,27
"13719","미드나잇 선","2018-07-18","115",4317,275087,28
"13720","미드나잇 선","2018-07-19","125",4502,279589,29
"13721","미드나잇 선","2018-07-20","147",6858,286447,30
"13722","미드나잇 선","2018-07-21","156",10101,296548,31
"13723","미드나잇 선","2018-07-22","154",10099,306647,32
"13724","미드나잇 선","2018-07-23","142",5919,312566,33
"13725","미드나잇 선","2018-07-24","150",6429,318995,34
"13726","미드나잇 선","2018-07-25","40",1741,320736,35
"13727","미드나잇 선","2018-07-26","28",627,321363,36
"13728","미드나잇 선","2018-07-27","33",700,322063,37
"13729","미드나잇 선","2018-07-28","36",909,322972,38
"13730","미드나잇 선","2018-07-29","39",1004,323976,39
"13731","미드나잇 선","2018-07-30","39",637,324613,40
"13732","미드나잇 선","2018-07-31","37",792,325405,41
"13733","미드나잇 선","2018-08-01","10",195,325600,42
"13734","미드나잇 선","2018-08-02","8",94,325694,43
"13735","미드나잇 선","2018-08-03","7",63,325757,44
"13736","미드나잇 선","2018-08-04","5",26,325783,45
"13737","미드나잇 선","2018-08-05","5",27,325810,46
"13738","미드나잇 선","2018-08-06","8",43,325853,47
"13739","미드나잇 선","2018-08-07","11",110,325963,48
"13740","미드나잇 선","2018-08-08","3",22,325985,49
"13741","미드나잇 선","2018-08-09","2",20,326005,50
"13742","미드나잇 선","2018-08-10","2",13,326018,51
"13743","미드나잇 선","2018-08-11","3",44,326062,52
"13744","미드나잇 선","2018-08-12","3",15,326077,53
"13745","미드나잇 선","2018-08-14","2",6,326083,54
"13746","미드나잇 선","2018-08-15","1",3,326086,55
"13747","트루스 오어 데어","2018-05-18","1",200,200,0
"13748","트루스 오어 데어","2018-05-22","530",54911,55111,1
"13749","트루스 오어 데어","2018-05-23","516",17299,72410,2
"13750","트루스 오어 데어","2018-05-24","501",14919,87329,3
"13751","트루스 오어 데어","2018-05-25","501",23005,110334,4
"13752","트루스 오어 데어","2018-05-26","520",38602,148936,5
"13753","트루스 오어 데어","2018-05-27","511",35621,184557,6
"13754","트루스 오어 데어","2018-05-28","490",12489,197046,7
"13755","트루스 오어 데어","2018-05-29","476",10794,207840,8
"13756","트루스 오어 데어","2018-05-30","329",15342,223182,9
"13757","트루스 오어 데어","2018-05-31","292",6991,230173,10
"13758","트루스 오어 데어","2018-06-01","320",11660,241833,11
"13759","트루스 오어 데어","2018-06-02","341",25023,266856,12
"13760","트루스 오어 데어","2018-06-03","336",21812,288668,13
"13761","트루스 오어 데어","2018-06-04","311",5673,294341,14
"13762","트루스 오어 데어","2018-06-05","333",7904,302245,15
"13763","트루스 오어 데어","2018-06-06","84",4592,306837,16
"13764","트루스 오어 데어","2018-06-07","46",508,307345,17
"13765","트루스 오어 데어","2018-06-08","54",721,308066,18
"13766","트루스 오어 데어","2018-06-09","41",692,308758,19
"13767","트루스 오어 데어","2018-06-10","39",555,309313,20
"13768","트루스 오어 데어","2018-06-11","38",234,309547,21
"13769","트루스 오어 데어","2018-06-12","44",352,309899,22
"13770","트루스 오어 데어","2018-06-13","6",69,309968,23
"13771","트루스 오어 데어","2018-06-14","4",10,309978,24
"13772","트루스 오어 데어","2018-06-15","3",34,310012,25
"13773","트루스 오어 데어","2018-06-16","5",44,310056,26
"13774","트루스 오어 데어","2018-06-17","4",38,310094,27
"13775","트루스 오어 데어","2018-06-18","2",3,310097,28
"13776","트루스 오어 데어","2018-06-19","7",223,310320,29
"13777","트루스 오어 데어","2018-06-20","1",32,310352,30
"13778","트루스 오어 데어","2018-06-21","1",34,310386,31
"13779","트루스 오어 데어","2018-06-22","1",34,310420,32
"13780","트루스 오어 데어","2018-06-23","1",34,310454,33
"13781","트루스 오어 데어","2018-06-24","1",36,310490,34
"13782","트루스 오어 데어","2018-06-25","1",31,310521,35
"13783","트루스 오어 데어","2018-06-26","1",34,310555,36
"13784","트루스 오어 데어","2018-06-27","1",36,310591,37
"13785","트루스 오어 데어","2018-06-28","1",30,310621,38
"13786","트루스 오어 데어","2018-06-29","1",42,310663,39
"13787","트루스 오어 데어","2018-06-30","1",32,310695,40
"13788","트루스 오어 데어","2018-07-01","1",34,310729,41
"13789","트루스 오어 데어","2018-07-02","1",30,310759,42
"13790","트루스 오어 데어","2018-07-03","1",36,310795,43
"13791","트루스 오어 데어","2018-07-04","1",30,310825,44
"13792","트루스 오어 데어","2018-07-05","1",30,310855,45
"13793","트루스 오어 데어","2018-07-06","1",38,310893,46
"13794","트루스 오어 데어","2018-07-07","1",32,310925,47
"13795","트루스 오어 데어","2018-07-08","1",31,310956,48
"13796","커뮤터","2018-01-10","1",33,33,0
"13797","커뮤터","2018-01-11","2",705,738,0
"13798","커뮤터","2018-01-16","2",476,1214,0
"13799","커뮤터","2018-01-18","2",421,1635,0
"13800","커뮤터","2018-01-23","25",3035,4670,0
"13801","커뮤터","2018-01-24","553",35006,39676,1
"13802","커뮤터","2018-01-25","543",32942,72618,2
"13803","커뮤터","2018-01-26","548",33446,106064,3
"13804","커뮤터","2018-01-27","575",62288,168352,4
"13805","커뮤터","2018-01-28","559",54826,223178,5
"13806","커뮤터","2018-01-29","521",19287,242465,6
"13807","커뮤터","2018-01-30","521",16663,259128,7
"13808","커뮤터","2018-01-31","203",5176,264304,8
"13809","커뮤터","2018-02-01","169",2854,267158,9
"13810","커뮤터","2018-02-02","163",2588,269746,10
"13811","커뮤터","2018-02-03","147",3974,273720,11
"13812","커뮤터","2018-02-04","139",3725,277445,12
"13813","커뮤터","2018-02-05","149",1572,279017,13
"13814","커뮤터","2018-02-06","144",1516,280533,14
"13815","커뮤터","2018-02-07","143",1392,281925,15
"13816","커뮤터","2018-02-08","17",142,282067,16
"13817","커뮤터","2018-02-09","16",168,282235,17
"13818","커뮤터","2018-02-10","14",343,282578,18
"13819","커뮤터","2018-02-11","15",272,282850,19
"13820","커뮤터","2018-02-12","16",112,282962,20
"13821","커뮤터","2018-02-13","18",259,283221,21
"13822","커뮤터","2018-02-14","4",101,283322,22
"13823","커뮤터","2018-02-15","3",176,283498,23
"13824","커뮤터","2018-02-16","2",60,283558,24
"13825","커뮤터","2018-02-17","2",51,283609,25
"13826","커뮤터","2018-02-18","2",33,283642,26
"13827","커뮤터","2018-02-19","2",28,283670,27
"13828","커뮤터","2018-02-20","1",20,283690,28
"13829","커뮤터","2018-02-21","2",24,283714,29
"13830","커뮤터","2018-02-22","2",21,283735,30
"13831","커뮤터","2018-02-23","1",20,283755,31
"13832","커뮤터","2018-02-24","2",21,283776,32
"13833","커뮤터","2018-02-25","2",26,283802,33
"13834","커뮤터","2018-02-26","1",20,283822,34
"13835","커뮤터","2018-02-27","2",22,283844,35
"13836","커뮤터","2018-02-28","1",20,283864,36
"13837","커뮤터","2018-03-01","1",20,283884,37
"13838","커뮤터","2018-03-02","1",20,283904,38
"13839","커뮤터","2018-03-03","1",20,283924,39
"13840","커뮤터","2018-03-04","1",20,283944,40
"13841","커뮤터","2018-03-05","1",20,283964,41
"13842","커뮤터","2018-03-06","1",20,283984,42
"13843","커뮤터","2018-03-07","1",20,284004,43
"13844","커뮤터","2018-03-08","1",20,284024,44
"13845","커뮤터","2018-03-09","1",20,284044,45
"13846","커뮤터","2018-03-10","1",20,284064,46
"13847","커뮤터","2018-03-11","1",20,284084,47
"13848","커뮤터","2018-03-12","1",20,284104,48
"13849","커뮤터","2018-03-13","1",20,284124,49
"13850","커뮤터","2018-03-14","1",20,284144,50
"13851","커뮤터","2018-03-15","2",208,284352,51
"13852","커뮤터","2018-03-16","1",20,284372,52
"13853","커뮤터","2018-03-17","1",20,284392,53
"13854","커뮤터","2018-03-18","1",20,284412,54
"13855","커뮤터","2018-03-19","1",20,284432,55
"13856","커뮤터","2018-03-20","1",20,284452,56
"13857","커뮤터","2018-03-21","1",20,284472,57
"13858","커뮤터","2018-03-22","1",20,284492,58
"13859","커뮤터","2018-03-23","1",20,284512,59
"13860","커뮤터","2018-03-24","1",20,284532,60
"13861","커뮤터","2018-03-25","1",20,284552,61
"13862","커뮤터","2018-03-26","19",190,284742,62
"13863","커뮤터","2018-03-27","18",180,284922,63
"13864","커뮤터","2018-03-28","4",40,284962,64
"13865","커뮤터","2018-03-29","5",50,285012,65
"13866","커뮤터","2018-03-30","5",50,285062,66
"13867","커뮤터","2018-03-31","5",50,285112,67
"13868","커뮤터","2018-04-01","5",50,285162,68
"13869","커뮤터","2018-04-02","5",50,285212,69
"13870","커뮤터","2018-04-03","5",50,285262,70
"13871","커뮤터","2018-04-04","5",50,285312,71
"13872","커뮤터","2018-04-05","5",50,285362,72
"13873","커뮤터","2018-04-06","5",50,285412,73
"13874","커뮤터","2018-04-07","4",40,285452,74
"13875","커뮤터","2018-04-08","5",60,285512,75
"13876","커뮤터","2018-04-09","5",50,285562,76
"13877","커뮤터","2018-04-18","1",220,285782,77
"13878","커뮤터","2018-04-19","1",200,285982,78
"13879","커뮤터","2018-05-14","1",60,286042,79
"13880","커뮤터","2018-06-30","1",20,286062,80
"13881","후드","2018-11-07","1",170,170,0
"13882","후드","2018-11-20","1",247,417,0
"13883","후드","2018-11-21","1",598,1015,0
"13884","후드","2018-11-22","2",305,1320,0
"13885","후드","2018-11-23","7",685,2005,0
"13886","후드","2018-11-27","1",193,2198,0
"13887","후드","2018-11-28","628",58586,60784,1
"13888","후드","2018-11-29","577",28957,89741,2
"13889","후드","2018-11-30","588",37024,126765,3
"13890","후드","2018-12-01","597",54017,180782,4
"13891","후드","2018-12-02","603",46476,227258,5
"13892","후드","2018-12-03","547",17969,245227,6
"13893","후드","2018-12-04","571",15299,260526,7
"13894","후드","2018-12-05","259",4662,265188,8
"13895","후드","2018-12-06","192",3778,268966,9
"13896","후드","2018-12-07","179",2599,271565,10
"13897","후드","2018-12-08","158",2801,274366,11
"13898","후드","2018-12-09","143",2292,276658,12
"13899","후드","2018-12-10","128",1083,277741,13
"13900","후드","2018-12-11","133",1441,279182,14
"13901","후드","2018-12-12","23",1240,280422,15
"13902","후드","2018-12-13","15",878,281300,16
"13903","후드","2018-12-14","23",2083,283383,17
"13904","후드","2018-12-15","13",980,284363,18
"13905","후드","2018-12-16","7",83,284446,19
"13906","후드","2018-12-17","6",16,284462,20
"13907","후드","2018-12-18","6",129,284591,21
"13908","후드","2018-12-19","2",10,284601,22
"13909","극장판 짱구는 못말려: 아뵤! 쿵후 보이즈 ~라면 대란~","2018-12-11","4",750,750,0
"13910","극장판 짱구는 못말려: 아뵤! 쿵후 보이즈 ~라면 대란~","2018-12-17","3",742,1492,0
"13911","극장판 짱구는 못말려: 아뵤! 쿵후 보이즈 ~라면 대란~","2018-12-19","296",5904,7396,1
"13912","극장판 짱구는 못말려: 아뵤! 쿵후 보이즈 ~라면 대란~","2018-12-20","286",4299,11695,2
"13913","극장판 짱구는 못말려: 아뵤! 쿵후 보이즈 ~라면 대란~","2018-12-21","298",4393,16088,3
"13914","극장판 짱구는 못말려: 아뵤! 쿵후 보이즈 ~라면 대란~","2018-12-22","428",44580,60668,4
"13915","극장판 짱구는 못말려: 아뵤! 쿵후 보이즈 ~라면 대란~","2018-12-23","489",51871,112539,5
"13916","극장판 짱구는 못말려: 아뵤! 쿵후 보이즈 ~라면 대란~","2018-12-24","419",11141,123680,6
"13917","극장판 짱구는 못말려: 아뵤! 쿵후 보이즈 ~라면 대란~","2018-12-25","444",69481,193161,7
"13918","극장판 짱구는 못말려: 아뵤! 쿵후 보이즈 ~라면 대란~","2018-12-26","187",4556,197717,8
"13919","극장판 짱구는 못말려: 아뵤! 쿵후 보이즈 ~라면 대란~","2018-12-27","195",5309,203026,9
"13920","극장판 짱구는 못말려: 아뵤! 쿵후 보이즈 ~라면 대란~","2018-12-28","201",5752,208778,10
"13921","극장판 짱구는 못말려: 아뵤! 쿵후 보이즈 ~라면 대란~","2018-12-29","301",24821,233599,11
"13922","극장판 짱구는 못말려: 아뵤! 쿵후 보이즈 ~라면 대란~","2018-12-30","316",26154,259753,12
"13923","극장판 짱구는 못말려: 아뵤! 쿵후 보이즈 ~라면 대란~","2018-12-31","269",17453,277206,13
"13924","극장판 짱구는 못말려: 아뵤! 쿵후 보이즈 ~라면 대란~","2019-01-01","336",29372,306578,14
"13925","극장판 짱구는 못말려: 아뵤! 쿵후 보이즈 ~라면 대란~","2019-01-02","280",10414,316992,15
"13926","극장판 짱구는 못말려: 아뵤! 쿵후 보이즈 ~라면 대란~","2019-01-03","148",4200,321192,16
"13927","극장판 짱구는 못말려: 아뵤! 쿵후 보이즈 ~라면 대란~","2019-01-04","154",3967,325159,17
"13928","극장판 짱구는 못말려: 아뵤! 쿵후 보이즈 ~라면 대란~","2019-01-05","160",8061,333220,18
"13929","극장판 짱구는 못말려: 아뵤! 쿵후 보이즈 ~라면 대란~","2019-01-06","157",7849,341069,19
"13930","극장판 짱구는 못말려: 아뵤! 쿵후 보이즈 ~라면 대란~","2019-01-07","151",2412,343481,20
"13931","극장판 짱구는 못말려: 아뵤! 쿵후 보이즈 ~라면 대란~","2019-01-08","156",2702,346183,21
"13932","극장판 짱구는 못말려: 아뵤! 쿵후 보이즈 ~라면 대란~","2019-01-09","70",1243,347426,22
"13933","극장판 짱구는 못말려: 아뵤! 쿵후 보이즈 ~라면 대란~","2019-01-10","38",759,348185,23
"13934","극장판 짱구는 못말려: 아뵤! 쿵후 보이즈 ~라면 대란~","2019-01-11","40",693,348878,24
"13935","극장판 짱구는 못말려: 아뵤! 쿵후 보이즈 ~라면 대란~","2019-01-12","39",1427,350305,25
"13936","극장판 짱구는 못말려: 아뵤! 쿵후 보이즈 ~라면 대란~","2019-01-13","38",1413,351718,26
"13937","극장판 짱구는 못말려: 아뵤! 쿵후 보이즈 ~라면 대란~","2019-01-14","38",442,352160,27
"13938","극장판 짱구는 못말려: 아뵤! 쿵후 보이즈 ~라면 대란~","2019-01-15","39",536,352696,28
"13939","극장판 짱구는 못말려: 아뵤! 쿵후 보이즈 ~라면 대란~","2019-01-16","3",18,352714,29
"13940","극장판 짱구는 못말려: 아뵤! 쿵후 보이즈 ~라면 대란~","2019-01-17","2",7,352721,30
"13941","극장판 짱구는 못말려: 아뵤! 쿵후 보이즈 ~라면 대란~","2019-01-18","1",7,352728,31
"13942","극장판 짱구는 못말려: 아뵤! 쿵후 보이즈 ~라면 대란~","2019-01-19","5",110,352838,32
"13943","극장판 짱구는 못말려: 아뵤! 쿵후 보이즈 ~라면 대란~","2019-01-20","6",150,352988,33
"13944","극장판 짱구는 못말려: 아뵤! 쿵후 보이즈 ~라면 대란~","2019-01-21","2",6,352994,34
"13945","극장판 짱구는 못말려: 아뵤! 쿵후 보이즈 ~라면 대란~","2019-01-22","3",18,353012,35
"13946","해리포터와 마법사의 돌","2018-10-22","1",144,144,0
"13947","해리포터와 마법사의 돌","2018-10-23","16",1887,2031,0
"13948","해리포터와 마법사의 돌","2018-10-24","33",17482,19513,0
"13949","해리포터와 마법사의 돌","2018-10-25","32",17098,36611,0
"13950","해리포터와 마법사의 돌","2018-10-26","32",20213,56824,0
"13951","해리포터와 마법사의 돌","2018-10-27","32",24223,81047,0
"13952","해리포터와 마법사의 돌","2018-10-28","32",22430,103477,0
"13953","해리포터와 마법사의 돌","2018-10-29","32",15124,118601,0
"13954","해리포터와 마법사의 돌","2018-10-30","32",14373,132974,0
"13955","해리포터와 마법사의 돌","2018-10-31","32",16145,149119,0
"13956","해리포터와 마법사의 돌","2018-11-01","32",15432,164551,0
"13957","해리포터와 마법사의 돌","2018-11-02","32",19476,184027,0
"13958","해리포터와 마법사의 돌","2018-11-03","30",8732,192759,0
"13959","해리포터와 마법사의 돌","2018-11-04","32",9007,201766,0
"13960","해리포터와 마법사의 돌","2018-11-05","32",5876,207642,0
"13961","해리포터와 마법사의 돌","2018-11-06","32",4994,212636,0
"13962","해리포터와 마법사의 돌","2018-11-07","32",5561,218197,0
"13963","해리포터와 마법사의 돌","2018-11-08","32",5105,223302,0
"13964","해리포터와 마법사의 돌","2018-11-09","32",7753,231055,0
"13965","해리포터와 마법사의 돌","2018-11-10","32",14889,245944,0
"13966","해리포터와 마법사의 돌","2018-11-11","32",13789,259733,0
"13967","해리포터와 마법사의 돌","2018-11-12","32",3923,263656,0
"13968","해리포터와 마법사의 돌","2018-11-13","33",4294,267950,0
"13969","모털 엔진","2018-12-05","661",45519,45519,1
"13970","모털 엔진","2018-12-06","630",26922,72441,2
"13971","모털 엔진","2018-12-07","622",30250,102691,3
"13972","모털 엔진","2018-12-08","600",53109,155800,4
"13973","모털 엔진","2018-12-09","582",47572,203372,5
"13974","모털 엔진","2018-12-10","574",14755,218127,6
"13975","모털 엔진","2018-12-11","569",15336,233463,7
"13976","모털 엔진","2018-12-12","286",7576,241039,8
"13977","모털 엔진","2018-12-13","258",6052,247091,9
"13978","모털 엔진","2018-12-14","239",5725,252816,10
"13979","모털 엔진","2018-12-15","197",5365,258181,11
"13980","모털 엔진","2018-12-16","187",3889,262070,12
"13981","모털 엔진","2018-12-17","201",2107,264177,13
"13982","모털 엔진","2018-12-18","190",2934,267111,14
"13983","모털 엔진","2018-12-19","6",161,267272,15
"13984","모털 엔진","2018-12-20","8",343,267615,16
"13985","모털 엔진","2018-12-21","5",42,267657,17
"13986","모털 엔진","2018-12-22","2",17,267674,18
"13987","모털 엔진","2018-12-23","3",43,267717,19
"13988","모털 엔진","2018-12-24","1",23,267740,20
"13989","모털 엔진","2018-12-25","2",68,267808,21
"13990","모털 엔진","2018-12-26","3",88,267896,22
"13991","모털 엔진","2019-01-02","5",300,268196,23
"13992","모털 엔진","2019-01-03","2",65,268261,24
"13993","모털 엔진","2019-01-04","1",60,268321,25
"13994","모털 엔진","2019-01-05","1",60,268381,26
"13995","모털 엔진","2019-01-06","1",60,268441,27
"13996","모털 엔진","2019-01-07","1",60,268501,28
"13997","모털 엔진","2019-01-08","1",60,268561,29
"13998","모털 엔진","2019-01-09","1",60,268621,30
"13999","모털 엔진","2019-01-10","1",60,268681,31
"14000","모털 엔진","2019-01-11","1",60,268741,32
"14001","모털 엔진","2019-01-12","1",60,268801,33
"14002","모털 엔진","2019-01-13","1",60,268861,34
"14003","모털 엔진","2019-01-14","1",60,268921,35
"14004","바울","2018-10-01","1",120,120,0
"14005","바울","2018-10-05","1",115,235,0
"14006","바울","2018-10-08","1",136,371,0
"14007","바울","2018-10-10","1",131,502,0
"14008","바울","2018-10-11","4",459,961,0
"14009","바울","2018-10-12","2",248,1209,0
"14010","바울","2018-10-15","1",154,1363,0
"14011","바울","2018-10-16","3",256,1619,0
"14012","바울","2018-10-17","2",204,1823,0
"14013","바울","2018-10-18","8",1396,3219,0
"14014","바울","2018-10-19","1",207,3426,0
"14015","바울","2018-10-21","1",184,3610,0
"14016","바울","2018-10-22","6",839,4449,0
"14017","바울","2018-10-23","7",826,5275,0
"14018","바울","2018-10-24","3",302,5577,0
"14019","바울","2018-10-25","4",601,6178,0
"14020","바울","2018-10-26","1",179,6357,0
"14021","바울","2018-10-28","1",87,6444,0
"14022","바울","2018-10-29","2",229,6673,0
"14023","바울","2018-10-30","3",381,7054,0
"14024","바울","2018-10-31","200",5055,12109,1
"14025","바울","2018-11-01","198",4674,16783,2
"14026","바울","2018-11-02","205",5922,22705,3
"14027","바울","2018-11-03","216",8799,31504,4
"14028","바울","2018-11-04","217",11539,43043,5
"14029","바울","2018-11-05","211",6587,49630,6
"14030","바울","2018-11-06","227",8222,57852,7
"14031","바울","2018-11-07","173",6236,64088,8
"14032","바울","2018-11-08","167",8495,72583,9
"14033","바울","2018-11-09","173",8224,80807,10
"14034","바울","2018-11-10","192",12195,93002,11
"14035","바울","2018-11-11","211",15994,108996,12
"14036","바울","2018-11-12","186",6996,115992,13
"14037","바울","2018-11-13","196",8985,124977,14
"14038","바울","2018-11-14","139",4508,129485,15
"14039","바울","2018-11-15","121",5191,134676,16
"14040","바울","2018-11-16","140",7452,142128,17
"14041","바울","2018-11-17","137",8182,150310,18
"14042","바울","2018-11-18","149",9967,160277,19
"14043","바울","2018-11-19","137",5589,165866,20
"14044","바울","2018-11-20","144",5738,171604,21
"14045","바울","2018-11-21","148",5380,176984,22
"14046","바울","2018-11-22","113",4512,181496,23
"14047","바울","2018-11-23","117",4694,186190,24
"14048","바울","2018-11-24","125",6580,192770,25
"14049","바울","2018-11-25","145",8990,201760,26
"14050","바울","2018-11-26","115",3535,205295,27
"14051","바울","2018-11-27","129",5304,210599,28
"14052","바울","2018-11-28","70",2261,212860,29
"14053","바울","2018-11-29","71",2892,215752,30
"14054","바울","2018-11-30","88",4117,219869,31
"14055","바울","2018-12-01","78",3843,223712,32
"14056","바울","2018-12-02","91",6125,229837,33
"14057","바울","2018-12-03","71",1814,231651,34
"14058","바울","2018-12-04","73",2212,233863,35
"14059","바울","2018-12-05","53",1644,235507,36
"14060","바울","2018-12-06","41",1095,236602,37
"14061","바울","2018-12-07","41",1577,238179,38
"14062","바울","2018-12-08","42",2243,240422,39
"14063","바울","2018-12-09","53",3283,243705,40
"14064","바울","2018-12-10","40",1020,244725,41
"14065","바울","2018-12-11","46",2166,246891,42
"14066","바울","2018-12-12","41",2166,249057,43
"14067","바울","2018-12-13","35",1879,250936,44
"14068","바울","2018-12-14","38",2285,253221,45
"14069","바울","2018-12-15","38",2159,255380,46
"14070","바울","2018-12-16","44",2325,257705,47
"14071","바울","2018-12-17","32",898,258603,48
"14072","바울","2018-12-18","30",768,259371,49
"14073","바울","2018-12-19","14",1251,260622,50
"14074","바울","2018-12-20","10",574,261196,51
"14075","바울","2018-12-21","10",488,261684,52
"14076","바울","2018-12-22","12",651,262335,53
"14077","바울","2018-12-23","14",544,262879,54
"14078","바울","2018-12-24","7",511,263390,55
"14079","바울","2018-12-25","14",1050,264440,56
"14080","바울","2018-12-26","11",1045,265485,57
"14081","바울","2018-12-27","8",342,265827,58
"14082","바울","2018-12-28","9",417,266244,59
"14083","바울","2018-12-29","8",409,266653,60
"14084","바울","2018-12-30","11",776,267429,61
"14085","바울","2018-12-31","8",356,267785,62
"14086","바울","2019-01-01","7",577,268362,63
"14087","바울","2019-01-02","8",253,268615,64
"14088","바울","2019-01-03","6",147,268762,65
"14089","바울","2019-01-04","9",158,268920,66
"14090","바울","2019-01-05","10",384,269304,67
"14091","바울","2019-01-06","12",326,269630,68
"14092","바울","2019-01-07","7",91,269721,69
"14093","바울","2019-01-08","9",153,269874,70
"14094","바울","2019-01-09","6",56,269930,71
"14095","바울","2019-01-10","6",71,270001,72
"14096","바울","2019-01-11","6",71,270072,73
"14097","바울","2019-01-12","7",182,270254,74
"14098","바울","2019-01-13","9",137,270391,75
"14099","바울","2019-01-14","8",68,270459,76
"14100","바울","2019-01-15","7",53,270512,77
"14101","바울","2019-01-16","6",43,270555,78
"14102","바울","2019-01-17","5",37,270592,79
"14103","바울","2019-01-18","4",44,270636,80
"14104","바울","2019-01-19","7",162,270798,81
"14105","바울","2019-01-20","5",47,270845,82
"14106","바울","2019-01-21","6",31,270876,83
"14107","바울","2019-01-22","6",110,270986,84
"14108","바울","2019-01-23","3",33,271019,85
"14109","바울","2019-01-24","3",21,271040,86
"14110","바울","2019-01-25","3",47,271087,87
"14111","바울","2019-01-26","3",176,271263,88
"14112","바울","2019-01-27","3",267,271530,89
"14113","바울","2019-01-28","4",24,271554,90
"14114","바울","2019-01-29","2",12,271566,91
"14115","바울","2019-01-30","1",5,271571,92
"14116","바울","2019-01-31","1",18,271589,93
"14117","바울","2019-02-01","2",10,271599,94
"14118","바울","2019-02-02","4",37,271636,95
"14119","바울","2019-02-03","2",17,271653,96
"14120","바울","2019-02-04","2",31,271684,97
"14121","바울","2019-02-05","1",32,271716,98
"14122","바울","2019-02-06","2",57,271773,99
"14123","바울","2019-02-07","2",12,271785,100
"14124","바울","2019-02-08","2",13,271798,101
"14125","바울","2019-02-09","1",30,271828,102
"14126","바울","2019-02-11","1",2,271830,103
"14127","바울","2019-02-12","1",10,271840,104
"14128","바울","2019-02-13","1",3,271843,105
"14129","바울","2019-02-14","2",9,271852,106
"14130","바울","2019-02-15","1",3,271855,107
"14131","바울","2019-02-16","2",31,271886,108
"14132","바울","2019-02-17","2",120,272006,109
"14133","바울","2019-02-19","1",7,272013,110
"14134","바울","2019-02-20","1",2,272015,111
"14135","바울","2019-02-21","1",1,272016,112
"14136","바울","2019-02-23","1",50,272066,113
"14137","바울","2019-02-24","1",120,272186,114
"14138","바울","2019-02-25","1",10,272196,115
"14139","바울","2019-02-26","1",1,272197,116
"14140","바울","2019-02-27","2",4,272201,117
"14141","바울","2019-02-28","1",1,272202,118
"14142","바울","2019-03-02","1",7,272209,119
"14143","바울","2019-03-04","1",2,272211,120
"14144","바울","2019-03-05","1",1,272212,121
"14145","바울","2019-03-09","1",12,272224,122
"14146","바울","2019-03-11","1",1,272225,123
"14147","바울","2019-03-17","1",89,272314,124
"14148","나를 차버린 스파이","2018-08-09","1",170,170,0
"14149","나를 차버린 스파이","2018-08-10","2",618,788,0
"14150","나를 차버린 스파이","2018-08-14","20",3897,4685,0
"14151","나를 차버린 스파이","2018-08-16","14",2559,7244,0
"14152","나를 차버린 스파이","2018-08-17","9",1716,8960,0
"14153","나를 차버린 스파이","2018-08-21","15",1357,10317,0
"14154","나를 차버린 스파이","2018-08-22","278",29368,39685,1
"14155","나를 차버린 스파이","2018-08-23","268",19282,58967,2
"14156","나를 차버린 스파이","2018-08-24","262",26836,85803,3
"14157","나를 차버린 스파이","2018-08-25","250",41990,127793,4
"14158","나를 차버린 스파이","2018-08-26","236",36199,163992,5
"14159","나를 차버린 스파이","2018-08-27","223",13534,177526,6
"14160","나를 차버린 스파이","2018-08-28","228",12553,190079,7
"14161","나를 차버린 스파이","2018-08-29","163",9368,199447,8
"14162","나를 차버린 스파이","2018-08-30","184",6074,205521,9
"14163","나를 차버린 스파이","2018-08-31","174",7641,213162,10
"14164","나를 차버린 스파이","2018-09-01","186",10455,223617,11
"14165","나를 차버린 스파이","2018-09-02","193",11436,235053,12
"14166","나를 차버린 스파이","2018-09-03","171",3893,238946,13
"14167","나를 차버린 스파이","2018-09-04","175",3794,242740,14
"14168","나를 차버린 스파이","2018-09-05","160",3755,246495,15
"14169","나를 차버린 스파이","2018-09-06","97",2036,248531,16
"14170","나를 차버린 스파이","2018-09-07","103",2187,250718,17
"14171","나를 차버린 스파이","2018-09-08","105",3961,254679,18
"14172","나를 차버린 스파이","2018-09-09","104",3337,258016,19
"14173","나를 차버린 스파이","2018-09-10","94",1328,259344,20
"14174","나를 차버린 스파이","2018-09-11","95",1156,260500,21
"14175","나를 차버린 스파이","2018-09-12","27",425,260925,22
"14176","나를 차버린 스파이","2018-09-13","29",400,261325,23
"14177","나를 차버린 스파이","2018-09-14","31",505,261830,24
"14178","나를 차버린 스파이","2018-09-15","34",1101,262931,25
"14179","나를 차버린 스파이","2018-09-16","37",1007,263938,26
"14180","나를 차버린 스파이","2018-09-17","36",401,264339,27
"14181","나를 차버린 스파이","2018-09-18","37",412,264751,28
"14182","나를 차버린 스파이","2018-09-19","1",1,264752,29
"14183","나를 차버린 스파이","2018-09-20","1",1,264753,30
"14184","나를 차버린 스파이","2018-09-21","1",1,264754,31
"14185","나를 차버린 스파이","2018-09-22","1",1,264755,32
"14186","나를 차버린 스파이","2018-09-23","1",1,264756,33
"14187","나를 차버린 스파이","2018-09-24","1",1,264757,34
"14188","나를 차버린 스파이","2018-09-25","1",1,264758,35
"14189","나를 차버린 스파이","2018-09-26","1",1,264759,36
"14190","나를 차버린 스파이","2018-09-27","1",1,264760,37
"14191","나를 차버린 스파이","2018-09-28","1",1,264761,38
"14192","나를 차버린 스파이","2018-09-29","1",1,264762,39
"14193","나를 차버린 스파이","2018-09-30","1",1,264763,40
"14194","나를 차버린 스파이","2018-10-01","1",1,264764,41
"14195","나를 차버린 스파이","2018-10-02","1",1,264765,42
"14196","나를 차버린 스파이","2018-10-03","1",1,264766,43
"14197","극한직업","2019-01-09","1",406,406,0
"14198","극한직업","2019-01-10","9",3279,3685,0
"14199","극한직업","2019-01-15","11",2201,5886,0
"14200","극한직업","2019-01-16","23",5094,10980,0
"14201","극한직업","2019-01-17","40",7746,18726,0
"14202","극한직업","2019-01-18","1",432,19158,0
"14203","극한직업","2019-01-21","9",1823,20981,0
"14204","극한직업","2019-01-22","23",3210,24191,0
"14205","극한직업","2019-01-23","1,553",368582,392773,1
"14206","극한직업","2019-01-24","1,658",331924,724697,2
"14207","극한직업","2019-01-25","1,741",386371,1111068,3
"14208","극한직업","2019-01-26","1,910",995406,2106474,4
"14209","극한직업","2019-01-27","1,978",1033089,3139563,5
"14210","극한직업","2019-01-28","1,766",397188,3536751,6
"14211","극한직업","2019-01-29","1,827",358186,3894937,7
"14212","극한직업","2019-01-30","1,574",564825,4459762,8
"14213","극한직업","2019-01-31","1,548",350685,4810447,9
"14214","극한직업","2019-02-01","1,701",462875,5273322,10
"14215","극한직업","2019-02-02","1,890",962555,6235877,11
"14216","극한직업","2019-02-03","1,949",1058680,7294557,12
"14217","극한직업","2019-02-04","2,003",975927,8270484,13
"14218","극한직업","2019-02-05","1,844",1130176,9400660,14
"14219","극한직업","2019-02-06","1,835",1131697,10532357,15
"14220","극한직업","2019-02-07","1,558",460448,10992805,16
"14221","극한직업","2019-02-08","1,595",409796,11402601,17
"14222","극한직업","2019-02-09","1,703",776215,12178816,18
"14223","극한직업","2019-02-10","1,707",660049,12838865,19
"14224","극한직업","2019-02-11","1,571",214339,13053204,20
"14225","극한직업","2019-02-12","1,571",198066,13251270,21
"14226","극한직업","2019-02-13","1,193",172086,13423356,22
"14227","극한직업","2019-02-14","1,027",167585,13590941,23
"14228","극한직업","2019-02-15","1,059",191503,13782444,24
"14229","극한직업","2019-02-16","1,158",405476,14187920,25
"14230","극한직업","2019-02-17","1,166",348325,14536245,26
"14231","극한직업","2019-02-18","1,071",114307,14650552,27
"14232","극한직업","2019-02-19","1,073",114270,14764822,28
"14233","극한직업","2019-02-20","836",91845,14856667,29
"14234","극한직업","2019-02-21","807",82354,14939021,30
"14235","극한직업","2019-02-22","858",93652,15032673,31
"14236","극한직업","2019-02-23","890",199025,15231698,32
"14237","극한직업","2019-02-24","905",185583,15417281,33
"14238","극한직업","2019-02-25","827",65055,15482336,34
"14239","극한직업","2019-02-26","840",61140,15543476,35
"14240","극한직업","2019-02-27","646",89179,15632655,36
"14241","극한직업","2019-02-28","638",66832,15699487,37
"14242","극한직업","2019-03-01","669",134879,15834366,38
"14243","극한직업","2019-03-02","728",112618,15946984,39
"14244","극한직업","2019-03-03","698",82814,16029798,40
"14245","극한직업","2019-03-04","613",26877,16056675,41
"14246","극한직업","2019-03-05","620",25684,16082359,42
"14247","극한직업","2019-03-06","460",12235,16094594,43
"14248","극한직업","2019-03-07","491",12010,16106604,44
"14249","극한직업","2019-03-08","489",13978,16120582,45
"14250","극한직업","2019-03-09","523",28632,16149214,46
"14251","극한직업","2019-03-10","507",29340,16178554,47
"14252","극한직업","2019-03-11","530",10946,16189500,48
"14253","극한직업","2019-03-12","531",11755,16201255,49
"14254","극한직업","2019-03-13","510",9228,16210483,50
"14255","극한직업","2019-03-14","305",5386,16215869,51
"14256","극한직업","2019-03-15","317",5416,16221285,52
"14257","극한직업","2019-03-16","348",11245,16232530,53
"14258","극한직업","2019-03-17","347",10714,16243244,54
"14259","극한직업","2019-03-18","339",4531,16247775,55
"14260","극한직업","2019-03-19","340",4813,16252588,56
"14261","극한직업","2019-03-20","83",1205,16253793,57
"14262","극한직업","2019-03-21","78",1248,16255041,58
"14263","극한직업","2019-03-22","72",932,16255973,59
"14264","극한직업","2019-03-23","60",1172,16257145,60
"14265","말모이","2018-11-27","1",1,1,0
"14266","말모이","2018-12-17","1",262,263,0
"14267","말모이","2018-12-18","108",22785,23048,0
"14268","말모이","2018-12-19","44",11570,34618,0
"14269","말모이","2018-12-20","39",10133,44751,0
"14270","말모이","2018-12-21","2",361,45112,0
"14271","말모이","2018-12-22","2",230,45342,0
"14272","말모이","2018-12-27","24",5127,50469,0
"14273","말모이","2018-12-28","2",297,50766,0
"14274","말모이","2018-12-29","6",1361,52127,0
"14275","말모이","2018-12-30","6",1237,53364,0
"14276","말모이","2018-12-31","1",212,53576,0
"14277","말모이","2019-01-02","13",2253,55829,0
"14278","말모이","2019-01-03","30",3422,59251,0
"14279","말모이","2019-01-04","10",1770,61021,0
"14280","말모이","2019-01-05","447",42874,103895,0
"14281","말모이","2019-01-06","449",48084,151979,0
"14282","말모이","2019-01-07","35",7208,159187,0
"14283","말모이","2019-01-08","18",3333,162520,0
"14284","말모이","2019-01-09","1,077",122458,284978,1
"14285","말모이","2019-01-10","1,112",114367,399345,2
"14286","말모이","2019-01-11","1,128",138509,537854,3
"14287","말모이","2019-01-12","1,203",322741,860595,4
"14288","말모이","2019-01-13","1,202",324324,1184919,5
"14289","말모이","2019-01-14","1,106",112037,1296956,6
"14290","말모이","2019-01-15","1,116",111887,1408843,7
"14291","말모이","2019-01-16","1,015",107579,1516422,8
"14292","말모이","2019-01-17","965",90529,1606951,9
"14293","말모이","2019-01-18","1,021",108567,1715518,10
"14294","말모이","2019-01-19","1,135",259951,1975469,11
"14295","말모이","2019-01-20","1,137",249109,2224578,12
"14296","말모이","2019-01-21","1,046",82069,2306647,13
"14297","말모이","2019-01-22","1,081",75518,2382165,14
"14298","말모이","2019-01-23","807",47177,2429342,15
"14299","말모이","2019-01-24","827",40419,2469761,16
"14300","말모이","2019-01-25","826",38664,2508425,17
"14301","말모이","2019-01-26","810",80123,2588548,18
"14302","말모이","2019-01-27","783",69004,2657552,19
"14303","말모이","2019-01-28","760",24255,2681807,20
"14304","말모이","2019-01-29","783",25202,2707009,21
"14305","말모이","2019-01-30","391",21211,2728220,22
"14306","말모이","2019-01-31","338",9897,2738117,23
"14307","말모이","2019-02-01","318",10617,2748734,24
"14308","말모이","2019-02-02","281",16107,2764841,25
"14309","말모이","2019-02-03","286",18715,2783556,26
"14310","말모이","2019-02-04","281",19166,2802722,27
"14311","말모이","2019-02-05","179",14371,2817093,28
"14312","말모이","2019-02-06","177",12231,2829324,29
"14313","말모이","2019-02-07","147",3419,2832743,30
"14314","말모이","2019-02-08","151",3895,2836638,31
"14315","말모이","2019-02-09","174",6466,2843104,32
"14316","말모이","2019-02-10","175",5642,2848746,33
"14317","말모이","2019-02-11","159",2627,2851373,34
"14318","말모이","2019-02-12","160",2550,2853923,35
"14319","말모이","2019-02-13","30",1128,2855051,36
"14320","말모이","2019-02-14","10",320,2855371,37
"14321","말모이","2019-02-15","8",216,2855587,38
"14322","말모이","2019-02-16","10",396,2855983,39
"14323","말모이","2019-02-17","8",178,2856161,40
"14324","말모이","2019-02-18","17",375,2856536,41
"14325","말모이","2019-02-19","35",1067,2857603,42
"14326","말모이","2019-02-20","9",526,2858129,43
"14327","말모이","2019-02-21","33",1369,2859498,44
"14328","말모이","2019-02-22","5",173,2859671,45
"14329","말모이","2019-02-23","10",432,2860103,46
"14330","말모이","2019-02-24","5",590,2860693,47
"14331","말모이","2019-02-25","7",232,2860925,48
"14332","말모이","2019-02-26","3",32,2860957,49
"14333","말모이","2019-02-27","3",44,2861001,50
"14334","말모이","2019-03-01","1",49,2861050,51
"14335","말모이","2019-03-03","3",292,2861342,52
"14336","말모이","2019-03-06","1",1,2861343,53
"14337","말모이","2019-03-10","1",4,2861347,54
"14338","말모이","2019-03-12","1",1,2861348,55
"14339","말모이","2019-03-14","1",16,2861364,56
"14340","말모이","2019-03-15","1",183,2861547,57
"14341","말모이","2019-03-16","2",343,2861890,58
"14342","말모이","2019-03-17","1",2,2861892,59
"14343","말모이","2019-03-20","5",1044,2862936,60
"14344","말모이","2019-03-22","1",175,2863111,61
"14345","증인","2019-01-20","1",262,262,0
"14346","증인","2019-01-21","4",966,1228,0
"14347","증인","2019-01-22","7",1649,2877,0
"14348","증인","2019-01-23","4",1022,3899,0
"14349","증인","2019-01-24","4",1035,4934,0
"14350","증인","2019-01-28","20",5028,9962,0
"14351","증인","2019-01-29","10",1996,11958,0
"14352","증인","2019-01-31","46",5989,17947,0
"14353","증인","2019-02-01","1",315,18262,0
"14354","증인","2019-02-02","14",3335,21597,0
"14355","증인","2019-02-03","14",2846,24443,0
"14356","증인","2019-02-07","10",2640,27083,0
"14357","증인","2019-02-09","15",3585,30668,0
"14358","증인","2019-02-10","14",3095,33763,0
"14359","증인","2019-02-12","25",2262,36025,0
"14360","증인","2019-02-13","884",81424,117449,1
"14361","증인","2019-02-14","806",85900,203349,2
"14362","증인","2019-02-15","833",98611,301960,3
"14363","증인","2019-02-16","937",209875,511835,4
"14364","증인","2019-02-17","993",225305,737140,5
"14365","증인","2019-02-18","960",94251,831391,6
"14366","증인","2019-02-19","1,047",116432,947823,7
"14367","증인","2019-02-20","830",80798,1028621,8
"14368","증인","2019-02-21","838",77606,1106227,9
"14369","증인","2019-02-22","916",90479,1196706,10
"14370","증인","2019-02-23","1,046",187720,1384426,11
"14371","증인","2019-02-24","1,040",175832,1560258,12
"14372","증인","2019-02-25","943",67363,1627621,13
"14373","증인","2019-02-26","953",67934,1695555,14
"14374","증인","2019-02-27","815",138913,1834468,15
"14375","증인","2019-02-28","850",81279,1915747,16
"14376","증인","2019-03-01","963",148186,2063933,17
"14377","증인","2019-03-02","974",127417,2191350,18
"14378","증인","2019-03-03","957",97042,2288392,19
"14379","증인","2019-03-04","843",27595,2315987,20
"14380","증인","2019-03-05","826",24411,2340398,21
"14381","증인","2019-03-06","560",15115,2355513,22
"14382","증인","2019-03-07","556",14173,2369686,23
"14383","증인","2019-03-08","564",16074,2385760,24
"14384","증인","2019-03-09","555",35898,2421658,25
"14385","증인","2019-03-10","573",35633,2457291,26
"14386","증인","2019-03-11","528",10735,2468026,27
"14387","증인","2019-03-12","536",10600,2478626,28
"14388","증인","2019-03-13","527",8705,2487331,29
"14389","증인","2019-03-14","371",5294,2492625,30
"14390","증인","2019-03-15","368",5926,2498551,31
"14391","증인","2019-03-16","379",11229,2509780,32
"14392","증인","2019-03-17","369",9370,2519150,33
"14393","증인","2019-03-18","373",3996,2523146,34
"14394","증인","2019-03-19","367",4121,2527267,35
"14395","증인","2019-03-20","68",810,2528077,36
"14396","증인","2019-03-21","63",722,2528799,37
"14397","증인","2019-03-22","62",717,2529516,38
"14398","증인","2019-03-23","62",779,2530295,39
"14399","사바하","2019-01-29","2",727,727,0
"14400","사바하","2019-02-13","5",1432,2159,0
"14401","사바하","2019-02-18","9",1816,3975,0
"14402","사바하","2019-02-19","23",3198,7173,0
"14403","사바하","2019-02-20","1,162",184517,191690,1
"14404","사바하","2019-02-21","1,149",144986,336676,2
"14405","사바하","2019-02-22","1,174",177329,514005,3
"14406","사바하","2019-02-23","1,142",348834,862839,4
"14407","사바하","2019-02-24","1,155",313336,1176175,5
"14408","사바하","2019-02-25","1,080",119778,1295953,6
"14409","사바하","2019-02-26","1,103",106800,1402753,7
"14410","사바하","2019-02-27","906",167791,1570544,8
"14411","사바하","2019-02-28","909",106839,1677383,9
"14412","사바하","2019-03-01","949",186751,1864134,10
"14413","사바하","2019-03-02","955",162038,2026172,11
"14414","사바하","2019-03-03","912",122329,2148501,12
"14415","사바하","2019-03-04","832",37179,2185680,13
"14416","사바하","2019-03-05","833",33650,2219330,14
"14417","사바하","2019-03-06","524",15911,2235241,15
"14418","사바하","2019-03-07","518",14538,2249779,16
"14419","사바하","2019-03-08","553",18892,2268671,17
"14420","사바하","2019-03-09","560",38446,2307117,18
"14421","사바하","2019-03-10","546",33408,2340525,19
"14422","사바하","2019-03-11","527",10706,2351231,20
"14423","사바하","2019-03-12","544",9976,2361207,21
"14424","사바하","2019-03-13","504",8076,2369283,22
"14425","사바하","2019-03-14","271",3503,2372786,23
"14426","사바하","2019-03-15","277",3998,2376784,24
"14427","사바하","2019-03-16","289",7730,2384514,25
"14428","사바하","2019-03-17","272",5250,2389764,26
"14429","사바하","2019-03-18","279",2376,2392140,27
"14430","사바하","2019-03-19","272",2149,2394289,28
"14431","사바하","2019-03-20","20",267,2394556,29
"14432","사바하","2019-03-21","19",741,2395297,30
"14433","사바하","2019-03-22","17",261,2395558,31
"14434","사바하","2019-03-23","17",331,2395889,32
"14435","내안의 그놈","2018-11-28","1",132,132,0
"14436","내안의 그놈","2018-11-29","1",233,365,0
"14437","내안의 그놈","2018-11-30","6",1339,1704,0
"14438","내안의 그놈","2018-12-01","1",134,1838,0
"14439","내안의 그놈","2018-12-11","1",229,2067,0
"14440","내안의 그놈","2018-12-13","7",1610,3677,0
"14441","내안의 그놈","2018-12-14","6",1659,5336,0
"14442","내안의 그놈","2018-12-17","4",635,5971,0
"14443","내안의 그놈","2018-12-18","14",3249,9220,0
"14444","내안의 그놈","2018-12-19","7",2118,11338,0
"14445","내안의 그놈","2018-12-20","1",160,11498,0
"14446","내안의 그놈","2018-12-21","2",737,12235,0
"14447","내안의 그놈","2018-12-24","1",233,12468,0
"14448","내안의 그놈","2018-12-26","5",968,13436,0
"14449","내안의 그놈","2018-12-27","7",1734,15170,0
"14450","내안의 그놈","2018-12-28","1",1,15171,0
"14451","내안의 그놈","2019-01-03","25",4807,19978,0
"14452","내안의 그놈","2019-01-04","1",416,20394,0
"14453","내안의 그놈","2019-01-07","26",2142,22536,0
"14454","내안의 그놈","2019-01-08","28",4183,26719,0
"14455","내안의 그놈","2019-01-09","671",85238,111957,1
"14456","내안의 그놈","2019-01-10","776",88860,200817,2
"14457","내안의 그놈","2019-01-11","880",111168,311985,3
"14458","내안의 그놈","2019-01-12","1,004",223603,535588,4
"14459","내안의 그놈","2019-01-13","1,041",229792,765380,5
"14460","내안의 그놈","2019-01-14","963",95878,861258,6
"14461","내안의 그놈","2019-01-15","1,004",92667,953925,7
"14462","내안의 그놈","2019-01-16","954",89952,1043877,8
"14463","내안의 그놈","2019-01-17","862",75564,1119441,9
"14464","내안의 그놈","2019-01-18","899",90405,1209846,10
"14465","내안의 그놈","2019-01-19","992",195973,1405819,11
"14466","내안의 그놈","2019-01-20","992",191234,1597053,12
"14467","내안의 그놈","2019-01-21","890",71568,1668621,13
"14468","내안의 그놈","2019-01-22","913",62309,1730930,14
"14469","내안의 그놈","2019-01-23","656",29853,1760783,15
"14470","내안의 그놈","2019-01-24","641",22822,1783605,16
"14471","내안의 그놈","2019-01-25","627",20908,1804513,17
"14472","내안의 그놈","2019-01-26","617",35366,1839879,18
"14473","내안의 그놈","2019-01-27","602",31245,1871124,19
"14474","내안의 그놈","2019-01-28","589",14309,1885433,20
"14475","내안의 그놈","2019-01-29","570",15429,1900862,21
"14476","내안의 그놈","2019-01-30","117",2895,1903757,22
"14477","내안의 그놈","2019-01-31","81",1455,1905212,23
"14478","내안의 그놈","2019-02-01","81",1817,1907029,24
"14479","내안의 그놈","2019-02-02","61",1906,1908935,25
"14480","내안의 그놈","2019-02-03","60",1867,1910802,26
"14481","내안의 그놈","2019-02-04","64",1994,1912796,27
"14482","내안의 그놈","2019-02-05","19",539,1913335,28
"14483","내안의 그놈","2019-02-06","16",417,1913752,29
"14484","내안의 그놈","2019-02-07","8",110,1913862,30
"14485","내안의 그놈","2019-02-08","9",118,1913980,31
"14486","내안의 그놈","2019-02-09","10",235,1914215,32
"14487","내안의 그놈","2019-02-10","9",169,1914384,33
"14488","내안의 그놈","2019-02-11","8",77,1914461,34
"14489","내안의 그놈","2019-02-12","9",121,1914582,35
"14490","내안의 그놈","2019-02-13","5",406,1914988,36
"14491","내안의 그놈","2019-02-14","3",243,1915231,37
"14492","내안의 그놈","2019-02-15","2",59,1915290,38
"14493","내안의 그놈","2019-02-16","2",73,1915363,39
"14494","내안의 그놈","2019-02-17","3",113,1915476,40
"14495","내안의 그놈","2019-02-18","3",115,1915591,41
"14496","내안의 그놈","2019-02-19","4",109,1915700,42
"14497","내안의 그놈","2019-02-20","3",109,1915809,43
"14498","내안의 그놈","2019-02-21","3",101,1915910,44
"14499","내안의 그놈","2019-02-22","1",31,1915941,45
"14500","내안의 그놈","2019-02-25","2",31,1915972,46
"14501","내안의 그놈","2019-02-26","14",467,1916439,47
"14502","내안의 그놈","2019-02-27","2",60,1916499,48
"14503","내안의 그놈","2019-02-28","11",350,1916849,49
"14504","내안의 그놈","2019-03-05","1",1,1916850,50
"14505","내안의 그놈","2019-03-06","1",1,1916851,51
"14506","내안의 그놈","2019-03-20","1",4,1916855,52
"14507","뺑반","2019-01-23","1",186,186,0
"14508","뺑반","2019-01-24","13",3923,4109,0
"14509","뺑반","2019-01-25","34",4787,8896,0
"14510","뺑반","2019-01-28","9",2809,11705,0
"14511","뺑반","2019-01-29","12",2552,14257,0
"14512","뺑반","2019-01-30","1,285",253727,267984,1
"14513","뺑반","2019-01-31","1,186",122748,390732,2
"14514","뺑반","2019-02-01","1,134",131301,522033,3
"14515","뺑반","2019-02-02","1,083",219180,741213,4
"14516","뺑반","2019-02-03","1,060",221789,963002,5
"14517","뺑반","2019-02-04","996",180905,1143907,6
"14518","뺑반","2019-02-05","802",162519,1306426,7
"14519","뺑반","2019-02-06","786",148122,1454548,8
"14520","뺑반","2019-02-07","761",61925,1516473,9
"14521","뺑반","2019-02-08","734",53774,1570247,10
"14522","뺑반","2019-02-09","718",86771,1657018,11
"14523","뺑반","2019-02-10","698",75176,1732194,12
"14524","뺑반","2019-02-11","698",29614,1761808,13
"14525","뺑반","2019-02-12","714",28998,1790806,14
"14526","뺑반","2019-02-13","369",11793,1802599,15
"14527","뺑반","2019-02-14","207",5088,1807687,16
"14528","뺑반","2019-02-15","194",4308,1811995,17
"14529","뺑반","2019-02-16","160",4815,1816810,18
"14530","뺑반","2019-02-17","155",4337,1821147,19
"14531","뺑반","2019-02-18","158",2168,1823315,20
"14532","뺑반","2019-02-19","164",2320,1825635,21
"14533","뺑반","2019-02-20","10",114,1825749,22
"14534","뺑반","2019-02-21","9",75,1825824,23
"14535","뺑반","2019-02-22","9",55,1825879,24
"14536","뺑반","2019-02-23","8",107,1825986,25
"14537","뺑반","2019-02-24","9",168,1826154,26
"14538","뺑반","2019-02-25","8",40,1826194,27
"14539","뺑반","2019-02-26","8",63,1826257,28
"14540","뺑반","2019-02-27","1",15,1826272,29
"14541","뺑반","2019-02-28","1",2,1826274,30
"14542","뺑반","2019-03-03","1",1,1826275,31
"14543","뺑반","2019-03-05","1",1,1826276,32
"14544","뺑반","2019-03-16","1",8,1826284,33
"14545","뺑반","2019-03-20","2",430,1826714,34
"14546","항거:유관순 이야기","2019-02-15","4",862,862,0
"14547","항거:유관순 이야기","2019-02-19","3",332,1194,0
"14548","항거:유관순 이야기","2019-02-25","7",1796,2990,0
"14549","항거:유관순 이야기","2019-02-27","737",99754,102744,1
"14550","항거:유관순 이야기","2019-02-28","794",82232,184976,2
"14551","항거:유관순 이야기","2019-03-01","1,052",262491,447467,3
"14552","항거:유관순 이야기","2019-03-02","1,094",189038,636505,4
"14553","항거:유관순 이야기","2019-03-03","1,085",154533,791038,5
"14554","항거:유관순 이야기","2019-03-04","890",44117,835155,6
"14555","항거:유관순 이야기","2019-03-05","900",35164,870319,7
"14556","항거:유관순 이야기","2019-03-06","600",20715,891034,8
"14557","항거:유관순 이야기","2019-03-07","620",20085,911119,9
"14558","항거:유관순 이야기","2019-03-08","633",23212,934331,10
"14559","항거:유관순 이야기","2019-03-09","633",54780,989111,11
"14560","항거:유관순 이야기","2019-03-10","603",52939,1042050,12
"14561","항거:유관순 이야기","2019-03-11","618",13394,1055444,13
"14562","항거:유관순 이야기","2019-03-12","617",13016,1068460,14
"14563","항거:유관순 이야기","2019-03-13","614",11665,1080125,15
"14564","항거:유관순 이야기","2019-03-14","410",7028,1087153,16
"14565","항거:유관순 이야기","2019-03-15","418",8213,1095366,17
"14566","항거:유관순 이야기","2019-03-16","453",16972,1112338,18
"14567","항거:유관순 이야기","2019-03-17","453",16559,1128897,19
"14568","항거:유관순 이야기","2019-03-18","406",4489,1133386,20
"14569","항거:유관순 이야기","2019-03-19","399",4435,1137821,21
"14570","항거:유관순 이야기","2019-03-20","106",1243,1139064,22
"14571","항거:유관순 이야기","2019-03-21","69",2021,1141085,23
"14572","항거:유관순 이야기","2019-03-22","66",710,1141795,24
"14573","항거:유관순 이야기","2019-03-23","71",1218,1143013,25
"14574","돈","2019-03-06","19",3999,3999,0
"14575","돈","2019-03-07","8",1334,5333,0
"14576","돈","2019-03-11","8",1620,6953,0
"14577","돈","2019-03-12","17",3493,10446,0
"14578","돈","2019-03-13","1",183,10629,0
"14579","돈","2019-03-14","35",6239,16868,0
"14580","돈","2019-03-15","1",176,17044,0
"14581","돈","2019-03-16","373",28293,45337,0
"14582","돈","2019-03-17","375",30127,75464,0
"14583","돈","2019-03-18","17",6693,82157,0
"14584","돈","2019-03-19","35",6190,88347,0
"14585","돈","2019-03-20","1,146",165833,254180,1
"14586","돈","2019-03-21","1,166",170844,425024,2
"14587","돈","2019-03-22","1,268",214518,639542,3
"14588","돈","2019-03-23","1,410",480741,1120283,4
"14589","극장판 헬로카봇: 옴파로스 섬의 비밀","2019-01-17","1",140,140,0
"14590","극장판 헬로카봇: 옴파로스 섬의 비밀","2019-01-24","2",617,757,0
"14591","극장판 헬로카봇: 옴파로스 섬의 비밀","2019-01-25","2",506,1263,0
"14592","극장판 헬로카봇: 옴파로스 섬의 비밀","2019-01-28","1",100,1363,0
"14593","극장판 헬로카봇: 옴파로스 섬의 비밀","2019-01-29","4",400,1763,0
"14594","극장판 헬로카봇: 옴파로스 섬의 비밀","2019-01-30","5",525,2288,0
"14595","극장판 헬로카봇: 옴파로스 섬의 비밀","2019-01-31","622",48839,51127,1
"14596","극장판 헬로카봇: 옴파로스 섬의 비밀","2019-02-01","595",28939,80066,2
"14597","극장판 헬로카봇: 옴파로스 섬의 비밀","2019-02-02","731",134911,214977,3
"14598","극장판 헬로카봇: 옴파로스 섬의 비밀","2019-02-03","752",94623,309600,4
"14599","극장판 헬로카봇: 옴파로스 섬의 비밀","2019-02-04","690",50787,360387,5
"14600","극장판 헬로카봇: 옴파로스 섬의 비밀","2019-02-05","542",25536,385923,6
"14601","극장판 헬로카봇: 옴파로스 섬의 비밀","2019-02-06","543",54316,440239,7
"14602","극장판 헬로카봇: 옴파로스 섬의 비밀","2019-02-07","398",8591,448830,8
"14603","극장판 헬로카봇: 옴파로스 섬의 비밀","2019-02-08","393",7492,456322,9
"14604","극장판 헬로카봇: 옴파로스 섬의 비밀","2019-02-09","447",33522,489844,10
"14605","극장판 헬로카봇: 옴파로스 섬의 비밀","2019-02-10","464",33390,523234,11
"14606","극장판 헬로카봇: 옴파로스 섬의 비밀","2019-02-11","320",3425,526659,12
"14607","극장판 헬로카봇: 옴파로스 섬의 비밀","2019-02-12","342",4752,531411,13
"14608","극장판 헬로카봇: 옴파로스 섬의 비밀","2019-02-13","168",3272,534683,14
"14609","극장판 헬로카봇: 옴파로스 섬의 비밀","2019-02-14","110",1950,536633,15
"14610","극장판 헬로카봇: 옴파로스 섬의 비밀","2019-02-15","104",2527,539160,16
"14611","극장판 헬로카봇: 옴파로스 섬의 비밀","2019-02-16","165",8716,547876,17
"14612","극장판 헬로카봇: 옴파로스 섬의 비밀","2019-02-17","174",10271,558147,18
"14613","극장판 헬로카봇: 옴파로스 섬의 비밀","2019-02-18","103",1430,559577,19
"14614","극장판 헬로카봇: 옴파로스 섬의 비밀","2019-02-19","106",1397,560974,20
"14615","극장판 헬로카봇: 옴파로스 섬의 비밀","2019-02-20","44",844,561818,21
"14616","극장판 헬로카봇: 옴파로스 섬의 비밀","2019-02-21","44",997,562815,22
"14617","극장판 헬로카봇: 옴파로스 섬의 비밀","2019-02-22","52",1167,563982,23
"14618","극장판 헬로카봇: 옴파로스 섬의 비밀","2019-02-23","74",2562,566544,24
"14619","극장판 헬로카봇: 옴파로스 섬의 비밀","2019-02-24","71",2499,569043,25
"14620","극장판 헬로카봇: 옴파로스 섬의 비밀","2019-02-25","47",1222,570265,26
"14621","극장판 헬로카봇: 옴파로스 섬의 비밀","2019-02-26","47",1354,571619,27
"14622","극장판 헬로카봇: 옴파로스 섬의 비밀","2019-02-27","12",268,571887,28
"14623","극장판 헬로카봇: 옴파로스 섬의 비밀","2019-02-28","14",388,572275,29
"14624","극장판 헬로카봇: 옴파로스 섬의 비밀","2019-03-01","16",569,572844,30
"14625","극장판 헬로카봇: 옴파로스 섬의 비밀","2019-03-02","19",504,573348,31
"14626","극장판 헬로카봇: 옴파로스 섬의 비밀","2019-03-03","18",433,573781,32
"14627","극장판 헬로카봇: 옴파로스 섬의 비밀","2019-03-04","9",84,573865,33
"14628","극장판 헬로카봇: 옴파로스 섬의 비밀","2019-03-05","5",29,573894,34
"14629","극장판 헬로카봇: 옴파로스 섬의 비밀","2019-03-06","3",7,573901,35
"14630","극장판 헬로카봇: 옴파로스 섬의 비밀","2019-03-07","3",13,573914,36
"14631","극장판 헬로카봇: 옴파로스 섬의 비밀","2019-03-08","2",3,573917,37
"14632","극장판 헬로카봇: 옴파로스 섬의 비밀","2019-03-09","12",188,574105,38
"14633","극장판 헬로카봇: 옴파로스 섬의 비밀","2019-03-10","12",200,574305,39
"14634","극장판 헬로카봇: 옴파로스 섬의 비밀","2019-03-11","2",3,574308,40
"14635","극장판 헬로카봇: 옴파로스 섬의 비밀","2019-03-12","1",3,574311,41
"14636","극장판 헬로카봇: 옴파로스 섬의 비밀","2019-03-13","1",4,574315,42
"14637","극장판 헬로카봇: 옴파로스 섬의 비밀","2019-03-15","2",3,574318,43
"14638","극장판 헬로카봇: 옴파로스 섬의 비밀","2019-03-16","5",110,574428,44
"14639","극장판 헬로카봇: 옴파로스 섬의 비밀","2019-03-17","5",71,574499,45
"14640","극장판 헬로카봇: 옴파로스 섬의 비밀","2019-03-19","1",2,574501,46
"14641","극장판 헬로카봇: 옴파로스 섬의 비밀","2019-03-20","3",8,574509,47
"14642","극장판 헬로카봇: 옴파로스 섬의 비밀","2019-03-21","2",11,574520,48
"14643","극장판 헬로카봇: 옴파로스 섬의 비밀","2019-03-22","1",4,574524,49
"14644","극장판 헬로카봇: 옴파로스 섬의 비밀","2019-03-23","3",47,574571,50
"14701","극장판 공룡메카드: 타이니소어의 섬","2018-12-26","1",142,142,0
"14702","극장판 공룡메카드: 타이니소어의 섬","2019-01-03","2",512,654,0
"14703","극장판 공룡메카드: 타이니소어의 섬","2019-01-07","3",300,954,0
"14704","극장판 공룡메카드: 타이니소어의 섬","2019-01-08","4",417,1371,0
"14705","극장판 공룡메카드: 타이니소어의 섬","2019-01-09","3",204,1575,0
"14706","극장판 공룡메카드: 타이니소어의 섬","2019-01-10","692",57616,59191,1
"14707","극장판 공룡메카드: 타이니소어의 섬","2019-01-11","707",30253,89444,2
"14708","극장판 공룡메카드: 타이니소어의 섬","2019-01-12","763",110957,200401,3
"14709","극장판 공룡메카드: 타이니소어의 섬","2019-01-13","748",89477,289878,4
"14710","극장판 공룡메카드: 타이니소어의 섬","2019-01-14","568",11348,301226,5
"14711","극장판 공룡메카드: 타이니소어의 섬","2019-01-15","557",11066,312292,6
"14712","극장판 공룡메카드: 타이니소어의 섬","2019-01-16","407",7576,319868,7
"14713","극장판 공룡메카드: 타이니소어의 섬","2019-01-17","346",5491,325359,8
"14714","극장판 공룡메카드: 타이니소어의 섬","2019-01-18","334",5115,330474,9
"14715","극장판 공룡메카드: 타이니소어의 섬","2019-01-19","436",24858,355332,10
"14716","극장판 공룡메카드: 타이니소어의 섬","2019-01-20","460",24237,379569,11
"14717","극장판 공룡메카드: 타이니소어의 섬","2019-01-21","303",2798,382367,12
"14718","극장판 공룡메카드: 타이니소어의 섬","2019-01-22","313",3113,385480,13
"14719","극장판 공룡메카드: 타이니소어의 섬","2019-01-23","150",1611,387091,14
"14720","극장판 공룡메카드: 타이니소어의 섬","2019-01-24","142",1462,388553,15
"14721","극장판 공룡메카드: 타이니소어의 섬","2019-01-25","141",1964,390517,16
"14722","극장판 공룡메카드: 타이니소어의 섬","2019-01-26","194",7624,398141,17
"14723","극장판 공룡메카드: 타이니소어의 섬","2019-01-27","197",7878,406019,18
"14724","극장판 공룡메카드: 타이니소어의 섬","2019-01-28","105",862,406881,19
"14725","극장판 공룡메카드: 타이니소어의 섬","2019-01-29","111",952,407833,20
"14726","극장판 공룡메카드: 타이니소어의 섬","2019-01-30","30",318,408151,21
"14727","극장판 공룡메카드: 타이니소어의 섬","2019-01-31","17",79,408230,22
"14728","극장판 공룡메카드: 타이니소어의 섬","2019-02-01","14",99,408329,23
"14729","극장판 공룡메카드: 타이니소어의 섬","2019-02-02","17",238,408567,24
"14730","극장판 공룡메카드: 타이니소어의 섬","2019-02-03","17",255,408822,25
"14731","극장판 공룡메카드: 타이니소어의 섬","2019-02-04","14",140,408962,26
"14732","극장판 공룡메카드: 타이니소어의 섬","2019-02-05","7",71,409033,27
"14733","극장판 공룡메카드: 타이니소어의 섬","2019-02-06","7",151,409184,28
"14734","극장판 공룡메카드: 타이니소어의 섬","2019-02-07","3",14,409198,29
"14735","극장판 공룡메카드: 타이니소어의 섬","2019-02-08","4",44,409242,30
"14736","극장판 공룡메카드: 타이니소어의 섬","2019-02-09","5",54,409296,31
"14737","극장판 공룡메카드: 타이니소어의 섬","2019-02-10","5",69,409365,32
"14738","극장판 공룡메카드: 타이니소어의 섬","2019-02-11","4",12,409377,33
"14739","극장판 공룡메카드: 타이니소어의 섬","2019-02-12","4",16,409393,34
"14740","극장판 공룡메카드: 타이니소어의 섬","2019-02-13","5",545,409938,35
"14741","극장판 공룡메카드: 타이니소어의 섬","2019-02-15","1",32,409970,36
"14742","극장판 공룡메카드: 타이니소어의 섬","2019-02-19","1",33,410003,37
"14743","극장판 공룡메카드: 타이니소어의 섬","2019-02-20","2",99,410102,38
"14744","극장판 공룡메카드: 타이니소어의 섬","2019-02-21","1",37,410139,39
"14745","극장판 공룡메카드: 타이니소어의 섬","2019-02-22","1",29,410168,40
"14746","극장판 공룡메카드: 타이니소어의 섬","2019-02-24","1",12,410180,41
"14747","극장판 공룡메카드: 타이니소어의 섬","2019-02-27","1",5,410185,42
"14748","극장판 공룡메카드: 타이니소어의 섬","2019-03-20","1",10,410195,43
"14749","극장판 공룡메카드: 타이니소어의 섬","2019-03-21","1",4,410199,44
"14750","극장판 공룡메카드: 타이니소어의 섬","2019-03-23","1",17,410216,45
"14751","러브 유어셀프 인 서울","2019-01-26","224",100191,100191,1
"14752","러브 유어셀프 인 서울","2019-01-27","212",81912,182103,2
"14753","러브 유어셀프 인 서울","2019-01-28","162",26513,208616,3
"14754","러브 유어셀프 인 서울","2019-01-29","161",25240,233856,4
"14755","러브 유어셀프 인 서울","2019-01-30","132",18491,252347,5
"14756","러브 유어셀프 인 서울","2019-01-31","123",10332,262679,6
"14757","러브 유어셀프 인 서울","2019-02-01","118",10696,273375,7
"14758","러브 유어셀프 인 서울","2019-02-02","110",14831,288206,8
"14759","러브 유어셀프 인 서울","2019-02-03","108",11001,299207,9
"14760","러브 유어셀프 인 서울","2019-02-04","100",6127,305334,10
"14761","러브 유어셀프 인 서울","2019-02-05","68",3982,309316,11
"14762","러브 유어셀프 인 서울","2019-02-06","62",6455,315771,12
"14763","러브 유어셀프 인 서울","2019-02-07","48",3520,319291,13
"14764","러브 유어셀프 인 서울","2019-02-08","48",3641,322932,14
"14765","러브 유어셀프 인 서울","2019-02-09","44",9454,332386,15
"14766","러브 유어셀프 인 서울","2019-02-10","41",9980,342366,16
"14767","기묘한 가족","2019-01-21","4",1126,1126,0
"14768","기묘한 가족","2019-01-30","5",1972,3098,0
"14769","기묘한 가족","2019-01-31","15",4022,7120,0
"14770","기묘한 가족","2019-02-07","3",745,7865,0
"14771","기묘한 가족","2019-02-08","19",5271,13136,0
"14772","기묘한 가족","2019-02-11","3",746,13882,0
"14773","기묘한 가족","2019-02-12","10",740,14622,0
"14774","기묘한 가족","2019-02-13","625",42736,57358,1
"14775","기묘한 가족","2019-02-14","605",36571,93929,2
"14776","기묘한 가족","2019-02-15","585",29956,123885,3
"14777","기묘한 가족","2019-02-16","610",49596,173481,4
"14778","기묘한 가족","2019-02-17","601",42773,216254,5
"14779","기묘한 가족","2019-02-18","565",14066,230320,6
"14780","기묘한 가족","2019-02-19","580",15585,245905,7
"14781","기묘한 가족","2019-02-20","237",3484,249389,8
"14782","기묘한 가족","2019-02-21","206",2330,251719,9
"14783","기묘한 가족","2019-02-22","203",1933,253652,10
"14784","기묘한 가족","2019-02-23","173",2887,256539,11
"14785","기묘한 가족","2019-02-24","176",2455,258994,12
"14786","기묘한 가족","2019-02-25","151",1132,260126,13
"14787","기묘한 가족","2019-02-26","162",1679,261805,14
"14788","기묘한 가족","2019-02-27","17",713,262518,15
"14789","기묘한 가족","2019-02-28","12",83,262601,16
"14790","기묘한 가족","2019-03-01","8",126,262727,17
"14791","기묘한 가족","2019-03-02","9",98,262825,18
"14792","기묘한 가족","2019-03-03","9",95,262920,19
"14793","기묘한 가족","2019-03-04","4",28,262948,20
"14794","기묘한 가족","2019-03-05","6",47,262995,21
"14795","기묘한 가족","2019-03-21","1",327,263322,22
"14869","언니","2018-12-14","1",186,186,0
"14870","언니","2018-12-20","2",294,480,0
"14871","언니","2018-12-27","3",763,1243,0
"14872","언니","2019-01-01","509",66686,67929,1
"14873","언니","2019-01-02","529",24845,92774,2
"14874","언니","2019-01-03","530",17227,110001,3
"14875","언니","2019-01-04","510",17202,127203,4
"14876","언니","2019-01-05","506",24906,152109,5
"14877","언니","2019-01-06","498",20229,172338,6
"14878","언니","2019-01-07","508",10145,182483,7
"14879","언니","2019-01-08","507",9043,191526,8
"14880","언니","2019-01-09","146",1416,192942,9
"14881","언니","2019-01-10","108",939,193881,10
"14882","언니","2019-01-11","94",967,194848,11
"14883","언니","2019-01-12","83",1277,196125,12
"14884","언니","2019-01-13","81",1086,197211,13
"14885","언니","2019-01-14","72",475,197686,14
"14886","언니","2019-01-15","66",434,198120,15
"14887","언니","2019-01-16","14",45,198165,16
"14888","언니","2019-01-17","6",6,198171,17
"14889","언니","2019-01-18","8",17,198188,18
"14890","언니","2019-01-19","8",20,198208,19
"14891","언니","2019-01-20","7",21,198229,20
"14892","언니","2019-01-21","6",12,198241,21
"14893","언니","2019-01-22","6",10,198251,22
"14894","언니","2019-01-23","5",5,198256,23
"14895","언니","2019-01-24","5",5,198261,24
"14896","언니","2019-01-25","5",5,198266,25
"14897","언니","2019-01-26","5",5,198271,26
"14898","언니","2019-01-27","5",5,198276,27
"14899","언니","2019-01-28","5",5,198281,28
"14900","언니","2019-02-01","1",78,198359,29
"14901","언니","2019-02-02","1",18,198377,30
"14902","언더독","2018-10-12","1",153,153,0
"14903","언더독","2018-12-27","1",151,304,0
"14904","언더독","2018-12-28","1",78,382,0
"14905","언더독","2019-01-02","2",231,613,0
"14906","언더독","2019-01-03","6",1236,1849,0
"14907","언더독","2019-01-04","3",486,2335,0
"14908","언더독","2019-01-07","14",2892,5227,0
"14909","언더독","2019-01-08","23",4412,9639,0
"14910","언더독","2019-01-09","7",1897,11536,0
"14911","언더독","2019-01-10","1",255,11791,0
"14912","언더독","2019-01-14","14",3390,15181,0
"14913","언더독","2019-01-15","12",4417,19598,0
"14914","언더독","2019-01-16","612",18781,38379,1
"14915","언더독","2019-01-17","580",13756,52135,2
"14916","언더독","2019-01-18","571",13236,65371,3
"14917","언더독","2019-01-19","608",30172,95543,4
"14918","언더독","2019-01-20","596",27030,122573,5
"14919","언더독","2019-01-21","526",8256,130829,6
"14920","언더독","2019-01-22","541",10965,141794,7
"14921","언더독","2019-01-23","297",5196,146990,8
"14922","언더독","2019-01-24","287",5657,152647,9
"14923","언더독","2019-01-25","286",5597,158244,10
"14924","언더독","2019-01-26","293",9406,167650,11
"14925","언더독","2019-01-27","292",9187,176837,12
"14926","언더독","2019-01-28","229",2375,179212,13
"14927","언더독","2019-01-29","225",2959,182171,14
"14928","언더독","2019-01-30","30",1259,183430,15
"14929","언더독","2019-01-31","18",515,183945,16
"14930","언더독","2019-02-01","13",443,184388,17
"14931","언더독","2019-02-02","18",584,184972,18
"14932","언더독","2019-02-03","16",526,185498,19
"14933","언더독","2019-02-04","11",393,185891,20
"14934","언더독","2019-02-05","6",190,186081,21
"14935","언더독","2019-02-06","5",248,186329,22
"14936","언더독","2019-02-07","6",200,186529,23
"14937","언더독","2019-02-08","10",272,186801,24
"14938","언더독","2019-02-09","7",466,187267,25
"14939","언더독","2019-02-10","6",179,187446,26
"14940","언더독","2019-02-11","4",132,187578,27
"14941","언더독","2019-02-12","5",106,187684,28
"14942","언더독","2019-02-13","4",112,187796,29
"14943","언더독","2019-02-14","4",79,187875,30
"14944","언더독","2019-02-15","3",86,187961,31
"14945","언더독","2019-02-16","4",82,188043,32
"14946","언더독","2019-02-17","5",70,188113,33
"14947","언더독","2019-02-18","4",60,188173,34
"14948","언더독","2019-02-19","5",197,188370,35
"14949","언더독","2019-02-20","3",38,188408,36
"14950","언더독","2019-02-21","2",33,188441,37
"14951","언더독","2019-02-22","3",19,188460,38
"14952","언더독","2019-02-23","3",209,188669,39
"14953","언더독","2019-02-24","5",223,188892,40
"14954","언더독","2019-02-25","3",22,188914,41
"14955","언더독","2019-02-26","15",312,189226,42
"14956","언더독","2019-02-27","9",249,189475,43
"14957","언더독","2019-02-28","4",11,189486,44
"14958","언더독","2019-03-01","4",45,189531,45
"14959","언더독","2019-03-02","4",50,189581,46
"14960","언더독","2019-03-03","6",24,189605,47
"14961","언더독","2019-03-04","3",4,189609,48
"14962","언더독","2019-03-05","4",9,189618,49
"14963","언더독","2019-03-06","5",11,189629,50
"14964","언더독","2019-03-07","4",6,189635,51
"14965","언더독","2019-03-08","3",7,189642,52
"14966","언더독","2019-03-09","5",309,189951,53
"14967","언더독","2019-03-10","4",8,189959,54
"14968","언더독","2019-03-11","4",4,189963,55
"14969","언더독","2019-03-12","1",2,189965,56
"14970","언더독","2019-03-13","2",158,190123,57
"14971","언더독","2019-03-14","1",5,190128,58
"14972","언더독","2019-03-15","2",3,190131,59
"14973","언더독","2019-03-16","3",345,190476,60
"14974","언더독","2019-03-17","1",9,190485,61
"14975","언더독","2019-03-19","1",1,190486,62
"14976","언더독","2019-03-20","2",325,190811,63
"14977","언더독","2019-03-21","1",9,190820,64
"14978","언더독","2019-03-22","1",175,190995,65
"14979","언더독","2019-03-23","2",23,191018,66
"15041","자전차왕 엄복동","2019-02-08","1",240,240,0
"15042","자전차왕 엄복동","2019-02-19","3",1111,1351,0
"15043","자전차왕 엄복동","2019-02-24","2",568,1919,0
"15044","자전차왕 엄복동","2019-02-25","18",3145,5064,0
"15045","자전차왕 엄복동","2019-02-26","9",2652,7716,0
"15046","자전차왕 엄복동","2019-02-27","624",43408,51124,1
"15047","자전차왕 엄복동","2019-02-28","585",22126,73250,2
"15048","자전차왕 엄복동","2019-03-01","587",35351,108601,3
"15049","자전차왕 엄복동","2019-03-02","566",24982,133583,4
"15050","자전차왕 엄복동","2019-03-03","567",20748,154331,5
"15051","자전차왕 엄복동","2019-03-04","484",5959,160290,6
"15052","자전차왕 엄복동","2019-03-05","466",5243,165533,7
"15053","자전차왕 엄복동","2019-03-06","76",814,166347,8
"15054","자전차왕 엄복동","2019-03-07","59",601,166948,9
"15055","자전차왕 엄복동","2019-03-08","68",531,167479,10
"15056","자전차왕 엄복동","2019-03-09","50",732,168211,11
"15057","자전차왕 엄복동","2019-03-10","59",674,168885,12
"15058","자전차왕 엄복동","2019-03-11","42",595,169480,13
"15059","자전차왕 엄복동","2019-03-12","38",205,169685,14
"15060","자전차왕 엄복동","2019-03-13","42",282,169967,15
"15061","자전차왕 엄복동","2019-03-14","9",119,170086,16
"15062","자전차왕 엄복동","2019-03-15","8",75,170161,17
"15063","자전차왕 엄복동","2019-03-16","6",68,170229,18
"15064","자전차왕 엄복동","2019-03-17","5",57,170286,19
"15065","자전차왕 엄복동","2019-03-18","5",32,170318,20
"15066","자전차왕 엄복동","2019-03-19","6",75,170393,21
"15067","자전차왕 엄복동","2019-03-20","2",9,170402,22
"15068","자전차왕 엄복동","2019-03-21","8",1801,172203,23
"15069","자전차왕 엄복동","2019-03-22","2",2,172205,24
"15070","자전차왕 엄복동","2019-03-23","1",1,172206,25
"15071","악질경찰","2019-03-13","3",1261,1261,0
"15072","악질경찰","2019-03-18","5",1822,3083,0
"15073","악질경찰","2019-03-20","833",33072,36155,1
"15074","악질경찰","2019-03-21","807",29275,65430,2
"15075","악질경찰","2019-03-22","772",27478,92908,3
"15076","악질경찰","2019-03-23","731",50107,143015,4
"15077","우상","2019-03-04","1",142,142,0
"15078","우상","2019-03-06","1",130,272,0
"15079","우상","2019-03-07","3",867,1139,0
"15080","우상","2019-03-08","1",165,1304,0
"15081","우상","2019-03-11","11",2152,3456,0
"15082","우상","2019-03-12","17",1472,4928,0
"15083","우상","2019-03-14","2",410,5338,0
"15084","우상","2019-03-15","3",736,6074,0
"15085","우상","2019-03-19","28",3432,9506,0
"15086","우상","2019-03-20","900",27175,36681,1
"15087","우상","2019-03-21","849",20549,57230,2
"15088","우상","2019-03-22","797",19826,77056,3
"15089","우상","2019-03-23","675",32698,109754,4
"15090","그대 이름은 장미","2018-12-28","4",1184,1184,0
"15091","그대 이름은 장미","2019-01-02","1",100,1284,0
"15092","그대 이름은 장미","2019-01-03","15",3346,4630,0
"15093","그대 이름은 장미","2019-01-07","5",500,5130,0
"15094","그대 이름은 장미","2019-01-08","10",1641,6771,0
"15095","그대 이름은 장미","2019-01-09","3",338,7109,0
"15096","그대 이름은 장미","2019-01-10","5",1703,8812,0
"15097","그대 이름은 장미","2019-01-11","11",2072,10884,0
"15098","그대 이름은 장미","2019-01-14","21",795,11679,0
"15099","그대 이름은 장미","2019-01-15","14",3101,14780,0
"15100","그대 이름은 장미","2019-01-16","540",14163,28943,1
"15101","그대 이름은 장미","2019-01-17","506",9636,38579,2
"15102","그대 이름은 장미","2019-01-18","498",9194,47773,3
"15103","그대 이름은 장미","2019-01-19","492",12836,60609,4
"15104","그대 이름은 장미","2019-01-20","475",11169,71778,5
"15105","그대 이름은 장미","2019-01-21","447",5300,77078,6
"15106","그대 이름은 장미","2019-01-22","440",5620,82698,7
"15107","그대 이름은 장미","2019-01-23","74",525,83223,8
"15108","그대 이름은 장미","2019-01-24","65",408,83631,9
"15109","그대 이름은 장미","2019-01-25","59",456,84087,10
"15110","그대 이름은 장미","2019-01-26","40",343,84430,11
"15111","그대 이름은 장미","2019-01-27","44",388,84818,12
"15112","그대 이름은 장미","2019-01-28","34",200,85018,13
"15113","그대 이름은 장미","2019-01-29","45",264,85282,14
"15114","그대 이름은 장미","2019-01-30","6",162,85444,15
"15115","그대 이름은 장미","2019-01-31","19",99,85543,16
"15116","그대 이름은 장미","2019-02-01","4",6,85549,17
"15117","그대 이름은 장미","2019-02-02","4",10,85559,18
"15118","그대 이름은 장미","2019-02-03","4",11,85570,19
"15119","그대 이름은 장미","2019-02-04","4",42,85612,20
"15120","그대 이름은 장미","2019-02-05","4",34,85646,21
"15121","그대 이름은 장미","2019-02-06","4",12,85658,22
"15122","그대 이름은 장미","2019-02-07","3",3,85661,23
"15123","그대 이름은 장미","2019-02-08","4",153,85814,24
"15124","그대 이름은 장미","2019-02-09","3",3,85817,25
"15125","그대 이름은 장미","2019-02-10","3",3,85820,26
"15126","그대 이름은 장미","2019-02-11","3",3,85823,27
"15127","그대 이름은 장미","2019-02-12","4",4,85827,28
"15128","그대 이름은 장미","2019-02-13","3",3,85830,29
"15129","그대 이름은 장미","2019-02-14","1",184,86014,30
"15130","그대 이름은 장미","2019-02-20","2",298,86312,31
"15131","그대 이름은 장미","2019-02-24","2",526,86838,32
"15132","그대 이름은 장미","2019-03-16","2",343,87181,33
"15133","어쩌다, 결혼","2019-02-18","1",1023,1023,0
"15134","어쩌다, 결혼","2019-02-27","529",22216,23239,1
"15135","어쩌다, 결혼","2019-02-28","499",13602,36841,2
"15136","어쩌다, 결혼","2019-03-01","482",14964,51805,3
"15137","어쩌다, 결혼","2019-03-02","463",11680,63485,4
"15138","어쩌다, 결혼","2019-03-03","421",7342,70827,5
"15139","어쩌다, 결혼","2019-03-04","352",2396,73223,6
"15140","어쩌다, 결혼","2019-03-05","366",2380,75603,7
"15141","어쩌다, 결혼","2019-03-06","39",155,75758,8
"15142","어쩌다, 결혼","2019-03-07","29",125,75883,9
"15143","어쩌다, 결혼","2019-03-08","27",122,76005,10
"15144","어쩌다, 결혼","2019-03-09","30",208,76213,11
"15145","어쩌다, 결혼","2019-03-10","32",173,76386,12
"15146","어쩌다, 결혼","2019-03-11","26",125,76511,13
"15147","어쩌다, 결혼","2019-03-12","24",76,76587,14
"15148","어쩌다, 결혼","2019-03-13","21",56,76643,15
"15149","어쩌다, 결혼","2019-03-14","2",4,76647,16
"15150","어쩌다, 결혼","2019-03-15","4",40,76687,17
"15151","어쩌다, 결혼","2019-03-16","4",21,76708,18
"15152","어쩌다, 결혼","2019-03-17","4",17,76725,19
"15153","어쩌다, 결혼","2019-03-18","1",1,76726,20
"15154","어쩌다, 결혼","2019-03-20","1",10,76736,21
"15155","어쩌다, 결혼","2019-03-21","1",10,76746,22
"15203","칠곡 가시나들","2018-12-22","1",93,93,0
"15204","칠곡 가시나들","2019-01-10","1",126,219,0
"15205","칠곡 가시나들","2019-01-18","1",247,466,0
"15206","칠곡 가시나들","2019-01-24","3",218,684,0
"15207","칠곡 가시나들","2019-01-25","1",46,730,0
"15208","칠곡 가시나들","2019-01-31","1",189,919,0
"15209","칠곡 가시나들","2019-02-01","1",13,932,0
"15210","칠곡 가시나들","2019-02-02","4",39,971,0
"15211","칠곡 가시나들","2019-02-03","2",32,1003,0
"15212","칠곡 가시나들","2019-02-04","3",54,1057,0
"15213","칠곡 가시나들","2019-02-05","2",41,1098,0
"15214","칠곡 가시나들","2019-02-06","3",28,1126,0
"15215","칠곡 가시나들","2019-02-07","1",39,1165,0
"15216","칠곡 가시나들","2019-02-08","1",47,1212,0
"15217","칠곡 가시나들","2019-02-09","1",47,1259,0
"15218","칠곡 가시나들","2019-02-12","1",154,1413,0
"15219","칠곡 가시나들","2019-02-14","1",114,1527,0
"15220","칠곡 가시나들","2019-02-19","1",290,1817,0
"15221","칠곡 가시나들","2019-02-20","9",1485,3302,0
"15222","칠곡 가시나들","2019-02-21","3",632,3934,0
"15223","칠곡 가시나들","2019-02-22","7",1640,5574,0
"15224","칠곡 가시나들","2019-02-27","118",3558,9132,1
"15225","칠곡 가시나들","2019-02-28","119",3670,12802,2
"15226","칠곡 가시나들","2019-03-01","131",3320,16122,3
"15227","칠곡 가시나들","2019-03-02","138",4079,20201,4
"15228","칠곡 가시나들","2019-03-03","133",3053,23254,5
"15229","칠곡 가시나들","2019-03-04","128",2153,25407,6
"15230","칠곡 가시나들","2019-03-05","129",2073,27480,7
"15231","칠곡 가시나들","2019-03-06","112",1103,28583,8
"15232","칠곡 가시나들","2019-03-07","128",1523,30106,9
"15233","칠곡 가시나들","2019-03-08","131",1366,31472,10
"15234","칠곡 가시나들","2019-03-09","119",1512,32984,11
"15235","칠곡 가시나들","2019-03-10","113",1162,34146,12
"15236","칠곡 가시나들","2019-03-11","99",671,34817,13
"15237","칠곡 가시나들","2019-03-12","103",662,35479,14
"15238","칠곡 가시나들","2019-03-13","80",556,36035,15
"15239","칠곡 가시나들","2019-03-14","19",158,36193,16
"15240","칠곡 가시나들","2019-03-15","23",411,36604,17
"15241","칠곡 가시나들","2019-03-16","26",376,36980,18
"15242","칠곡 가시나들","2019-03-17","21",253,37233,19
"15243","칠곡 가시나들","2019-03-18","19",371,37604,20
"15244","칠곡 가시나들","2019-03-19","18",290,37894,21
"15245","칠곡 가시나들","2019-03-20","14",225,38119,22
"15246","칠곡 가시나들","2019-03-21","16",243,38362,23
"15247","칠곡 가시나들","2019-03-22","12",311,38673,24
"15248","칠곡 가시나들","2019-03-23","13",111,38784,25
"15249","1919 유관순","2019-03-08","1",195,195,0
"15250","1919 유관순","2019-03-11","7",1465,1660,0
"15251","1919 유관순","2019-03-12","5",765,2425,0
"15252","1919 유관순","2019-03-13","5",503,2928,0
"15253","1919 유관순","2019-03-14","269",3017,5945,1
"15254","1919 유관순","2019-03-15","254",2590,8535,2
"15255","1919 유관순","2019-03-16","243",4093,12628,3
"15256","1919 유관순","2019-03-17","238",3892,16520,4
"15257","1919 유관순","2019-03-18","196",1832,18352,5
"15258","1919 유관순","2019-03-19","218",2197,20549,6
"15259","1919 유관순","2019-03-20","122",2147,22696,7
"15260","1919 유관순","2019-03-21","35",243,22939,8
"15261","1919 유관순","2019-03-22","35",228,23167,9
"15262","1919 유관순","2019-03-23","40",558,23725,10
"15263","시인 할매","2018-11-14","1",140,140,0
"15264","시인 할매","2019-01-29","4",713,853,0
"15265","시인 할매","2019-01-30","3",547,1400,0
"15266","시인 할매","2019-01-31","12",1744,3144,0
"15267","시인 할매","2019-02-01","1",306,3450,0
"15268","시인 할매","2019-02-05","13",167,3617,1
"15269","시인 할매","2019-02-06","13",220,3837,2
"15270","시인 할매","2019-02-07","102",547,4384,3
"15271","시인 할매","2019-02-08","95",472,4856,4
"15272","시인 할매","2019-02-09","80",541,5397,5
"15273","시인 할매","2019-02-10","76",462,5859,6
"15274","시인 할매","2019-02-11","76",291,6150,7
"15275","시인 할매","2019-02-12","86",849,6999,8
"15276","시인 할매","2019-02-13","40",349,7348,9
"15277","시인 할매","2019-02-14","16",125,7473,10
"15278","시인 할매","2019-02-15","14",129,7602,11
"15279","시인 할매","2019-02-16","13",144,7746,12
"15280","시인 할매","2019-02-17","13",102,7848,13
"15281","시인 할매","2019-02-18","13",119,7967,14
"15282","시인 할매","2019-02-19","17",131,8098,15
"15283","시인 할매","2019-02-20","9",55,8153,16
"15284","시인 할매","2019-02-21","9",43,8196,17
"15285","시인 할매","2019-02-22","7",86,8282,18
"15286","시인 할매","2019-02-23","7",51,8333,19
"15287","시인 할매","2019-02-24","5",16,8349,20
"15288","시인 할매","2019-02-25","6",26,8375,21
"15289","시인 할매","2019-02-26","4",10,8385,22
"15290","시인 할매","2019-02-27","5",33,8418,23
"15291","시인 할매","2019-02-28","5",44,8462,24
"15292","시인 할매","2019-03-01","3",12,8474,25
"15293","시인 할매","2019-03-02","3",18,8492,26
"15294","시인 할매","2019-03-03","3",7,8499,27
"15295","시인 할매","2019-03-04","2",3,8502,28
"15296","시인 할매","2019-03-05","5",23,8525,29
"15297","시인 할매","2019-03-06","3",9,8534,30
"15298","시인 할매","2019-03-07","1",1,8535,31
"15299","시인 할매","2019-03-08","2",5,8540,32
"15300","시인 할매","2019-03-09","2",21,8561,33
"15301","시인 할매","2019-03-10","3",10,8571,34
"15302","시인 할매","2019-03-11","1",1,8572,35
"15303","시인 할매","2019-03-12","1",3,8575,36
"15304","시인 할매","2019-03-13","1",3,8578,37
"15305","시인 할매","2019-03-14","1",1,8579,38
"15306","시인 할매","2019-03-15","1",0,8579,39
"15307","시인 할매","2019-03-16","2",7,8586,40
"15308","시인 할매","2019-03-17","1",10,8596,41
"15309","시인 할매","2019-03-18","1",1,8597,42
"15310","시인 할매","2019-03-22","1",15,8612,43
"15383","생일","2019-01-16","1",262,262,0
"15384","생일","2019-03-06","1",344,606,0
"15385","생일","2019-03-13","1",166,772,0
"15386","생일","2019-03-15","1",247,1019,0
"15387","생일","2019-03-18","12",2843,3862,0
"15388","생일","2019-03-19","2",541,4403,0
"15389","생일","2019-03-20","1",290,4693,0
"15390","생일","2019-03-21","9",1853,6546,0
"15391","질투의 역사","2019-03-08","4",861,861,0
"15392","질투의 역사","2019-03-14","83",766,1627,1
"15393","질투의 역사","2019-03-15","81",650,2277,2
"15394","질투의 역사","2019-03-16","71",277,2554,3
"15395","질투의 역사","2019-03-17","71",275,2829,4
"15396","질투의 역사","2019-03-18","57",164,2993,5
"15397","질투의 역사","2019-03-19","61",329,3322,6
"15398","질투의 역사","2019-03-20","21",48,3370,7
"15399","질투의 역사","2019-03-23","1",2,3372,8
"15400","산상수훈","2017-10-26","1",112,112,0
"15401","산상수훈","2017-10-28","1",123,235,0
"15402","산상수훈","2017-11-21","1",166,401,0
"15403","산상수훈","2017-11-23","1",156,557,0
"15404","산상수훈","2017-11-24","1",284,841,0
"15405","산상수훈","2017-11-29","1",188,1029,0
"15406","산상수훈","2017-12-04","3",1079,2108,0
"15407","산상수훈","2017-12-07","71",3082,5190,1
"15408","산상수훈","2017-12-08","64",3039,8229,2
"15409","산상수훈","2017-12-09","66",2578,10807,3
"15410","산상수훈","2017-12-10","62",2635,13442,4
"15411","산상수훈","2017-12-11","60",5385,18827,5
"15412","산상수훈","2017-12-12","48",556,19383,6
"15413","산상수훈","2017-12-13","54",1212,20595,7
"15414","산상수훈","2017-12-14","24",387,20982,8
"15415","산상수훈","2017-12-15","26",810,21792,9
"15416","산상수훈","2017-12-16","27",962,22754,10
"15417","산상수훈","2017-12-17","22",644,23398,11
"15418","산상수훈","2017-12-18","23",406,23804,12
"15419","산상수훈","2017-12-19","22",499,24303,13
"15420","산상수훈","2017-12-20","17",523,24826,14
"15421","산상수훈","2017-12-21","10",119,24945,15
"15422","산상수훈","2017-12-22","12",136,25081,16
"15423","산상수훈","2017-12-23","10",75,25156,17
"15424","산상수훈","2017-12-24","9",128,25284,18
"15425","산상수훈","2017-12-25","8",170,25454,19
"15426","산상수훈","2017-12-26","12",108,25562,20
"15427","산상수훈","2017-12-27","3",26,25588,21
"15428","산상수훈","2017-12-28","19",3498,29086,22
"15429","산상수훈","2017-12-29","42",6377,35463,23
"15430","산상수훈","2017-12-30","15",1850,37313,24
"15431","산상수훈","2017-12-31","19",2760,40073,25
"15432","산상수훈","2018-01-01","1",24,40097,26
"15433","산상수훈","2018-01-02","2",12,40109,27
"15434","산상수훈","2018-01-03","2",21,40130,28
"15435","산상수훈","2018-01-04","2",53,40183,29
"15436","산상수훈","2018-01-05","2",301,40484,30
"15437","산상수훈","2018-01-06","3",422,40906,31
"15438","산상수훈","2018-01-07","4",362,41268,32
"15439","산상수훈","2018-01-09","2",46,41314,33
"15440","산상수훈","2018-01-10","1",10,41324,34
"15441","산상수훈","2018-01-11","2",41,41365,35
"15442","산상수훈","2018-01-12","3",132,41497,36
"15443","산상수훈","2018-01-13","1",10,41507,37
"15444","산상수훈","2018-01-14","3",37,41544,38
"15445","산상수훈","2018-01-15","1",1,41545,39
"15446","산상수훈","2018-01-16","3",70,41615,40
"15447","산상수훈","2018-01-17","1",23,41638,41
"15448","산상수훈","2018-01-18","1",30,41668,42
"15449","산상수훈","2018-01-19","1",24,41692,43
"15450","산상수훈","2018-01-20","4",154,41846,44
"15451","산상수훈","2018-01-21","5",143,41989,45
"15452","산상수훈","2018-01-23","1",27,42016,46
"15453","산상수훈","2018-01-26","2",42,42058,47
"15454","산상수훈","2018-01-27","2",37,42095,48
"15455","산상수훈","2018-01-28","2",62,42157,49
"15456","산상수훈","2018-01-30","3",93,42250,50
"15457","산상수훈","2018-02-01","1",7,42257,51
"15458","산상수훈","2018-02-02","1",20,42277,52
"15459","산상수훈","2018-02-03","2",35,42312,53
"15460","산상수훈","2018-02-04","1",30,42342,54
"15461","산상수훈","2018-02-06","2",45,42387,55
"15462","산상수훈","2018-02-08","1",14,42401,56
"15463","산상수훈","2018-02-09","1",20,42421,57
"15464","산상수훈","2018-02-10","2",16,42437,58
"15465","산상수훈","2018-02-11","1",19,42456,59
"15466","산상수훈","2018-02-12","1",11,42467,60
"15467","산상수훈","2018-02-13","1",21,42488,61
"15468","산상수훈","2018-02-16","1",5,42493,62
"15469","산상수훈","2018-02-17","1",30,42523,63
"15470","산상수훈","2018-02-18","2",30,42553,64
"15471","산상수훈","2018-02-20","2",37,42590,65
"15472","산상수훈","2018-02-23","1",35,42625,66
"15473","산상수훈","2018-02-24","2",21,42646,67
"15474","산상수훈","2018-02-25","1",15,42661,68
"15475","산상수훈","2018-02-27","1",6,42667,69
"15476","산상수훈","2018-03-01","1",7,42674,70
"15477","산상수훈","2018-03-03","1",17,42691,71
"15478","산상수훈","2018-03-04","1",18,42709,72
"15479","산상수훈","2018-03-10","1",21,42730,73
"15480","산상수훈","2018-03-11","1",22,42752,74
"15481","산상수훈","2018-03-12","1",28,42780,75
"15482","산상수훈","2018-03-15","1",21,42801,76
"15483","산상수훈","2018-03-17","1",27,42828,77
"15484","산상수훈","2018-03-18","1",20,42848,78
"15485","산상수훈","2018-03-19","1",25,42873,79
"15486","산상수훈","2018-03-22","1",18,42891,80
"15487","산상수훈","2018-03-24","1",22,42913,81
"15488","산상수훈","2018-03-25","1",21,42934,82
"15489","산상수훈","2018-03-26","1",28,42962,83
"15490","산상수훈","2018-04-01","1",20,42982,84
"15491","산상수훈","2018-04-02","1",29,43011,85
"15492","산상수훈","2018-04-04","1",6,43017,86
"15493","산상수훈","2018-04-07","1",19,43036,87
"15494","산상수훈","2018-04-08","1",18,43054,88
"15495","산상수훈","2018-04-09","1",26,43080,89
"15496","산상수훈","2018-04-14","1",19,43099,90
"15497","산상수훈","2018-04-15","1",18,43117,91
"15498","산상수훈","2018-04-16","1",3,43120,92
"15499","산상수훈","2018-04-18","1",24,43144,93
"15500","산상수훈","2018-04-19","1",39,43183,94
"15501","산상수훈","2018-04-21","1",16,43199,95
"15502","산상수훈","2018-04-22","1",5,43204,96
"15503","산상수훈","2018-04-23","1",49,43253,97
"15504","산상수훈","2018-04-25","1",23,43276,98
"15505","산상수훈","2018-04-26","1",37,43313,99
"15506","산상수훈","2018-05-02","1",27,43340,100
"15507","산상수훈","2018-05-03","1",31,43371,101
"15508","산상수훈","2018-05-09","1",27,43398,102
"15509","산상수훈","2018-05-10","1",35,43433,103
"15510","산상수훈","2018-05-12","1",37,43470,104
"15511","산상수훈","2018-05-13","1",35,43505,105
"15512","산상수훈","2018-05-16","1",26,43531,106
"15513","산상수훈","2018-05-17","1",36,43567,107
"15514","산상수훈","2018-05-19","1",39,43606,108
"15515","산상수훈","2018-05-20","1",42,43648,109
"15516","산상수훈","2018-05-23","1",27,43675,110
"15517","산상수훈","2018-05-24","1",34,43709,111
"15518","산상수훈","2018-05-26","1",37,43746,112
"15519","산상수훈","2018-05-27","1",38,43784,113
"15520","산상수훈","2018-05-30","1",24,43808,114
"15521","산상수훈","2018-05-31","1",34,43842,115
"15522","산상수훈","2018-06-01","1",60,43902,116
"15523","산상수훈","2018-06-02","1",48,43950,117
"15524","산상수훈","2018-06-03","1",22,43972,118
"15525","산상수훈","2018-06-06","1",28,44000,119
"15526","산상수훈","2018-06-08","1",58,44058,120
"15527","산상수훈","2018-06-09","1",46,44104,121
"15528","산상수훈","2018-06-10","1",21,44125,122
"15529","산상수훈","2018-06-13","1",25,44150,123
"15530","산상수훈","2018-06-14","1",26,44176,124
"15531","산상수훈","2018-06-15","1",58,44234,125
"15532","산상수훈","2018-06-16","1",45,44279,126
"15533","산상수훈","2018-06-17","1",20,44299,127
"15534","산상수훈","2018-06-20","1",24,44323,128
"15535","산상수훈","2018-06-21","1",22,44345,129
"15536","산상수훈","2018-06-22","1",52,44397,130
"15537","산상수훈","2018-06-23","1",57,44454,131
"15538","산상수훈","2018-06-24","1",26,44480,132
"15539","산상수훈","2018-06-27","1",24,44504,133
"15540","산상수훈","2018-06-28","1",20,44524,134
"15541","산상수훈","2018-06-29","1",64,44588,135
"15542","산상수훈","2018-06-30","1",49,44637,136
"15543","산상수훈","2018-07-01","1",22,44659,137
"15544","산상수훈","2018-07-04","1",24,44683,138
"15545","산상수훈","2018-07-05","1",23,44706,139
"15546","산상수훈","2018-07-07","1",51,44757,140
"15547","산상수훈","2018-07-08","1",24,44781,141
"15548","산상수훈","2018-07-11","1",28,44809,142
"15549","산상수훈","2018-07-12","1",21,44830,143
"15550","산상수훈","2018-07-14","1",50,44880,144
"15551","산상수훈","2018-07-15","1",25,44905,145
"15552","산상수훈","2018-07-18","1",32,44937,146
"15553","산상수훈","2018-07-19","1",25,44962,147
"15554","산상수훈","2018-07-21","1",58,45020,148
"15555","산상수훈","2018-07-22","1",29,45049,149
"15556","산상수훈","2018-07-25","1",30,45079,150
"15557","산상수훈","2018-07-26","1",34,45113,151
"15558","산상수훈","2018-07-28","1",57,45170,152
"15559","산상수훈","2018-07-29","1",30,45200,153
"15560","산상수훈","2018-08-01","1",24,45224,154
"15561","산상수훈","2018-08-02","1",36,45260,155
"15562","산상수훈","2018-08-04","1",55,45315,156
"15563","산상수훈","2018-08-05","1",29,45344,157
"15564","산상수훈","2018-08-08","1",24,45368,158
"15565","산상수훈","2018-08-09","1",39,45407,159
"15566","산상수훈","2018-08-11","1",75,45482,160
"15567","산상수훈","2018-08-12","1",30,45512,161
"15568","산상수훈","2018-08-15","1",44,45556,162
"15569","산상수훈","2018-08-16","1",46,45602,163
"15570","산상수훈","2018-08-18","1",54,45656,164
"15571","산상수훈","2018-08-19","1",22,45678,165
"15572","산상수훈","2018-08-22","1",24,45702,166
"15573","산상수훈","2018-08-23","1",21,45723,167
"15574","산상수훈","2018-08-25","1",58,45781,168
"15575","산상수훈","2018-08-26","1",21,45802,169
"15576","산상수훈","2018-08-29","1",30,45832,170
"15577","산상수훈","2018-08-30","1",20,45852,171
"15578","산상수훈","2018-09-01","1",46,45898,172
"15579","산상수훈","2018-09-02","1",20,45918,173
"15580","산상수훈","2018-09-05","2",108,46026,174
"15581","산상수훈","2018-09-06","1",23,46049,175
"15582","산상수훈","2018-09-08","1",45,46094,176
"15583","산상수훈","2018-09-09","1",21,46115,177
"15584","산상수훈","2018-09-12","1",24,46139,178
"15585","산상수훈","2018-09-13","1",24,46163,179
"15586","산상수훈","2018-09-14","2",201,46364,180
"15587","산상수훈","2018-09-15","1",48,46412,181
"15588","산상수훈","2018-09-16","1",22,46434,182
"15589","산상수훈","2018-09-19","1",24,46458,183
"15590","산상수훈","2018-09-20","1",20,46478,184
"15591","산상수훈","2018-09-22","1",46,46524,185
"15592","산상수훈","2018-09-23","1",21,46545,186
"15593","산상수훈","2018-09-26","1",41,46586,187
"15594","산상수훈","2018-09-27","1",22,46608,188
"15595","산상수훈","2018-09-29","1",43,46651,189
"15596","산상수훈","2018-09-30","1",22,46673,190
"15597","산상수훈","2018-10-03","1",41,46714,191
"15598","산상수훈","2018-10-04","1",21,46735,192
"15599","산상수훈","2018-10-06","1",40,46775,193
"15600","산상수훈","2018-10-07","1",20,46795,194
"15601","산상수훈","2018-10-10","1",24,46819,195
"15602","산상수훈","2018-10-11","1",20,46839,196
"15603","산상수훈","2018-10-13","1",40,46879,197
"15604","산상수훈","2018-10-14","1",21,46900,198
"15605","산상수훈","2018-10-17","1",24,46924,199
"15606","산상수훈","2018-10-18","1",20,46944,200
"15607","산상수훈","2018-10-20","1",40,46984,201
"15608","산상수훈","2018-10-21","1",23,47007,202
"15609","산상수훈","2018-10-24","1",24,47031,203
"15610","산상수훈","2018-10-25","1",22,47053,204
"15611","산상수훈","2018-10-27","1",39,47092,205
"15612","산상수훈","2018-10-28","1",21,47113,206
"15613","산상수훈","2018-10-31","1",26,47139,207
"15614","산상수훈","2018-11-01","1",25,47164,208
"15615","산상수훈","2018-11-03","1",40,47204,209
"15616","산상수훈","2018-11-04","1",21,47225,210
"15617","산상수훈","2018-11-07","1",24,47249,211
"15618","산상수훈","2018-11-08","1",20,47269,212
"15619","산상수훈","2018-11-10","1",40,47309,213
"15620","산상수훈","2018-11-11","1",18,47327,214
"15621","산상수훈","2018-11-14","1",29,47356,215
"15622","산상수훈","2018-11-15","1",21,47377,216
"15623","산상수훈","2018-11-17","1",40,47417,217
"15624","산상수훈","2018-11-18","1",30,47447,218
"15625","산상수훈","2018-11-21","1",24,47471,219
"15626","산상수훈","2018-11-24","2",116,47587,220
"15627","산상수훈","2018-11-25","1",30,47617,221
"15628","산상수훈","2018-12-01","3",136,47753,222
"15629","산상수훈","2018-12-02","1",30,47783,223
"15630","산상수훈","2018-12-08","3",139,47922,224
"15631","산상수훈","2018-12-09","1",29,47951,225
"15632","산상수훈","2018-12-14","1",80,48031,226
"15633","산상수훈","2018-12-15","3",136,48167,227
"15634","산상수훈","2018-12-16","1",30,48197,228
"15635","산상수훈","2018-12-18","2",303,48500,229
"15636","산상수훈","2018-12-22","3",147,48647,230
"15637","산상수훈","2018-12-23","1",30,48677,231
"15638","산상수훈","2018-12-27","3",620,49297,232
"15639","산상수훈","2018-12-29","3",152,49449,233
"15640","산상수훈","2018-12-30","1",30,49479,234
"15641","산상수훈","2019-01-05","3",142,49621,235
"15642","산상수훈","2019-01-06","1",29,49650,236
"15643","산상수훈","2019-01-12","4",302,49952,237
"15644","산상수훈","2019-01-13","1",30,49982,238
"15645","산상수훈","2019-01-19","4",295,50277,239
"15646","산상수훈","2019-01-20","1",30,50307,240
"15647","산상수훈","2019-01-21","1",86,50393,241
"15648","산상수훈","2019-01-26","4",293,50686,242
"15649","산상수훈","2019-01-27","1",25,50711,243
"15650","산상수훈","2019-02-02","3",141,50852,244
"15651","산상수훈","2019-02-03","1",25,50877,245
"15652","산상수훈","2019-02-09","4",294,51171,246
"15653","산상수훈","2019-02-10","1",30,51201,247
"15654","산상수훈","2019-02-12","4",625,51826,248
"15655","산상수훈","2019-02-16","3",129,51955,249
"15656","산상수훈","2019-02-17","1",21,51976,250
"15657","산상수훈","2019-02-23","3",139,52115,251
"15658","산상수훈","2019-02-24","1",21,52136,252
"15659","산상수훈","2019-03-02","2",96,52232,253
"15660","산상수훈","2019-03-03","1",24,52256,254
"15661","산상수훈","2019-03-09","3",144,52400,255
"15662","산상수훈","2019-03-10","1",30,52430,256
"15663","산상수훈","2019-03-16","3",114,52544,257
"15664","산상수훈","2019-03-17","1",21,52565,258
"15665","산상수훈","2019-03-23","3",111,52676,259
"15666","썬키스 패밀리","2019-03-17","3",940,940,0
"15667","썬키스 패밀리","2019-03-19","5",1334,2274,0
"15668","메이트","2018-12-19","1",10,10,0
"15669","메이트","2019-01-08","1",315,325,0
"15670","메이트","2019-01-15","1",151,476,0
"15671","메이트","2019-01-16","1",105,581,0
"15672","메이트","2019-01-17","21",148,729,1
"15673","메이트","2019-01-18","20",181,910,2
"15674","메이트","2019-01-19","20",193,1103,3
"15675","메이트","2019-01-20","20",289,1392,4
"15676","메이트","2019-01-21","15",145,1537,5
"15677","메이트","2019-01-22","22",120,1657,6
"15678","메이트","2019-01-23","14",73,1730,7
"15679","메이트","2019-01-24","9",22,1752,8
"15680","메이트","2019-01-25","10",36,1788,9
"15681","메이트","2019-01-26","11",55,1843,10
"15682","메이트","2019-01-27","11",66,1909,11
"15683","메이트","2019-01-28","10",31,1940,12
"15684","메이트","2019-01-29","14",20,1960,13
"15685","메이트","2019-01-30","9",21,1981,14
"15686","메이트","2019-01-31","5",11,1992,15
"15687","메이트","2019-02-01","6",13,2005,16
"15688","메이트","2019-02-02","4",12,2017,17
"15689","메이트","2019-02-03","2",5,2022,18
"15690","메이트","2019-02-04","2",3,2025,19
"15691","메이트","2019-02-05","2",8,2033,20
"15692","메이트","2019-02-06","5",21,2054,21
"15693","메이트","2019-02-07","2",3,2057,22
"15694","메이트","2019-02-08","5",11,2068,23
"15695","메이트","2019-02-09","1",4,2072,24
"15696","메이트","2019-02-10","2",5,2077,25
"15697","메이트","2019-02-11","4",12,2089,26
"15698","메이트","2019-02-12","2",6,2095,27
"15699","메이트","2019-02-13","2",2,2097,28
"15700","메이트","2019-02-14","3",7,2104,29
"15701","메이트","2019-02-15","3",3,2107,30
"15702","메이트","2019-02-17","1",5,2112,31
"15703","메이트","2019-02-18","2",4,2116,32
"15704","메이트","2019-02-19","1",1,2117,33
"15705","메이트","2019-02-20","3",4,2121,34
"15706","메이트","2019-02-21","2",4,2125,35
"15707","메이트","2019-02-22","4",64,2189,36
"15708","메이트","2019-02-23","3",6,2195,37
"15709","메이트","2019-02-24","2",2,2197,38
"15710","메이트","2019-02-25","2",8,2205,39
"15711","메이트","2019-02-26","5",9,2214,40
"15712","얼굴들","2017-12-01","1",52,52,0
"15713","얼굴들","2017-12-03","1",73,125,0
"15714","얼굴들","2017-12-06","1",38,163,0
"15715","얼굴들","2018-03-21","1",25,188,0
"15716","얼굴들","2018-04-06","1",25,213,0
"15717","얼굴들","2018-06-08","1",12,225,0
"15718","얼굴들","2018-06-14","1",2,227,0
"15719","얼굴들","2018-08-10","1",3,230,0
"15720","얼굴들","2018-08-12","1",10,240,0
"15721","얼굴들","2018-08-15","1",4,244,0
"15722","얼굴들","2019-01-11","1",180,424,0
"15723","얼굴들","2019-01-18","2",412,836,0
"15724","얼굴들","2019-01-22","2",268,1104,0
"15725","얼굴들","2019-01-24","19",70,1174,1
"15726","얼굴들","2019-01-25","17",99,1273,2
"15727","얼굴들","2019-01-26","15",117,1390,3
"15728","얼굴들","2019-01-27","16",56,1446,4
"15729","얼굴들","2019-01-28","14",45,1491,5
"15730","얼굴들","2019-01-29","12",32,1523,6
"15731","얼굴들","2019-01-30","14",66,1589,7
"15732","얼굴들","2019-01-31","15",65,1654,8
"15733","얼굴들","2019-02-01","10",38,1692,9
"15734","얼굴들","2019-02-02","7",23,1715,10
"15735","얼굴들","2019-02-03","8",33,1748,11
"15736","얼굴들","2019-02-04","5",11,1759,12
"15737","얼굴들","2019-02-05","4",9,1768,13
"15738","얼굴들","2019-02-06","9",24,1792,14
"15739","얼굴들","2019-02-07","4",5,1797,15
"15740","얼굴들","2019-02-08","8",32,1829,16
"15741","얼굴들","2019-02-09","6",26,1855,17
"15742","얼굴들","2019-02-10","4",15,1870,18
"15743","얼굴들","2019-02-11","8",20,1890,19
"15744","얼굴들","2019-02-12","5",25,1915,20
"15745","얼굴들","2019-02-13","6",34,1949,21
"15746","얼굴들","2019-02-14","2",4,1953,22
"15747","얼굴들","2019-02-15","8",56,2009,23
"15748","얼굴들","2019-02-16","5",17,2026,24
"15749","얼굴들","2019-02-17","3",11,2037,25
"15750","얼굴들","2019-02-18","5",11,2048,26
"15751","얼굴들","2019-02-19","4",5,2053,27
"15752","얼굴들","2019-02-20","4",8,2061,28
"15753","얼굴들","2019-02-21","6",10,2071,29
"15754","얼굴들","2019-02-22","7",24,2095,30
"15755","얼굴들","2019-02-23","1",3,2098,31
"15756","얼굴들","2019-02-24","2",2,2100,32
"15757","얼굴들","2019-02-25","3",6,2106,33
"15758","얼굴들","2019-02-26","7",21,2127,34
"15759","얼굴들","2019-02-27","6",13,2140,35
"15760","얼굴들","2019-02-28","4",9,2149,36
"15761","얼굴들","2019-03-01","3",14,2163,37
"15762","얼굴들","2019-03-02","3",7,2170,38
"15763","얼굴들","2019-03-03","3",10,2180,39
"15764","얼굴들","2019-03-04","3",6,2186,40
"15765","얼굴들","2019-03-05","3",4,2190,41
"15766","얼굴들","2019-03-06","2",4,2194,42
"15767","얼굴들","2019-03-08","1",7,2201,43
"15768","얼굴들","2019-03-09","3",13,2214,44
"15769","얼굴들","2019-03-10","2",14,2228,45
"15770","얼굴들","2019-03-11","2",9,2237,46
"15771","얼굴들","2019-03-12","1",1,2238,47
"15772","얼굴들","2019-03-13","1",1,2239,48
"15773","얼굴들","2019-03-14","1",2,2241,49
"15774","얼굴들","2019-03-15","1",1,2242,50
"15775","얼굴들","2019-03-16","2",7,2249,51
"15776","얼굴들","2019-03-21","2",4,2253,52
"15777","얼굴들","2019-03-22","1",1,2254,53
"15778","선종 무문관","2018-12-10","1",189,189,0
"15779","선종 무문관","2018-12-13","1",53,242,1
"15780","선종 무문관","2018-12-14","2",67,309,2
"15781","선종 무문관","2018-12-15","3",73,382,3
"15782","선종 무문관","2018-12-16","2",78,460,4
"15783","선종 무문관","2018-12-17","3",69,529,5
"15784","선종 무문관","2018-12-18","2",65,594,6
"15785","선종 무문관","2018-12-19","2",70,664,7
"15786","선종 무문관","2018-12-20","3",41,705,8
"15787","선종 무문관","2018-12-21","2",47,752,9
"15788","선종 무문관","2018-12-22","1",35,787,10
"15789","선종 무문관","2018-12-23","2",43,830,11
"15790","선종 무문관","2018-12-24","1",42,872,12
"15791","선종 무문관","2018-12-25","1",42,914,13
"15792","선종 무문관","2018-12-26","2",37,951,14
"15793","선종 무문관","2018-12-27","2",53,1004,15
"15794","선종 무문관","2018-12-28","1",5,1009,16
"15795","선종 무문관","2019-01-01","1",4,1013,17
"15796","선종 무문관","2019-01-03","2",41,1054,18
"15797","선종 무문관","2019-01-04","1",42,1096,19
"15798","선종 무문관","2019-01-05","2",48,1144,20
"15799","선종 무문관","2019-01-06","3",69,1213,21
"15800","선종 무문관","2019-01-07","1",43,1256,22
"15801","선종 무문관","2019-01-08","3",66,1322,23
"15802","선종 무문관","2019-01-09","2",101,1423,24
"15803","선종 무문관","2019-01-10","4",185,1608,25
"15804","선종 무문관","2019-01-11","3",149,1757,26
"15805","선종 무문관","2019-01-12","2",96,1853,27
"15806","선종 무문관","2019-01-13","4",173,2026,28
"15807","선종 무문관","2019-01-14","3",101,2127,29
"15808","선종 무문관","2019-01-15","2",95,2222,30
"15809","선종 무문관","2019-01-16","3",96,2318,31
"15810","선종 무문관","2019-01-17","3",49,2367,32
"15811","선종 무문관","2019-01-18","2",45,2412,33
"15812","선종 무문관","2019-01-19","3",63,2475,34
"15813","선종 무문관","2019-01-20","2",52,2527,35
"15814","선종 무문관","2019-01-21","1",36,2563,36
"15815","선종 무문관","2019-01-22","2",78,2641,37
"15816","선종 무문관","2019-01-23","1",32,2673,38
"15817","선종 무문관","2019-01-24","2",3,2676,39
"15818","선종 무문관","2019-01-26","2",37,2713,40
"15819","선종 무문관","2019-01-27","1",55,2768,41
"15820","선종 무문관","2019-01-28","1",42,2810,42
"15821","선종 무문관","2019-01-29","1",13,2823,43
"15822","선종 무문관","2019-01-30","1",34,2857,44
"15823","선종 무문관","2019-01-31","1",1,2858,45
"15824","선종 무문관","2019-02-01","1",9,2867,46
"15825","선종 무문관","2019-02-02","1",14,2881,47
"15826","선종 무문관","2019-02-03","1",10,2891,48
"15827","선종 무문관","2019-02-04","2",26,2917,49
"15828","선종 무문관","2019-02-05","1",20,2937,50
"15829","선종 무문관","2019-02-07","1",3,2940,51
"15830","선종 무문관","2019-02-08","1",5,2945,52
"15831","선종 무문관","2019-02-09","1",42,2987,53
"15832","선종 무문관","2019-02-12","1",20,3007,54
"15833","선종 무문관","2019-02-20","1",2,3009,55
"15834","선종 무문관","2019-02-27","1",3,3012,56
"15890","이월","2017-12-02","1",50,50,0
"15891","이월","2017-12-04","1",46,96,0
"15892","이월","2017-12-05","1",11,107,0
"15893","이월","2018-01-13","1",17,124,0
"15894","이월","2018-04-08","1",32,156,0
"15895","이월","2018-04-12","1",2,158,0
"15896","이월","2018-04-13","1",14,172,0
"15897","이월","2018-04-14","1",20,192,0
"15898","이월","2018-04-26","1",2,194,0
"15899","이월","2018-04-28","1",0,194,0
"15900","이월","2018-05-02","1",4,198,0
"15901","이월","2018-05-10","1",5,203,0
"15902","이월","2018-05-12","1",2,205,0
"15903","이월","2018-05-13","1",3,208,0
"15904","이월","2018-05-16","2",10,218,0
"15905","이월","2018-06-22","1",1,219,0
"15906","이월","2019-01-16","2",327,546,0
"15907","이월","2019-01-30","12",34,580,1
"15908","이월","2019-01-31","19",105,685,2
"15909","이월","2019-02-01","14",178,863,3
"15910","이월","2019-02-02","15",63,926,4
"15911","이월","2019-02-03","17",100,1026,5
"15912","이월","2019-02-04","11",55,1081,6
"15913","이월","2019-02-05","8",36,1117,7
"15914","이월","2019-02-06","14",64,1181,8
"15915","이월","2019-02-07","10",30,1211,9
"15916","이월","2019-02-08","10",36,1247,10
"15917","이월","2019-02-09","7",54,1301,11
"15918","이월","2019-02-10","7",34,1335,12
"15919","이월","2019-02-11","9",21,1356,13
"15920","이월","2019-02-12","6",19,1375,14
"15921","이월","2019-02-13","8",20,1395,15
"15922","이월","2019-02-14","8",10,1405,16
"15923","이월","2019-02-15","8",24,1429,17
"15924","이월","2019-02-16","5",27,1456,18
"15925","이월","2019-02-17","4",15,1471,19
"15926","이월","2019-02-18","8",19,1490,20
"15927","이월","2019-02-19","8",58,1548,21
"15928","이월","2019-02-20","8",21,1569,22
"15929","이월","2019-02-21","4",8,1577,23
"15930","이월","2019-02-22","6",8,1585,24
"15931","이월","2019-02-23","7",19,1604,25
"15932","이월","2019-02-24","4",5,1609,26
"15933","이월","2019-02-25","7",17,1626,27
"15934","이월","2019-02-26","6",18,1644,28
"15935","이월","2019-02-27","3",4,1648,29
"15936","이월","2019-02-28","3",9,1657,30
"15937","이월","2019-03-01","1",1,1658,31
"15938","이월","2019-03-02","1",3,1661,32
"15939","이월","2019-03-03","3",9,1670,33
"15940","이월","2019-03-04","2",5,1675,34
"15941","이월","2019-03-05","3",7,1682,35
"15942","이월","2019-03-06","2",3,1685,36
"15943","이월","2019-03-07","1",1,1686,37
"15944","이월","2019-03-08","3",4,1690,38
"15945","이월","2019-03-09","2",8,1698,39
"15946","이월","2019-03-10","5",11,1709,40
"15947","이월","2019-03-12","1",2,1711,41
"15948","이월","2019-03-13","4",10,1721,42
"15949","이월","2019-03-14","2",9,1730,43
"15950","이월","2019-03-15","1",3,1733,44
"15951","이월","2019-03-16","2",13,1746,45
"15952","이월","2019-03-17","1",6,1752,46
"15953","이월","2019-03-18","2",3,1755,47
"15954","이월","2019-03-19","2",1,1756,48
"15955","이월","2019-03-20","1",3,1759,49
"15956","이월","2019-03-23","1",9,1768,50
"15957","어른이 되면","2018-11-02","1",0,0,0
"15958","어른이 되면","2018-11-14","2",192,192,0
"15959","어른이 되면","2018-11-21","1",46,238,0
"15960","어른이 되면","2018-11-29","1",138,376,0
"15961","어른이 되면","2018-12-03","1",89,465,0
"15962","어른이 되면","2018-12-04","3",419,884,0
"15963","어른이 되면","2018-12-05","1",226,1110,0
"15964","어른이 되면","2018-12-08","1",420,1530,0
"15965","어른이 되면","2018-12-11","1",160,1690,0
"15966","어른이 되면","2018-12-13","23",99,1789,1
"15967","어른이 되면","2018-12-14","22",155,1944,2
"15968","어른이 되면","2018-12-15","17",162,2106,3
"15969","어른이 되면","2018-12-16","18",159,2265,4
"15970","어른이 되면","2018-12-17","17",164,2429,5
"15971","어른이 되면","2018-12-18","25",121,2550,6
"15972","어른이 되면","2018-12-19","18",132,2682,7
"15973","어른이 되면","2018-12-20","13",212,2894,8
"15974","어른이 되면","2018-12-21","9",93,2987,9
"15975","어른이 되면","2018-12-22","11",198,3185,10
"15976","어른이 되면","2018-12-23","10",92,3277,11
"15977","어른이 되면","2018-12-24","9",54,3331,12
"15978","어른이 되면","2018-12-25","11",103,3434,13
"15979","어른이 되면","2018-12-26","9",214,3648,14
"15980","어른이 되면","2018-12-27","10",54,3702,15
"15981","어른이 되면","2018-12-28","6",196,3898,16
"15982","어른이 되면","2018-12-29","7",185,4083,17
"15983","어른이 되면","2018-12-30","7",85,4168,18
"15984","어른이 되면","2018-12-31","6",48,4216,19
"15985","어른이 되면","2019-01-01","7",110,4326,20
"15986","어른이 되면","2019-01-02","7",53,4379,21
"15987","어른이 되면","2019-01-03","6",27,4406,22
"15988","어른이 되면","2019-01-04","6",35,4441,23
"15989","어른이 되면","2019-01-05","6",100,4541,24
"15990","어른이 되면","2019-01-06","6",102,4643,25
"15991","어른이 되면","2019-01-07","6",41,4684,26
"15992","어른이 되면","2019-01-08","5",38,4722,27
"15993","어른이 되면","2019-01-09","5",66,4788,28
"15994","어른이 되면","2019-01-10","5",14,4802,29
"15995","어른이 되면","2019-01-11","4",22,4824,30
"15996","어른이 되면","2019-01-12","5",29,4853,31
"15997","어른이 되면","2019-01-13","5",18,4871,32
"15998","어른이 되면","2019-01-14","6",67,4938,33
"15999","어른이 되면","2019-01-15","7",70,5008,34
"16000","어른이 되면","2019-01-16","5",23,5031,35
"16001","어른이 되면","2019-01-17","5",27,5058,36
"16002","어른이 되면","2019-01-18","3",15,5073,37
"16003","어른이 되면","2019-01-19","6",38,5111,38
"16004","어른이 되면","2019-01-20","5",30,5141,39
"16005","어른이 되면","2019-01-21","3",12,5153,40
"16006","어른이 되면","2019-01-22","4",47,5200,41
"16007","어른이 되면","2019-01-23","6",12,5212,42
"16008","어른이 되면","2019-01-24","4",12,5224,43
"16009","어른이 되면","2019-01-25","3",7,5231,44
"16010","어른이 되면","2019-01-26","2",25,5256,45
"16011","어른이 되면","2019-01-27","4",18,5274,46
"16012","어른이 되면","2019-01-28","4",17,5291,47
"16013","어른이 되면","2019-01-29","1",6,5297,48
"16014","어른이 되면","2019-01-30","2",3,5300,49
"16015","어른이 되면","2019-01-31","3",19,5319,50
"16016","어른이 되면","2019-02-01","6",18,5337,51
"16017","어른이 되면","2019-02-02","4",18,5355,52
"16018","어른이 되면","2019-02-03","3",21,5376,53
"16019","어른이 되면","2019-02-04","5",23,5399,54
"16020","어른이 되면","2019-02-05","2",6,5405,55
"16021","어른이 되면","2019-02-06","4",10,5415,56
"16022","어른이 되면","2019-02-07","2",7,5422,57
"16023","어른이 되면","2019-02-08","3",7,5429,58
"16024","어른이 되면","2019-02-09","4",37,5466,59
"16025","어른이 되면","2019-02-10","3",6,5472,60
"16026","어른이 되면","2019-02-11","2",9,5481,61
"16027","어른이 되면","2019-02-12","1",3,5484,62
"16028","어른이 되면","2019-02-13","2",12,5496,63
"16029","어른이 되면","2019-02-14","4",19,5515,64
"16030","어른이 되면","2019-02-15","4",10,5525,65
"16031","어른이 되면","2019-02-16","2",5,5530,66
"16032","어른이 되면","2019-02-17","2",8,5538,67
"16033","어른이 되면","2019-02-18","1",2,5540,68
"16034","어른이 되면","2019-02-19","2",5,5545,69
"16035","어른이 되면","2019-02-20","4",8,5553,70
"16036","어른이 되면","2019-02-21","3",19,5572,71
"16037","어른이 되면","2019-02-22","4",10,5582,72
"16038","어른이 되면","2019-02-23","3",6,5588,73
"16039","어른이 되면","2019-02-24","3",7,5595,74
"16040","어른이 되면","2019-02-25","4",7,5602,75
"16041","어른이 되면","2019-02-26","4",10,5612,76
"16042","어른이 되면","2019-02-27","3",9,5621,77
"16043","어른이 되면","2019-02-28","1",2,5623,78
"16044","어른이 되면","2019-03-03","1",3,5626,79
"16045","어른이 되면","2019-03-13","1",2,5628,80
"16046","내가 사는 세상","2018-11-03","1",0,0,0
"16047","내가 사는 세상","2018-11-05","1",0,0,0
"16048","내가 사는 세상","2018-11-30","1",27,27,0
"16049","내가 사는 세상","2018-12-01","1",28,55,0
"16050","내가 사는 세상","2018-12-06","1",27,82,0
"16051","내가 사는 세상","2019-02-21","1",126,208,0
"16052","내가 사는 세상","2019-02-27","1",20,228,0
"16053","내가 사는 세상","2019-02-28","1",210,438,0
"16054","내가 사는 세상","2019-03-06","1",31,469,0
"16055","내가 사는 세상","2019-03-07","19",91,560,1
"16056","내가 사는 세상","2019-03-08","16",87,647,2
"16057","내가 사는 세상","2019-03-09","14",107,754,3
"16058","내가 사는 세상","2019-03-10","15",100,854,4
"16059","내가 사는 세상","2019-03-11","13",76,930,5
"16060","내가 사는 세상","2019-03-12","14",28,958,6
"16061","내가 사는 세상","2019-03-13","13",67,1025,7
"16062","내가 사는 세상","2019-03-14","11",45,1070,8
"16063","내가 사는 세상","2019-03-15","7",16,1086,9
"16064","내가 사는 세상","2019-03-16","11",45,1131,10
"16065","내가 사는 세상","2019-03-17","7",19,1150,11
"16066","내가 사는 세상","2019-03-18","7",42,1192,12
"16067","내가 사는 세상","2019-03-19","11",30,1222,13
"16068","내가 사는 세상","2019-03-20","8",23,1245,14
"16069","내가 사는 세상","2019-03-21","9",55,1300,15
"16070","내가 사는 세상","2019-03-22","5",41,1341,16
"16071","내가 사는 세상","2019-03-23","7",47,1388,17
"16072","국경의 왕","2017-12-01","1",42,42,0
"16073","국경의 왕","2017-12-03","1",42,84,0
"16074","국경의 왕","2017-12-05","1",75,159,0
"16075","국경의 왕","2018-04-07","1",44,203,0
"16076","국경의 왕","2018-06-09","1",30,233,0
"16077","국경의 왕","2018-06-14","1",14,247,0
"16078","국경의 왕","2018-11-24","1",56,303,0
"16079","국경의 왕","2018-11-26","1",56,359,0
"16080","국경의 왕","2019-02-28","5",248,607,1
"16081","국경의 왕","2019-03-01","5",63,670,2
"16082","국경의 왕","2019-03-02","4",87,757,3
"16083","국경의 왕","2019-03-03","3",32,789,4
"16084","국경의 왕","2019-03-04","5",59,848,5
"16085","국경의 왕","2019-03-05","5",30,878,6
"16086","국경의 왕","2019-03-06","4",33,911,7
"16087","국경의 왕","2019-03-07","6",206,1117,8
"16088","국경의 왕","2019-03-08","4",9,1126,9
"16089","국경의 왕","2019-03-09","7",49,1175,10
"16090","국경의 왕","2019-03-10","3",40,1215,11
"16091","국경의 왕","2019-03-11","6",21,1236,12
"16092","국경의 왕","2019-03-12","7",16,1252,13
"16093","국경의 왕","2019-03-13","5",15,1267,14
"16094","국경의 왕","2019-03-14","4",15,1282,15
"16095","국경의 왕","2019-03-15","6",28,1310,16
"16096","국경의 왕","2019-03-16","4",30,1340,17
"16097","국경의 왕","2019-03-17","6",16,1356,18
"16098","국경의 왕","2019-03-18","3",59,1415,19
"16099","국경의 왕","2019-03-19","7",22,1437,20
"16100","국경의 왕","2019-03-20","4",16,1453,21
"16101","국경의 왕","2019-03-21","6",13,1466,22
"16102","국경의 왕","2019-03-22","6",24,1490,23
"16103","국경의 왕","2019-03-23","4",31,1521,24
"16104","포항","2019-02-20","1",320,320,0
"16105","포항","2019-02-25","1",0,320,0
"16106","포항","2019-02-26","1",102,422,0
"16107","포항","2019-02-27","3",10,432,1
"16108","포항","2019-02-28","8",26,458,2
"16109","포항","2019-03-01","3",4,462,3
"16110","포항","2019-03-02","7",34,496,4
"16111","포항","2019-03-03","1",0,496,5
"16112","포항","2019-03-04","2",3,499,6
"16113","포항","2019-03-05","7",13,512,7
"16114","포항","2019-03-06","3",35,547,8
"16115","포항","2019-03-07","6",37,584,9
"16116","포항","2019-03-08","5",45,629,10
"16117","포항","2019-03-09","3",49,678,11
"16118","포항","2019-03-10","5",55,733,12
"16119","포항","2019-03-11","5",38,771,13
"16120","포항","2019-03-12","4",47,818,14
"16121","포항","2019-03-13","2",32,850,15
"16122","포항","2019-03-14","2",31,881,16
"16123","포항","2019-03-15","3",33,914,17
"16124","포항","2019-03-16","2",42,956,18
"16125","포항","2019-03-17","2",47,1003,19
"16126","포항","2019-03-18","2",31,1034,20
"16127","포항","2019-03-19","2",31,1065,21
"16128","포항","2019-03-22","1",8,1073,22
"16129","포항","2019-03-23","1",64,1137,23
"16238","산딸기","2019-03-12","1",458,458,0
"16239","산딸기","2019-03-13","1",301,759,0
"16240","산딸기","2019-03-14","1",226,985,0
"16241","히치하이크","2017-12-02","1",69,69,0
"16242","히치하이크","2017-12-04","1",56,125,0
"16243","히치하이크","2017-12-05","1",47,172,0
"16244","히치하이크","2018-09-30","1",17,189,0
"16245","히치하이크","2019-03-08","1",154,343,0
"16246","히치하이크","2019-03-12","1",210,553,0
"16247","히치하이크","2019-03-14","24",77,630,1
"16248","히치하이크","2019-03-15","19",59,689,2
"16249","히치하이크","2019-03-16","21",77,766,3
"16250","히치하이크","2019-03-17","16",54,820,4
"16251","히치하이크","2019-03-18","16",44,864,5
"16252","히치하이크","2019-03-19","18",60,924,6
"16253","히치하이크","2019-03-20","13",32,956,7
"16254","히치하이크","2019-03-21","14",43,999,8
"16255","히치하이크","2019-03-22","11",53,1052,9
"16256","히치하이크","2019-03-23","11",56,1108,10
"16257","런닝맨 : 풀룰루의 역습","2018-11-27","3",721,721,0
"16258","런닝맨 : 풀룰루의 역습","2018-12-03","3",471,1192,0
"16259","런닝맨 : 풀룰루의 역습","2018-12-04","4",793,1985,0
"16260","런닝맨 : 풀룰루의 역습","2018-12-05","278",6486,8471,1
"16261","런닝맨 : 풀룰루의 역습","2018-12-06","252",3866,12337,2
"16262","런닝맨 : 풀룰루의 역습","2018-12-07","260",4666,17003,3
"16263","런닝맨 : 풀룰루의 역습","2018-12-08","434",49582,66585,4
"16264","런닝맨 : 풀룰루의 역습","2018-12-09","511",56288,122873,5
"16265","런닝맨 : 풀룰루의 역습","2018-12-10","238",2579,125452,6
"16266","런닝맨 : 풀룰루의 역습","2018-12-11","254",3124,128576,7
"16267","런닝맨 : 풀룰루의 역습","2018-12-12","177",2527,131103,8
"16268","런닝맨 : 풀룰루의 역습","2018-12-13","142",2306,133409,9
"16269","런닝맨 : 풀룰루의 역습","2018-12-14","159",2614,136023,10
"16270","런닝맨 : 풀룰루의 역습","2018-12-15","390",22258,158281,11
"16271","런닝맨 : 풀룰루의 역습","2018-12-16","394",22428,180709,12
"16272","런닝맨 : 풀룰루의 역습","2018-12-17","140",1092,181801,13
"16273","런닝맨 : 풀룰루의 역습","2018-12-18","144",1509,183310,14
"16274","런닝맨 : 풀룰루의 역습","2018-12-19","14",438,183748,15
"16275","런닝맨 : 풀룰루의 역습","2018-12-20","20",283,184031,16
"16276","런닝맨 : 풀룰루의 역습","2018-12-21","25",457,184488,17
"16277","런닝맨 : 풀룰루의 역습","2018-12-22","36",880,185368,18
"16278","런닝맨 : 풀룰루의 역습","2018-12-23","33",696,186064,19
"16279","런닝맨 : 풀룰루의 역습","2018-12-24","16",273,186337,20
"16280","런닝맨 : 풀룰루의 역습","2018-12-25","14",358,186695,21
"16281","런닝맨 : 풀룰루의 역습","2018-12-26","6",140,186835,22
"16282","런닝맨 : 풀룰루의 역습","2018-12-27","3",10,186845,23
"16283","런닝맨 : 풀룰루의 역습","2018-12-28","2",7,186852,24
"16284","런닝맨 : 풀룰루의 역습","2018-12-29","6",33,186885,25
"16285","런닝맨 : 풀룰루의 역습","2018-12-30","4",19,186904,26
"16286","런닝맨 : 풀룰루의 역습","2018-12-31","2",8,186912,27
"16287","런닝맨 : 풀룰루의 역습","2019-01-01","3",9,186921,28
"16288","런닝맨 : 풀룰루의 역습","2019-01-02","1",1,186922,29
"16289","런닝맨 : 풀룰루의 역습","2019-01-03","3",64,186986,30
"16290","런닝맨 : 풀룰루의 역습","2019-01-04","3",46,187032,31
"16291","런닝맨 : 풀룰루의 역습","2019-01-06","1",9,187041,32
"16292","런닝맨 : 풀룰루의 역습","2019-01-08","1",4,187045,33
"16293","런닝맨 : 풀룰루의 역습","2019-02-13","1",316,187361,34
"16294","런닝맨 : 풀룰루의 역습","2019-02-14","1",416,187777,35
"16295","창간호","2019-01-10","1",371,371,0
"16296","창간호","2019-01-17","7",100,471,1
"16297","창간호","2019-01-18","5",74,545,2
"16298","창간호","2019-01-19","5",64,609,3
"16299","창간호","2019-01-20","6",45,654,4
"16300","창간호","2019-01-21","5",29,683,5
"16301","창간호","2019-01-22","7",39,722,6
"16302","창간호","2019-01-23","6",21,743,7
"16303","창간호","2019-01-24","5",10,753,8
"16304","창간호","2019-01-25","4",16,769,9
"16305","창간호","2019-01-26","3",11,780,10
"16306","창간호","2019-01-27","3",8,788,11
"16307","창간호","2019-01-28","3",8,796,12
"16308","창간호","2019-01-29","3",5,801,13
"16309","창간호","2019-01-30","2",4,805,14
"16310","창간호","2019-01-31","3",3,808,15
"16311","창간호","2019-02-01","1",3,811,16
"16312","창간호","2019-02-02","1",2,813,17
"16313","창간호","2019-02-03","1",1,814,18
"16314","창간호","2019-02-05","1",7,821,19
"16315","창간호","2019-02-07","1",3,824,20
"16316","창간호","2019-02-08","1",3,827,21
"16317","창간호","2019-02-09","1",2,829,22
"16318","창간호","2019-02-10","1",5,834,23
"16319","창간호","2019-02-12","2",4,838,24
"16320","창간호","2019-02-13","2",3,841,25
"16321","창간호","2019-02-14","1",4,845,26
"16322","창간호","2019-02-18","2",2,847,27
"16323","창간호","2019-02-19","1",1,848,28
"16324","창간호","2019-02-21","2",3,851,29
"16325","창간호","2019-02-22","2",2,853,30
"16326","창간호","2019-02-24","1",3,856,31
"16327","창간호","2019-02-25","1",1,857,32
"16328","창간호","2019-03-04","1",0,857,33
"16329","구봉서의 벼락부자","2010-11-15","1",82,82,0
"16330","구봉서의 벼락부자","2010-11-16","1",110,192,0
"16331","구봉서의 벼락부자","2010-11-17","1",91,283,0
"16332","구봉서의 벼락부자","2014-04-06","1",101,384,0
"16333","구봉서의 벼락부자","2014-04-07","1",90,474,0
"16334","구봉서의 벼락부자","2014-04-08","1",82,556,0
"16335","구봉서의 벼락부자","2014-04-09","1",34,590,0
"16336","구봉서의 벼락부자","2014-05-07","1",61,651,0
"16337","구봉서의 벼락부자","2014-05-08","1",67,718,0
"16338","구봉서의 벼락부자","2014-05-09","1",38,756,0
"16339","구봉서의 벼락부자","2014-05-10","1",61,817,0
"16340","구봉서의 벼락부자","2014-10-29","1",116,933,0
"16341","구봉서의 벼락부자","2014-10-30","1",111,1044,0
"16342","구봉서의 벼락부자","2015-08-09","1",280,1324,0
"16343","구봉서의 벼락부자","2015-08-10","1",174,1498,0
"16344","구봉서의 벼락부자","2015-08-11","1",156,1654,0
"16345","구봉서의 벼락부자","2017-03-27","1",169,1823,0
"16346","구봉서의 벼락부자","2017-03-28","1",119,1942,0
"16347","구봉서의 벼락부자","2017-03-29","1",205,2147,0
"16348","구봉서의 벼락부자","2018-08-24","1",39,2186,0
"16349","구봉서의 벼락부자","2018-08-25","1",31,2217,0
"16350","구봉서의 벼락부자","2018-08-26","1",33,2250,0
"16351","구봉서의 벼락부자","2018-08-27","1",30,2280,0
"16352","구봉서의 벼락부자","2019-02-26","1",342,2622,0
"16353","구봉서의 벼락부자","2019-02-27","1",310,2932,0
"16354","구봉서의 벼락부자","2019-02-28","1",196,3128,0
"16355","폴란드로 간 아이들","2018-10-15","3",982,982,0
"16356","폴란드로 간 아이들","2018-10-22","8",2576,3558,0
"16357","폴란드로 간 아이들","2018-10-23","1",332,3890,0
"16358","폴란드로 간 아이들","2018-10-24","1",149,4039,0
"16359","폴란드로 간 아이들","2018-10-27","1",250,4289,0
"16360","폴란드로 간 아이들","2018-10-30","5",1055,5344,0
"16361","폴란드로 간 아이들","2018-10-31","137",6090,11434,1
"16362","폴란드로 간 아이들","2018-11-01","181",4876,16310,2
"16363","폴란드로 간 아이들","2018-11-02","179",5556,21866,3
"16364","폴란드로 간 아이들","2018-11-03","177",2866,24732,4
"16365","폴란드로 간 아이들","2018-11-04","165",2573,27305,5
"16366","폴란드로 간 아이들","2018-11-05","173",1412,28717,6
"16367","폴란드로 간 아이들","2018-11-06","168",1508,30225,7
"16368","폴란드로 간 아이들","2018-11-07","77",1337,31562,8
"16369","폴란드로 간 아이들","2018-11-08","63",876,32438,9
"16370","폴란드로 간 아이들","2018-11-09","60",1146,33584,10
"16371","폴란드로 간 아이들","2018-11-10","56",1189,34773,11
"16372","폴란드로 간 아이들","2018-11-11","53",886,35659,12
"16373","폴란드로 간 아이들","2018-11-12","49",534,36193,13
"16374","폴란드로 간 아이들","2018-11-13","54",777,36970,14
"16375","폴란드로 간 아이들","2018-11-14","35",566,37536,15
"16376","폴란드로 간 아이들","2018-11-15","28",504,38040,16
"16377","폴란드로 간 아이들","2018-11-16","26",413,38453,17
"16378","폴란드로 간 아이들","2018-11-17","23",858,39311,18
"16379","폴란드로 간 아이들","2018-11-18","23",559,39870,19
"16380","폴란드로 간 아이들","2018-11-19","23",287,40157,20
"16381","폴란드로 간 아이들","2018-11-20","26",271,40428,21
"16382","폴란드로 간 아이들","2018-11-21","29",398,40826,22
"16383","폴란드로 간 아이들","2018-11-22","15",379,41205,23
"16384","폴란드로 간 아이들","2018-11-23","15",352,41557,24
"16385","폴란드로 간 아이들","2018-11-24","14",319,41876,25
"16386","폴란드로 간 아이들","2018-11-25","12",228,42104,26
"16387","폴란드로 간 아이들","2018-11-26","16",370,42474,27
"16388","폴란드로 간 아이들","2018-11-27","19",443,42917,28
"16389","폴란드로 간 아이들","2018-11-28","10",312,43229,29
"16390","폴란드로 간 아이들","2018-11-29","13",219,43448,30
"16391","폴란드로 간 아이들","2018-11-30","12",670,44118,31
"16392","폴란드로 간 아이들","2018-12-01","9",271,44389,32
"16393","폴란드로 간 아이들","2018-12-02","11",189,44578,33
"16394","폴란드로 간 아이들","2018-12-03","11",288,44866,34
"16395","폴란드로 간 아이들","2018-12-04","15",351,45217,35
"16396","폴란드로 간 아이들","2018-12-05","10",120,45337,36
"16397","폴란드로 간 아이들","2018-12-06","6",354,45691,37
"16398","폴란드로 간 아이들","2018-12-07","6",199,45890,38
"16399","폴란드로 간 아이들","2018-12-08","5",126,46016,39
"16400","폴란드로 간 아이들","2018-12-09","5",112,46128,40
"16401","폴란드로 간 아이들","2018-12-10","6",274,46402,41
"16402","폴란드로 간 아이들","2018-12-11","8",448,46850,42
"16403","폴란드로 간 아이들","2018-12-12","6",52,46902,43
"16404","폴란드로 간 아이들","2018-12-13","3",13,46915,44
"16405","폴란드로 간 아이들","2018-12-14","3",16,46931,45
"16406","폴란드로 간 아이들","2018-12-15","4",231,47162,46
"16407","폴란드로 간 아이들","2018-12-16","5",280,47442,47
"16408","폴란드로 간 아이들","2018-12-17","3",11,47453,48
"16409","폴란드로 간 아이들","2018-12-18","6",225,47678,49
"16410","폴란드로 간 아이들","2018-12-19","1",2,47680,50
"16411","폴란드로 간 아이들","2018-12-20","2",412,48092,51
"16412","폴란드로 간 아이들","2018-12-21","1",3,48095,52
"16413","폴란드로 간 아이들","2018-12-24","2",4,48099,53
"16414","폴란드로 간 아이들","2018-12-25","1",27,48126,54
"16415","폴란드로 간 아이들","2018-12-26","1",7,48133,55
"16416","폴란드로 간 아이들","2018-12-27","2",146,48279,56
"16417","폴란드로 간 아이들","2018-12-28","1",112,48391,57
"16418","폴란드로 간 아이들","2018-12-30","2",71,48462,58
"16419","폴란드로 간 아이들","2019-01-01","1",1,48463,59
"16420","폴란드로 간 아이들","2019-01-02","1",12,48475,60
"16421","폴란드로 간 아이들","2019-01-03","1",200,48675,61
"16422","폴란드로 간 아이들","2019-01-05","1",10,48685,62
"16423","폴란드로 간 아이들","2019-01-07","2",163,48848,63
"16424","폴란드로 간 아이들","2019-01-10","1",10,48858,64
"16425","폴란드로 간 아이들","2019-01-11","1",10,48868,65
"16426","폴란드로 간 아이들","2019-01-12","2",9,48877,66
"16427","폴란드로 간 아이들","2019-01-13","1",13,48890,67
"16428","폴란드로 간 아이들","2019-01-15","1",71,48961,68
"16429","폴란드로 간 아이들","2019-01-16","2",23,48984,69
"16430","폴란드로 간 아이들","2019-01-17","1",3,48987,70
"16431","폴란드로 간 아이들","2019-01-19","2",28,49015,71
"16432","폴란드로 간 아이들","2019-01-20","1",29,49044,72
"16433","폴란드로 간 아이들","2019-01-21","1",3,49047,73
"16434","폴란드로 간 아이들","2019-01-23","1",2,49049,74
"16435","폴란드로 간 아이들","2019-01-24","1",5,49054,75
"16436","폴란드로 간 아이들","2019-01-25","1",4,49058,76
"16437","폴란드로 간 아이들","2019-01-26","2",89,49147,77
"16438","폴란드로 간 아이들","2019-01-28","1",0,49147,78
"16439","폴란드로 간 아이들","2019-01-29","1",4,49151,79
"16440","폴란드로 간 아이들","2019-01-31","1",6,49157,80
"16441","폴란드로 간 아이들","2019-02-02","1",1,49158,81
"16442","폴란드로 간 아이들","2019-02-04","1",6,49164,82
"16443","폴란드로 간 아이들","2019-02-06","1",10,49174,83
"16444","폴란드로 간 아이들","2019-02-07","1",7,49181,84
"16445","폴란드로 간 아이들","2019-02-08","1",3,49184,85
"16446","폴란드로 간 아이들","2019-02-09","1",7,49191,86
"16447","폴란드로 간 아이들","2019-02-11","1",8,49199,87
"16448","폴란드로 간 아이들","2019-02-12","1",4,49203,88
"16449","폴란드로 간 아이들","2019-02-13","1",10,49213,89
"16450","폴란드로 간 아이들","2019-02-14","1",2,49215,90
"16451","폴란드로 간 아이들","2019-02-16","1",3,49218,91
"16452","폴란드로 간 아이들","2019-02-18","1",4,49222,92
"16453","폴란드로 간 아이들","2019-02-21","1",2,49224,93
"16454","폴란드로 간 아이들","2019-02-22","1",5,49229,94
"16455","폴란드로 간 아이들","2019-02-23","1",2,49231,95
"16456","폴란드로 간 아이들","2019-02-24","1",5,49236,96
"16457","폴란드로 간 아이들","2019-02-28","1",2,49238,97
"16458","폴란드로 간 아이들","2019-03-02","1",11,49249,98
"16459","폴란드로 간 아이들","2019-03-04","1",3,49252,99
"16460","폴란드로 간 아이들","2019-03-05","1",4,49256,100
"16461","폴란드로 간 아이들","2019-03-06","1",38,49294,101
"16462","폴란드로 간 아이들","2019-03-08","1",6,49300,102
"16463","폴란드로 간 아이들","2019-03-11","1",1,49301,103
"16464","폴란드로 간 아이들","2019-03-14","1",1,49302,104
"16465","버블 패밀리","2017-06-22","1",8,8,0
"16466","버블 패밀리","2017-08-22","1",18,26,0
"16467","버블 패밀리","2017-08-25","1",12,38,0
"16468","버블 패밀리","2017-09-22","1",7,45,0
"16469","버블 패밀리","2017-09-24","1",35,80,0
"16470","버블 패밀리","2017-10-01","1",30,110,0
"16471","버블 패밀리","2018-03-24","1",68,178,0
"16472","버블 패밀리","2018-03-28","1",81,259,0
"16473","버블 패밀리","2018-05-09","1",140,399,0
"16474","버블 패밀리","2018-05-26","1",0,399,0
"16475","버블 패밀리","2018-08-21","1",20,419,0
"16476","버블 패밀리","2018-08-23","1",9,428,0
"16477","버블 패밀리","2018-09-07","1",1,429,0
"16478","버블 패밀리","2018-09-09","1",5,434,0
"16479","버블 패밀리","2018-09-11","1",15,449,0
"16480","버블 패밀리","2018-12-20","13",70,519,1
"16481","버블 패밀리","2018-12-21","10",29,548,2
"16482","버블 패밀리","2018-12-22","8",45,593,3
"16483","버블 패밀리","2018-12-23","9",55,648,4
"16484","버블 패밀리","2018-12-24","9",36,684,5
"16485","버블 패밀리","2018-12-25","12",78,762,6
"16486","버블 패밀리","2018-12-26","10",45,807,7
"16487","버블 패밀리","2018-12-27","9",22,829,8
"16488","버블 패밀리","2018-12-28","5",10,839,9
"16489","버블 패밀리","2018-12-29","7",37,876,10
"16490","버블 패밀리","2018-12-30","6",25,901,11
"16491","버블 패밀리","2018-12-31","9",57,958,12
"16492","버블 패밀리","2019-01-01","6",54,1012,13
"16493","버블 패밀리","2019-01-02","11",67,1079,14
"16494","버블 패밀리","2019-01-03","8",25,1104,15
"16495","버블 패밀리","2019-01-04","6",53,1157,16
"16496","버블 패밀리","2019-01-05","5",29,1186,17
"16497","버블 패밀리","2019-01-06","6",35,1221,18
"16498","버블 패밀리","2019-01-07","5",12,1233,19
"16499","버블 패밀리","2019-01-08","10",44,1277,20
"16500","버블 패밀리","2019-01-09","6",29,1306,21
"16501","버블 패밀리","2019-01-10","8",32,1338,22
"16502","버블 패밀리","2019-01-11","5",12,1350,23
"16503","버블 패밀리","2019-01-12","7",40,1390,24
"16504","버블 패밀리","2019-01-13","5",46,1436,25
"16505","버블 패밀리","2019-01-14","8",12,1448,26
"16506","버블 패밀리","2019-01-15","6",17,1465,27
"16507","버블 패밀리","2019-01-16","7",78,1543,28
"16508","버블 패밀리","2019-01-17","4",8,1551,29
"16509","버블 패밀리","2019-01-18","6",19,1570,30
"16510","버블 패밀리","2019-01-19","2",17,1587,31
"16511","버블 패밀리","2019-01-20","3",30,1617,32
"16512","버블 패밀리","2019-01-21","4",8,1625,33
"16513","버블 패밀리","2019-01-22","4",12,1637,34
"16514","버블 패밀리","2019-01-23","4",15,1652,35
"16515","버블 패밀리","2019-01-24","1",4,1656,36
"16516","버블 패밀리","2019-01-25","2",5,1661,37
"16517","버블 패밀리","2019-01-26","2",8,1669,38
"16518","버블 패밀리","2019-01-27","1",2,1671,39
"16519","버블 패밀리","2019-01-28","1",1,1672,40
"16520","버블 패밀리","2019-01-29","4",13,1685,41
"16521","버블 패밀리","2019-01-30","1",1,1686,42
"16522","버블 패밀리","2019-01-31","2",24,1710,43
"16523","버블 패밀리","2019-02-02","2",7,1717,44
"16524","버블 패밀리","2019-02-03","1",1,1718,45
"16525","버블 패밀리","2019-02-04","1",2,1720,46
"16526","버블 패밀리","2019-02-05","1",4,1724,47
"16527","버블 패밀리","2019-02-06","1",4,1728,48
"16528","버블 패밀리","2019-02-08","2",2,1730,49
"16529","버블 패밀리","2019-02-11","2",4,1734,50
"16530","버블 패밀리","2019-02-13","2",28,1762,51
"16531","버블 패밀리","2019-02-15","1",2,1764,52
"16532","버블 패밀리","2019-02-16","1",2,1766,53
"16533","버블 패밀리","2019-02-22","1",1,1767,54
"16534","버블 패밀리","2019-02-23","1",2,1769,55
"16535","버블 패밀리","2019-02-25","1",13,1782,56
"16536","버블 패밀리","2019-02-26","1",13,1795,57
"16537","버블 패밀리","2019-02-27","1",1,1796,58
"16615","오발탄","2014-02-25","1",602,602,0
"16616","오발탄","2014-02-26","1",463,1065,0
"16617","오발탄","2014-02-27","1",437,1502,0
"16618","오발탄","2017-05-15","1",133,1635,0
"16619","오발탄","2017-05-16","1",70,1705,0
"16620","오발탄","2017-05-17","1",108,1813,0
"16621","오발탄","2017-07-03","1",0,1813,0
"16622","오발탄","2017-07-10","1",0,1813,0
"16623","오발탄","2018-12-05","1",133,1946,0
"16624","오발탄","2018-12-06","1",114,2060,0
"16625","오발탄","2019-02-18","1",308,2368,0
"16626","오발탄","2019-02-19","1",198,2566,0
"16627","오발탄","2019-02-20","1",191,2757,0
"16628","오발탄","2019-02-22","1",26,2783,0
"16629","오발탄","2019-02-23","1",36,2819,0
"16630","오발탄","2019-02-24","1",36,2855,0
"16631","오발탄","2019-02-25","1",24,2879,0
"16632","캡틴 마블","2019-03-05","1",624,624,0
"16633","캡틴 마블","2019-03-06","2,017",461135,461759,1
"16634","캡틴 마블","2019-03-07","1,997",312694,774453,2
"16635","캡틴 마블","2019-03-08","2,014",413068,1187521,3
"16636","캡틴 마블","2019-03-09","2,100",1001721,2189242,4
"16637","캡틴 마블","2019-03-10","2,089",847396,3036638,5
"16638","캡틴 마블","2019-03-11","1,915",170529,3207167,6
"16639","캡틴 마블","2019-03-12","1,935",137977,3345144,7
"16640","캡틴 마블","2019-03-13","1,874",126640,3471784,8
"16641","캡틴 마블","2019-03-14","1,624",116329,3588113,9
"16642","캡틴 마블","2019-03-15","1,648",173982,3762095,10
"16643","캡틴 마블","2019-03-16","1,779",472306,4234401,11
"16644","캡틴 마블","2019-03-17","1,751",365799,4600200,12
"16645","캡틴 마블","2019-03-18","1,592",82944,4683144,13
"16646","캡틴 마블","2019-03-19","1,599",72229,4755373,14
"16647","캡틴 마블","2019-03-20","730",46043,4801416,15
"16648","캡틴 마블","2019-03-21","738",45258,4846674,16
"16649","캡틴 마블","2019-03-22","812",65368,4912042,17
"16650","캡틴 마블","2019-03-23","938",178493,5090535,18
"16651","알리타: 배틀 엔젤","2019-01-23","1",624,624,0
"16652","알리타: 배틀 엔젤","2019-01-25","2",1269,1893,0
"16653","알리타: 배틀 엔젤","2019-01-28","1",624,2517,0
"16654","알리타: 배틀 엔젤","2019-02-01","31",4193,6710,0
"16655","알리타: 배틀 엔젤","2019-02-02","15",2600,9310,0
"16656","알리타: 배틀 엔젤","2019-02-03","15",3390,12700,0
"16657","알리타: 배틀 엔젤","2019-02-05","919",264263,276963,1
"16658","알리타: 배틀 엔젤","2019-02-06","1,004",282430,559393,2
"16659","알리타: 배틀 엔젤","2019-02-07","966",119477,678870,3
"16660","알리타: 배틀 엔젤","2019-02-08","994",114672,793542,4
"16661","알리타: 배틀 엔젤","2019-02-09","1,043",247117,1040659,5
"16662","알리타: 배틀 엔젤","2019-02-10","1,012",216214,1256873,6
"16663","알리타: 배틀 엔젤","2019-02-11","946",66011,1322884,7
"16664","알리타: 배틀 엔젤","2019-02-12","966",63473,1386357,8
"16665","알리타: 배틀 엔젤","2019-02-13","673",48230,1434587,9
"16666","알리타: 배틀 엔젤","2019-02-14","601",40088,1474675,10
"16667","알리타: 배틀 엔젤","2019-02-15","613",45876,1520551,11
"16668","알리타: 배틀 엔젤","2019-02-16","651",104037,1624588,12
"16669","알리타: 배틀 엔젤","2019-02-17","687",93432,1718020,13
"16670","알리타: 배틀 엔젤","2019-02-18","631",29618,1747638,14
"16671","알리타: 배틀 엔젤","2019-02-19","637",30226,1777864,15
"16672","알리타: 배틀 엔젤","2019-02-20","414",15056,1792920,16
"16673","알리타: 배틀 엔젤","2019-02-21","401",13508,1806428,17
"16674","알리타: 배틀 엔젤","2019-02-22","412",16460,1822888,18
"16675","알리타: 배틀 엔젤","2019-02-23","408",32998,1855886,19
"16676","알리타: 배틀 엔젤","2019-02-24","404",29462,1885348,20
"16677","알리타: 배틀 엔젤","2019-02-25","382",10083,1895431,21
"16678","알리타: 배틀 엔젤","2019-02-26","390",11831,1907262,22
"16679","알리타: 배틀 엔젤","2019-02-27","169",7721,1914983,23
"16680","알리타: 배틀 엔젤","2019-02-28","166",6676,1921659,24
"16681","알리타: 배틀 엔젤","2019-03-01","153",9595,1931254,25
"16682","알리타: 배틀 엔젤","2019-03-02","153",8847,1940101,26
"16683","알리타: 배틀 엔젤","2019-03-03","152",6107,1946208,27
"16684","알리타: 배틀 엔젤","2019-03-04","140",1733,1947941,28
"16685","알리타: 배틀 엔젤","2019-03-05","144",1655,1949596,29
"16686","알리타: 배틀 엔젤","2019-03-06","12",204,1949800,30
"16687","알리타: 배틀 엔젤","2019-03-07","12",201,1950001,31
"16688","알리타: 배틀 엔젤","2019-03-08","10",254,1950255,32
"16689","알리타: 배틀 엔젤","2019-03-09","12",477,1950732,33
"16690","알리타: 배틀 엔젤","2019-03-10","10",425,1951157,34
"16691","알리타: 배틀 엔젤","2019-03-11","12",187,1951344,35
"16692","알리타: 배틀 엔젤","2019-03-12","12",172,1951516,36
"16693","알리타: 배틀 엔젤","2019-03-13","12",231,1951747,37
"16694","알리타: 배틀 엔젤","2019-03-21","1",23,1951770,38
"16695","알리타: 배틀 엔젤","2019-03-22","1",46,1951816,39
"16696","주먹왕 랄프 2: 인터넷 속으로","2018-12-19","1",406,406,0
"16697","주먹왕 랄프 2: 인터넷 속으로","2018-12-20","2",498,904,0
"16698","주먹왕 랄프 2: 인터넷 속으로","2018-12-21","1",100,1004,0
"16699","주먹왕 랄프 2: 인터넷 속으로","2018-12-27","4",1198,2202,0
"16700","주먹왕 랄프 2: 인터넷 속으로","2018-12-28","9",2110,4312,0
"16701","주먹왕 랄프 2: 인터넷 속으로","2018-12-30","1",204,4516,0
"16702","주먹왕 랄프 2: 인터넷 속으로","2019-01-01","1",49,4565,0
"16703","주먹왕 랄프 2: 인터넷 속으로","2019-01-03","962",125882,130447,1
"16704","주먹왕 랄프 2: 인터넷 속으로","2019-01-04","1,123",114355,244802,2
"16705","주먹왕 랄프 2: 인터넷 속으로","2019-01-05","1,393",268326,513128,3
"16706","주먹왕 랄프 2: 인터넷 속으로","2019-01-06","1,453",245225,758353,4
"16707","주먹왕 랄프 2: 인터넷 속으로","2019-01-07","1,185",71418,829771,5
"16708","주먹왕 랄프 2: 인터넷 속으로","2019-01-08","1,176",75411,905182,6
"16709","주먹왕 랄프 2: 인터넷 속으로","2019-01-09","908",62802,967984,7
"16710","주먹왕 랄프 2: 인터넷 속으로","2019-01-10","870",58195,1026179,8
"16711","주먹왕 랄프 2: 인터넷 속으로","2019-01-11","897",59365,1085544,9
"16712","주먹왕 랄프 2: 인터넷 속으로","2019-01-12","934",134929,1220473,10
"16713","주먹왕 랄프 2: 인터넷 속으로","2019-01-13","933",121811,1342284,11
"16714","주먹왕 랄프 2: 인터넷 속으로","2019-01-14","835",33913,1376197,12
"16715","주먹왕 랄프 2: 인터넷 속으로","2019-01-15","827",36337,1412534,13
"16716","주먹왕 랄프 2: 인터넷 속으로","2019-01-16","636",29914,1442448,14
"16717","주먹왕 랄프 2: 인터넷 속으로","2019-01-17","531",22921,1465369,15
"16718","주먹왕 랄프 2: 인터넷 속으로","2019-01-18","591",24286,1489655,16
"16719","주먹왕 랄프 2: 인터넷 속으로","2019-01-19","645",59071,1548726,17
"16720","주먹왕 랄프 2: 인터넷 속으로","2019-01-20","651",58241,1606967,18
"16721","주먹왕 랄프 2: 인터넷 속으로","2019-01-21","553",16128,1623095,19
"16722","주먹왕 랄프 2: 인터넷 속으로","2019-01-22","568",17939,1641034,20
"16723","주먹왕 랄프 2: 인터넷 속으로","2019-01-23","400",12020,1653054,21
"16724","주먹왕 랄프 2: 인터넷 속으로","2019-01-24","388",12161,1665215,22
"16725","주먹왕 랄프 2: 인터넷 속으로","2019-01-25","405",10887,1676102,23
"16726","주먹왕 랄프 2: 인터넷 속으로","2019-01-26","497",29395,1705497,24
"16727","주먹왕 랄프 2: 인터넷 속으로","2019-01-27","482",29734,1735231,25
"16728","주먹왕 랄프 2: 인터넷 속으로","2019-01-28","380",6686,1741917,26
"16729","주먹왕 랄프 2: 인터넷 속으로","2019-01-29","398",7590,1749507,27
"16730","주먹왕 랄프 2: 인터넷 속으로","2019-01-30","62",1626,1751133,28
"16731","주먹왕 랄프 2: 인터넷 속으로","2019-01-31","35",951,1752084,29
"16732","주먹왕 랄프 2: 인터넷 속으로","2019-02-01","25",585,1752669,30
"16733","주먹왕 랄프 2: 인터넷 속으로","2019-02-02","22",1037,1753706,31
"16734","주먹왕 랄프 2: 인터넷 속으로","2019-02-03","24",1244,1754950,32
"16735","주먹왕 랄프 2: 인터넷 속으로","2019-02-04","26",1289,1756239,33
"16736","주먹왕 랄프 2: 인터넷 속으로","2019-02-05","13",330,1756569,34
"16737","주먹왕 랄프 2: 인터넷 속으로","2019-02-06","5",270,1756839,35
"16738","주먹왕 랄프 2: 인터넷 속으로","2019-02-07","3",42,1756881,36
"16739","주먹왕 랄프 2: 인터넷 속으로","2019-02-08","2",32,1756913,37
"16740","주먹왕 랄프 2: 인터넷 속으로","2019-02-09","3",157,1757070,38
"16741","주먹왕 랄프 2: 인터넷 속으로","2019-02-10","2",160,1757230,39
"16742","주먹왕 랄프 2: 인터넷 속으로","2019-02-11","1",40,1757270,40
"16743","주먹왕 랄프 2: 인터넷 속으로","2019-02-12","11",92,1757362,41
"16744","주먹왕 랄프 2: 인터넷 속으로","2019-02-13","12",191,1757553,42
"16745","주먹왕 랄프 2: 인터넷 속으로","2019-02-14","12",190,1757743,43
"16746","주먹왕 랄프 2: 인터넷 속으로","2019-02-15","11",69,1757812,44
"16747","주먹왕 랄프 2: 인터넷 속으로","2019-02-16","10",60,1757872,45
"16748","주먹왕 랄프 2: 인터넷 속으로","2019-02-17","11",69,1757941,46
"16749","주먹왕 랄프 2: 인터넷 속으로","2019-02-18","10",50,1757991,47
"16750","주먹왕 랄프 2: 인터넷 속으로","2019-02-19","10",50,1758041,48
"16751","주먹왕 랄프 2: 인터넷 속으로","2019-02-20","10",50,1758091,49
"16752","주먹왕 랄프 2: 인터넷 속으로","2019-02-21","10",50,1758141,50
"16753","주먹왕 랄프 2: 인터넷 속으로","2019-02-22","11",53,1758194,51
"16754","주먹왕 랄프 2: 인터넷 속으로","2019-02-23","10",50,1758244,52
"16755","주먹왕 랄프 2: 인터넷 속으로","2019-02-24","11",92,1758336,53
"16756","주먹왕 랄프 2: 인터넷 속으로","2019-02-25","10",50,1758386,54
"16757","주먹왕 랄프 2: 인터넷 속으로","2019-02-26","11",67,1758453,55
"16758","주먹왕 랄프 2: 인터넷 속으로","2019-02-27","10",50,1758503,56
"16759","주먹왕 랄프 2: 인터넷 속으로","2019-02-28","10",50,1758553,57
"16760","주먹왕 랄프 2: 인터넷 속으로","2019-03-01","10",50,1758603,58
"16761","주먹왕 랄프 2: 인터넷 속으로","2019-03-02","11",59,1758662,59
"16762","주먹왕 랄프 2: 인터넷 속으로","2019-03-03","10",50,1758712,60
"16763","주먹왕 랄프 2: 인터넷 속으로","2019-03-04","10",50,1758762,61
"16764","주먹왕 랄프 2: 인터넷 속으로","2019-03-05","10",50,1758812,62
"16765","주먹왕 랄프 2: 인터넷 속으로","2019-03-06","11",57,1758869,63
"16766","주먹왕 랄프 2: 인터넷 속으로","2019-03-09","1",11,1758880,64
"16767","주먹왕 랄프 2: 인터넷 속으로","2019-03-14","1",0,1758880,65
"16768","주먹왕 랄프 2: 인터넷 속으로","2019-03-17","1",11,1758891,66
"16829","드래곤 길들이기 3","2019-01-17","4",747,747,0
"16830","드래곤 길들이기 3","2019-01-18","1",126,873,0
"16831","드래곤 길들이기 3","2019-01-19","12",2017,2890,0
"16832","드래곤 길들이기 3","2019-01-21","19",4247,7137,0
"16833","드래곤 길들이기 3","2019-01-22","10",2031,9168,0
"16834","드래곤 길들이기 3","2019-01-29","1",450,9618,0
"16835","드래곤 길들이기 3","2019-01-30","930",124517,134135,1
"16836","드래곤 길들이기 3","2019-01-31","895",68834,202969,2
"16837","드래곤 길들이기 3","2019-02-01","886",74501,277470,3
"16838","드래곤 길들이기 3","2019-02-02","963",179529,456999,4
"16839","드래곤 길들이기 3","2019-02-03","971",166677,623676,5
"16840","드래곤 길들이기 3","2019-02-04","952",123409,747085,6
"16841","드래곤 길들이기 3","2019-02-05","800",76624,823709,7
"16842","드래곤 길들이기 3","2019-02-06","770",117834,941543,8
"16843","드래곤 길들이기 3","2019-02-07","694",38600,980143,9
"16844","드래곤 길들이기 3","2019-02-08","692",35556,1015699,10
"16845","드래곤 길들이기 3","2019-02-09","700",82465,1098164,11
"16846","드래곤 길들이기 3","2019-02-10","690",82872,1181036,12
"16847","드래곤 길들이기 3","2019-02-11","642",23346,1204382,13
"16848","드래곤 길들이기 3","2019-02-12","684",25083,1229465,14
"16849","드래곤 길들이기 3","2019-02-13","445",16226,1245691,15
"16850","드래곤 길들이기 3","2019-02-14","359",12920,1258611,16
"16851","드래곤 길들이기 3","2019-02-15","363",13649,1272260,17
"16852","드래곤 길들이기 3","2019-02-16","475",35909,1308169,18
"16853","드래곤 길들이기 3","2019-02-17","503",39505,1347674,19
"16854","드래곤 길들이기 3","2019-02-18","402",11869,1359543,20
"16855","드래곤 길들이기 3","2019-02-19","408",12901,1372444,21
"16856","드래곤 길들이기 3","2019-02-20","190",7457,1379901,22
"16857","드래곤 길들이기 3","2019-02-21","186",7196,1387097,23
"16858","드래곤 길들이기 3","2019-02-22","212",8298,1395395,24
"16859","드래곤 길들이기 3","2019-02-23","305",17185,1412580,25
"16860","드래곤 길들이기 3","2019-02-24","306",18137,1430717,26
"16861","드래곤 길들이기 3","2019-02-25","261",8634,1439351,27
"16862","드래곤 길들이기 3","2019-02-26","268",10401,1449752,28
"16863","드래곤 길들이기 3","2019-02-27","157",7252,1457004,29
"16864","드래곤 길들이기 3","2019-02-28","164",7737,1464741,30
"16865","드래곤 길들이기 3","2019-03-01","203",14474,1479215,31
"16866","드래곤 길들이기 3","2019-03-02","206",10445,1489660,32
"16867","드래곤 길들이기 3","2019-03-03","209",9099,1498759,33
"16868","드래곤 길들이기 3","2019-03-04","136",1386,1500145,34
"16869","드래곤 길들이기 3","2019-03-05","118",721,1500866,35
"16870","드래곤 길들이기 3","2019-03-06","33",187,1501053,36
"16871","드래곤 길들이기 3","2019-03-07","23",124,1501177,37
"16872","드래곤 길들이기 3","2019-03-08","22",104,1501281,38
"16873","드래곤 길들이기 3","2019-03-09","49",1121,1502402,39
"16874","드래곤 길들이기 3","2019-03-10","49",1598,1504000,40
"16875","드래곤 길들이기 3","2019-03-11","17",86,1504086,41
"16876","드래곤 길들이기 3","2019-03-12","20",109,1504195,42
"16877","드래곤 길들이기 3","2019-03-13","17",100,1504295,43
"16878","드래곤 길들이기 3","2019-03-14","9",58,1504353,44
"16879","드래곤 길들이기 3","2019-03-15","12",114,1504467,45
"16880","드래곤 길들이기 3","2019-03-16","21",647,1505114,46
"16881","드래곤 길들이기 3","2019-03-17","22",649,1505763,47
"16882","드래곤 길들이기 3","2019-03-18","9",54,1505817,48
"16883","드래곤 길들이기 3","2019-03-19","8",49,1505866,49
"16884","드래곤 길들이기 3","2019-03-20","4",502,1506368,50
"16885","드래곤 길들이기 3","2019-03-21","1",9,1506377,51
"16886","드래곤 길들이기 3","2019-03-22","3",16,1506393,52
"16887","드래곤 길들이기 3","2019-03-23","4",122,1506515,53
"17037","이스케이프 룸","2019-03-05","1",284,284,0
"17038","이스케이프 룸","2019-03-07","1",545,829,0
"17039","이스케이프 룸","2019-03-12","15",3580,4409,0
"17040","이스케이프 룸","2019-03-13","582",18779,23188,0
"17041","이스케이프 룸","2019-03-14","686",52817,76005,1
"17042","이스케이프 룸","2019-03-15","718",63556,139561,2
"17043","이스케이프 룸","2019-03-16","850",133135,272696,3
"17044","이스케이프 룸","2019-03-17","832",116893,389589,4
"17045","이스케이프 룸","2019-03-18","751",36891,426480,5
"17046","이스케이프 룸","2019-03-19","756",32293,458773,6
"17047","이스케이프 룸","2019-03-20","513",12025,470798,7
"17048","이스케이프 룸","2019-03-21","456",9784,480582,8
"17049","이스케이프 룸","2019-03-22","447",12564,493146,9
"17050","이스케이프 룸","2019-03-23","496",27842,520988,10
"17051","글래스","2019-01-10","1",624,624,0
"17052","글래스","2019-01-17","837",71816,72440,1
"17053","글래스","2019-01-18","817",64404,136844,2
"17054","글래스","2019-01-19","810",113258,250102,3
"17055","글래스","2019-01-20","792",89605,339707,4
"17056","글래스","2019-01-21","735",31743,371450,5
"17057","글래스","2019-01-22","727",26131,397581,6
"17058","글래스","2019-01-23","490",11678,409259,7
"17059","글래스","2019-01-24","453",9325,418584,8
"17060","글래스","2019-01-25","426",8388,426972,9
"17061","글래스","2019-01-26","358",13897,440869,10
"17062","글래스","2019-01-27","349",11591,452460,11
"17063","글래스","2019-01-28","353",4926,457386,12
"17064","글래스","2019-01-29","348",5430,462816,13
"17065","글래스","2019-01-30","37",635,463451,14
"17066","글래스","2019-01-31","14",564,464015,15
"17067","글래스","2019-02-01","12",383,464398,16
"17068","글래스","2019-02-02","11",423,464821,17
"17069","글래스","2019-02-03","13",423,465244,18
"17070","글래스","2019-02-04","18",424,465668,19
"17071","글래스","2019-02-05","7",189,465857,20
"17072","글래스","2019-02-06","5",190,466047,21
"17073","글래스","2019-02-07","2",32,466079,22
"17074","글래스","2019-02-08","2",44,466123,23
"17075","글래스","2019-02-09","3",119,466242,24
"17076","글래스","2019-02-10","2",73,466315,25
"17077","글래스","2019-02-11","2",17,466332,26
"17078","글래스","2019-02-12","2",16,466348,27
"17079","글래스","2019-02-13","1",9,466357,28
"17080","글래스","2019-02-14","1",11,466368,29
"17081","글래스","2019-02-15","1",11,466379,30
"17082","글래스","2019-02-16","1",28,466407,31
"17083","글래스","2019-02-17","1",41,466448,32
"17084","글래스","2019-02-18","1",9,466457,33
"17085","글래스","2019-02-19","1",12,466469,34
"17086","글래스","2019-02-20","1",6,466475,35
"17087","해피 데스데이 2 유","2019-02-13","3",214,214,0
"17088","해피 데스데이 2 유","2019-02-14","612",72440,72654,1
"17089","해피 데스데이 2 유","2019-02-15","635",57716,130370,2
"17090","해피 데스데이 2 유","2019-02-16","657",86488,216858,3
"17091","해피 데스데이 2 유","2019-02-17","629",71284,288142,4
"17092","해피 데스데이 2 유","2019-02-18","585",29529,317671,5
"17093","해피 데스데이 2 유","2019-02-19","590",25667,343338,6
"17094","해피 데스데이 2 유","2019-02-20","371",11279,354617,7
"17095","해피 데스데이 2 유","2019-02-21","319",8629,363246,8
"17096","해피 데스데이 2 유","2019-02-22","305",8453,371699,9
"17097","해피 데스데이 2 유","2019-02-23","293",11100,382799,10
"17098","해피 데스데이 2 유","2019-02-24","295",9598,392397,11
"17099","해피 데스데이 2 유","2019-02-25","290",5746,398143,12
"17100","해피 데스데이 2 유","2019-02-26","289",5425,403568,13
"17101","해피 데스데이 2 유","2019-02-27","60",1674,405242,14
"17102","해피 데스데이 2 유","2019-02-28","51",1369,406611,15
"17103","해피 데스데이 2 유","2019-03-01","49",1737,408348,16
"17104","해피 데스데이 2 유","2019-03-02","47",1491,409839,17
"17105","해피 데스데이 2 유","2019-03-03","46",1160,410999,18
"17106","해피 데스데이 2 유","2019-03-04","39",401,411400,19
"17107","해피 데스데이 2 유","2019-03-05","43",420,411820,20
"17108","해피 데스데이 2 유","2019-03-06","1",3,411823,21
"17109","해피 데스데이 2 유","2019-03-07","2",8,411831,22
"17110","해피 데스데이 2 유","2019-03-08","2",7,411838,23
"17111","해피 데스데이 2 유","2019-03-09","2",25,411863,24
"17112","해피 데스데이 2 유","2019-03-10","2",21,411884,25
"17113","해피 데스데이 2 유","2019-03-12","1",6,411890,26
"17114","해피 데스데이 2 유","2019-03-14","5",300,412190,27
"17115","해피 데스데이 2 유","2019-03-15","1",60,412250,28
"17116","해피 데스데이 2 유","2019-03-16","1",60,412310,29
"17117","해피 데스데이 2 유","2019-03-17","1",60,412370,30
"17118","해피 데스데이 2 유","2019-03-18","1",60,412430,31
"17119","해피 데스데이 2 유","2019-03-19","1",60,412490,32
"17120","해피 데스데이 2 유","2019-03-20","1",60,412550,33
"17121","해피 데스데이 2 유","2019-03-21","1",60,412610,34
"17122","해피 데스데이 2 유","2019-03-22","1",60,412670,35
"17123","해피 데스데이 2 유","2019-03-23","1",60,412730,36
"17124","그린 북","2018-12-07","1",48,48,0
"17125","그린 북","2018-12-09","1",98,146,0
"17126","그린 북","2018-12-10","1",142,288,0
"17127","그린 북","2018-12-14","1",30,318,0
"17128","그린 북","2018-12-18","1",204,522,0
"17129","그린 북","2018-12-22","8",373,895,0
"17130","그린 북","2018-12-23","3",136,1031,0
"17131","그린 북","2018-12-24","5",269,1300,0
"17132","그린 북","2018-12-25","5",391,1691,0
"17133","그린 북","2018-12-27","2",514,2205,0
"17134","그린 북","2018-12-28","4",436,2641,0
"17135","그린 북","2018-12-29","15",783,3424,0
"17136","그린 북","2018-12-30","8",549,3973,0
"17137","그린 북","2018-12-31","2",128,4101,0
"17138","그린 북","2019-01-01","9",606,4707,0
"17139","그린 북","2019-01-03","6",1240,5947,0
"17140","그린 북","2019-01-04","4",902,6849,0
"17141","그린 북","2019-01-05","1",38,6887,0
"17142","그린 북","2019-01-07","11",2651,9538,0
"17143","그린 북","2019-01-08","2",513,10051,0
"17144","그린 북","2019-01-09","349",12416,22467,1
"17145","그린 북","2019-01-10","398",11461,33928,2
"17146","그린 북","2019-01-11","372",13264,47192,3
"17147","그린 북","2019-01-12","373",26917,74109,4
"17148","그린 북","2019-01-13","369",25460,99569,5
"17149","그린 북","2019-01-14","366",11366,110935,6
"17150","그린 북","2019-01-15","383",12316,123251,7
"17151","그린 북","2019-01-16","190",7989,131240,8
"17152","그린 북","2019-01-17","197",6324,137564,9
"17153","그린 북","2019-01-18","219",7373,144937,10
"17154","그린 북","2019-01-19","218",14763,159700,11
"17155","그린 북","2019-01-20","213",13548,173248,12
"17156","그린 북","2019-01-21","210",5876,179124,13
"17157","그린 북","2019-01-22","220",5632,184756,14
"17158","그린 북","2019-01-23","142",4499,189255,15
"17159","그린 북","2019-01-24","137",3780,193035,16
"17160","그린 북","2019-01-25","137",3866,196901,17
"17161","그린 북","2019-01-26","129",7285,204186,18
"17162","그린 북","2019-01-27","124",6466,210652,19
"17163","그린 북","2019-01-28","134",3598,214250,20
"17164","그린 북","2019-01-29","137",4134,218384,21
"17165","그린 북","2019-01-30","58",3227,221611,22
"17166","그린 북","2019-01-31","60",2164,223775,23
"17167","그린 북","2019-02-01","89",3750,227525,24
"17168","그린 북","2019-02-02","82",6293,233818,25
"17169","그린 북","2019-02-03","83",6550,240368,26
"17170","그린 북","2019-02-04","86",6841,247209,27
"17171","그린 북","2019-02-05","80",6278,253487,28
"17172","그린 북","2019-02-06","81",6652,260139,29
"17173","그린 북","2019-02-07","73",2755,262894,30
"17174","그린 북","2019-02-08","68",2995,265889,31
"17175","그린 북","2019-02-09","66",5592,271481,32
"17176","그린 북","2019-02-10","72",5926,277407,33
"17177","그린 북","2019-02-11","63",1929,279336,34
"17178","그린 북","2019-02-12","74",2592,281928,35
"17179","그린 북","2019-02-13","53",1767,283695,36
"17180","그린 북","2019-02-14","41",1479,285174,37
"17181","그린 북","2019-02-15","56",2155,287329,38
"17182","그린 북","2019-02-16","46",3490,290819,39
"17183","그린 북","2019-02-17","57",4025,294844,40
"17184","그린 북","2019-02-18","44",1372,296216,41
"17185","그린 북","2019-02-19","52",1806,298022,42
"17186","그린 북","2019-02-20","44",1435,299457,43
"17187","그린 북","2019-02-21","35",867,300324,44
"17188","그린 북","2019-02-22","38",1041,301365,45
"17189","그린 북","2019-02-23","40",2164,303529,46
"17190","그린 북","2019-02-24","43",1970,305499,47
"17191","그린 북","2019-02-25","28",987,306486,48
"17192","그린 북","2019-02-26","36",2233,308719,49
"17193","그린 북","2019-02-27","45",2478,311197,50
"17194","그린 북","2019-02-28","54",3522,314719,51
"17195","그린 북","2019-03-01","131",10302,325021,52
"17196","그린 북","2019-03-02","147",10469,335490,53
"17197","그린 북","2019-03-03","148",8146,343636,54
"17198","그린 북","2019-03-04","129",3254,346890,55
"17199","그린 북","2019-03-05","145",3965,350855,56
"17200","그린 북","2019-03-06","87",2138,352993,57
"17201","그린 북","2019-03-07","85",2643,355636,58
"17202","그린 북","2019-03-08","91",3098,358734,59
"17203","그린 북","2019-03-09","121",7293,366027,60
"17204","그린 북","2019-03-10","114",6266,372293,61
"17205","그린 북","2019-03-11","114",2761,375054,62
"17206","그린 북","2019-03-12","119",2725,377779,63
"17207","그린 북","2019-03-13","130",3232,381011,64
"17208","그린 북","2019-03-14","78",1674,382685,65
"17209","그린 북","2019-03-15","82",2344,385029,66
"17210","그린 북","2019-03-16","84",5137,390166,67
"17211","그린 북","2019-03-17","81",4215,394381,68
"17212","그린 북","2019-03-18","73",2074,396455,69
"17213","그린 북","2019-03-19","81",2088,398543,70
"17214","그린 북","2019-03-20","48",1378,399921,71
"17215","그린 북","2019-03-21","51",1203,401124,72
"17216","그린 북","2019-03-22","56",1644,402768,73
"17217","그린 북","2019-03-23","57",3802,406570,74
"17259","신데렐라:마법 반지의 비밀","2019-02-12","2",663,663,0
"17260","신데렐라:마법 반지의 비밀","2019-02-13","3",846,1509,0
"17261","신데렐라:마법 반지의 비밀","2019-02-18","14",1443,2952,0
"17262","신데렐라:마법 반지의 비밀","2019-02-19","13",1434,4386,0
"17263","신데렐라:마법 반지의 비밀","2019-02-20","403",14382,18768,1
"17264","신데렐라:마법 반지의 비밀","2019-02-21","414",15342,34110,2
"17265","신데렐라:마법 반지의 비밀","2019-02-22","461",18481,52591,3
"17266","신데렐라:마법 반지의 비밀","2019-02-23","568",40730,93321,4
"17267","신데렐라:마법 반지의 비밀","2019-02-24","575",39830,133151,5
"17268","신데렐라:마법 반지의 비밀","2019-02-25","466",19068,152219,6
"17269","신데렐라:마법 반지의 비밀","2019-02-26","470",21893,174112,7
"17270","신데렐라:마법 반지의 비밀","2019-02-27","334",16135,190247,8
"17271","신데렐라:마법 반지의 비밀","2019-02-28","352",16434,206681,9
"17272","신데렐라:마법 반지의 비밀","2019-03-01","449",26834,233515,10
"17273","신데렐라:마법 반지의 비밀","2019-03-02","443",18739,252254,11
"17274","신데렐라:마법 반지의 비밀","2019-03-03","441",15065,267319,12
"17275","신데렐라:마법 반지의 비밀","2019-03-04","260",2895,270214,13
"17276","신데렐라:마법 반지의 비밀","2019-03-05","209",1219,271433,14
"17277","신데렐라:마법 반지의 비밀","2019-03-06","64",330,271763,15
"17278","신데렐라:마법 반지의 비밀","2019-03-07","44",199,271962,16
"17279","신데렐라:마법 반지의 비밀","2019-03-08","47",215,272177,17
"17280","신데렐라:마법 반지의 비밀","2019-03-09","173",4275,276452,18
"17281","신데렐라:마법 반지의 비밀","2019-03-10","169",5253,281705,19
"17282","신데렐라:마법 반지의 비밀","2019-03-11","46",175,281880,20
"17283","신데렐라:마법 반지의 비밀","2019-03-12","47",164,282044,21
"17284","신데렐라:마법 반지의 비밀","2019-03-13","39",132,282176,22
"17285","신데렐라:마법 반지의 비밀","2019-03-14","8",27,282203,23
"17286","신데렐라:마법 반지의 비밀","2019-03-15","8",62,282265,24
"17287","신데렐라:마법 반지의 비밀","2019-03-16","39",913,283178,25
"17288","신데렐라:마법 반지의 비밀","2019-03-17","39",717,283895,26
"17289","신데렐라:마법 반지의 비밀","2019-03-18","11",26,283921,27
"17290","신데렐라:마법 반지의 비밀","2019-03-19","7",17,283938,28
"17291","신데렐라:마법 반지의 비밀","2019-03-20","2",9,283947,29
"17292","신데렐라:마법 반지의 비밀","2019-03-21","2",9,283956,30
"17293","신데렐라:마법 반지의 비밀","2019-03-22","4",40,283996,31
"17294","신데렐라:마법 반지의 비밀","2019-03-23","8",167,284163,32
"17295","메리 포핀스 리턴즈","2019-02-01","1",282,282,0
"17296","메리 포핀스 리턴즈","2019-02-08","5",905,1187,0
"17297","메리 포핀스 리턴즈","2019-02-13","1",5,1192,0
"17298","메리 포핀스 리턴즈","2019-02-14","558",27117,28309,1
"17299","메리 포핀스 리턴즈","2019-02-15","557",22072,50381,2
"17300","메리 포핀스 리턴즈","2019-02-16","573",43130,93511,3
"17301","메리 포핀스 리턴즈","2019-02-17","560",36980,130491,4
"17302","메리 포핀스 리턴즈","2019-02-18","508",13657,144148,5
"17303","메리 포핀스 리턴즈","2019-02-19","508",14203,158351,6
"17304","메리 포핀스 리턴즈","2019-02-20","292",7646,165997,7
"17305","메리 포핀스 리턴즈","2019-02-21","257",6798,172795,8
"17306","메리 포핀스 리턴즈","2019-02-22","250",6195,178990,9
"17307","메리 포핀스 리턴즈","2019-02-23","266",11000,189990,10
"17308","메리 포핀스 리턴즈","2019-02-24","263",9529,199519,11
"17309","메리 포핀스 리턴즈","2019-02-25","242",4809,204328,12
"17310","메리 포핀스 리턴즈","2019-02-26","244",5886,210214,13
"17311","메리 포핀스 리턴즈","2019-02-27","51",2462,212676,14
"17312","메리 포핀스 리턴즈","2019-02-28","37",1992,214668,15
"17313","메리 포핀스 리턴즈","2019-03-01","35",2739,217407,16
"17314","메리 포핀스 리턴즈","2019-03-02","30",2008,219415,17
"17315","메리 포핀스 리턴즈","2019-03-03","34",1550,220965,18
"17316","메리 포핀스 리턴즈","2019-03-04","29",403,221368,19
"17317","메리 포핀스 리턴즈","2019-03-05","29",401,221769,20
"17318","메리 포핀스 리턴즈","2019-03-06","13",145,221914,21
"17319","메리 포핀스 리턴즈","2019-03-07","14",154,222068,22
"17320","메리 포핀스 리턴즈","2019-03-08","12",97,222165,23
"17321","메리 포핀스 리턴즈","2019-03-09","13",136,222301,24
"17322","메리 포핀스 리턴즈","2019-03-10","13",286,222587,25
"17323","메리 포핀스 리턴즈","2019-03-11","11",77,222664,26
"17324","메리 포핀스 리턴즈","2019-03-12","12",83,222747,27
"17325","메리 포핀스 리턴즈","2019-03-13","13",99,222846,28
"17326","메리 포핀스 리턴즈","2019-03-14","12",74,222920,29
"17327","메리 포핀스 리턴즈","2019-03-15","10",69,222989,30
"17328","메리 포핀스 리턴즈","2019-03-16","11",156,223145,31
"17329","메리 포핀스 리턴즈","2019-03-17","11",81,223226,32
"17330","메리 포핀스 리턴즈","2019-03-18","11",83,223309,33
"17331","메리 포핀스 리턴즈","2019-03-19","11",89,223398,34
"17332","메리 포핀스 리턴즈","2019-03-20","10",62,223460,35
"17333","메리 포핀스 리턴즈","2019-03-21","10",50,223510,36
"17334","메리 포핀스 리턴즈","2019-03-22","10",50,223560,37
"17335","메리 포핀스 리턴즈","2019-03-23","10",50,223610,38
"17336","더 페이버릿: 여왕의 여자","2019-02-05","10",773,773,0
"17337","더 페이버릿: 여왕의 여자","2019-02-06","9",730,1503,0
"17338","더 페이버릿: 여왕의 여자","2019-02-08","11",603,2106,0
"17339","더 페이버릿: 여왕의 여자","2019-02-09","11",823,2929,0
"17340","더 페이버릿: 여왕의 여자","2019-02-14","11",604,3533,0
"17341","더 페이버릿: 여왕의 여자","2019-02-15","18",1895,5428,0
"17342","더 페이버릿: 여왕의 여자","2019-02-16","12",1276,6704,0
"17343","더 페이버릿: 여왕의 여자","2019-02-17","1",393,7097,0
"17344","더 페이버릿: 여왕의 여자","2019-02-21","73",5902,12999,1
"17345","더 페이버릿: 여왕의 여자","2019-02-22","79",6194,19193,2
"17346","더 페이버릿: 여왕의 여자","2019-02-23","81",10283,29476,3
"17347","더 페이버릿: 여왕의 여자","2019-02-24","83",10029,39505,4
"17348","더 페이버릿: 여왕의 여자","2019-02-25","79",6471,45976,5
"17349","더 페이버릿: 여왕의 여자","2019-02-26","78",8122,54098,6
"17350","더 페이버릿: 여왕의 여자","2019-02-27","73",9798,63896,7
"17351","더 페이버릿: 여왕의 여자","2019-02-28","83",7086,70982,8
"17352","더 페이버릿: 여왕의 여자","2019-03-01","114",13111,84093,9
"17353","더 페이버릿: 여왕의 여자","2019-03-02","128",11912,96005,10
"17354","더 페이버릿: 여왕의 여자","2019-03-03","120",8911,104916,11
"17355","더 페이버릿: 여왕의 여자","2019-03-04","110",4268,109184,12
"17356","더 페이버릿: 여왕의 여자","2019-03-05","111",4055,113239,13
"17357","더 페이버릿: 여왕의 여자","2019-03-06","88",3273,116512,14
"17358","더 페이버릿: 여왕의 여자","2019-03-07","88",2773,119285,15
"17359","더 페이버릿: 여왕의 여자","2019-03-08","93",3629,122914,16
"17360","더 페이버릿: 여왕의 여자","2019-03-09","83",5932,128846,17
"17361","더 페이버릿: 여왕의 여자","2019-03-10","84",4662,133508,18
"17362","더 페이버릿: 여왕의 여자","2019-03-11","90",2409,135917,19
"17363","더 페이버릿: 여왕의 여자","2019-03-12","92",2347,138264,20
"17364","더 페이버릿: 여왕의 여자","2019-03-13","91",2411,140675,21
"17365","더 페이버릿: 여왕의 여자","2019-03-14","69",1469,142144,22
"17366","더 페이버릿: 여왕의 여자","2019-03-15","75",1907,144051,23
"17367","더 페이버릿: 여왕의 여자","2019-03-16","72",3238,147289,24
"17368","더 페이버릿: 여왕의 여자","2019-03-17","77",2600,149889,25
"17369","더 페이버릿: 여왕의 여자","2019-03-18","71",1219,151108,26
"17370","더 페이버릿: 여왕의 여자","2019-03-19","74",1445,152553,27
"17371","더 페이버릿: 여왕의 여자","2019-03-20","53",927,153480,28
"17372","더 페이버릿: 여왕의 여자","2019-03-21","38",772,154252,29
"17373","더 페이버릿: 여왕의 여자","2019-03-22","38",880,155132,30
"17374","더 페이버릿: 여왕의 여자","2019-03-23","39",1560,156692,31
"17375","가버나움","2018-12-29","4",232,232,0
"17376","가버나움","2018-12-30","5",260,492,0
"17377","가버나움","2018-12-31","2",135,627,0
"17378","가버나움","2019-01-01","8",386,1013,0
"17379","가버나움","2019-01-08","1",335,1348,0
"17380","가버나움","2019-01-16","2",507,1855,0
"17381","가버나움","2019-01-17","2",242,2097,0
"17382","가버나움","2019-01-20","1",114,2211,0
"17383","가버나움","2019-01-21","1",44,2255,0
"17384","가버나움","2019-01-22","1",134,2389,0
"17385","가버나움","2019-01-23","1",0,2389,0
"17386","가버나움","2019-01-24","111",4442,6831,1
"17387","가버나움","2019-01-25","108",3560,10391,2
"17388","가버나움","2019-01-26","105",5975,16366,3
"17389","가버나움","2019-01-27","105",5503,21869,4
"17390","가버나움","2019-01-28","101",4067,25936,5
"17391","가버나움","2019-01-29","111",4470,30406,6
"17392","가버나움","2019-01-30","76",5168,35574,7
"17393","가버나움","2019-01-31","64",3329,38903,8
"17394","가버나움","2019-02-01","64",3391,42294,9
"17395","가버나움","2019-02-02","67",5628,47922,10
"17396","가버나움","2019-02-03","68",6079,54001,11
"17397","가버나움","2019-02-04","61",6102,60103,12
"17398","가버나움","2019-02-05","55",4827,64930,13
"17399","가버나움","2019-02-06","64",6168,71098,14
"17400","가버나움","2019-02-07","80",3110,74208,15
"17401","가버나움","2019-02-08","67",3042,77250,16
"17402","가버나움","2019-02-09","67",5302,82552,17
"17403","가버나움","2019-02-10","79",5235,87787,18
"17404","가버나움","2019-02-11","68",2292,90079,19
"17405","가버나움","2019-02-12","97",4446,94525,20
"17406","가버나움","2019-02-13","61",2167,96692,21
"17407","가버나움","2019-02-14","59",1990,98682,22
"17408","가버나움","2019-02-15","68",2523,101205,23
"17409","가버나움","2019-02-16","62",3923,105128,24
"17410","가버나움","2019-02-17","72",4069,109197,25
"17411","가버나움","2019-02-18","55",1724,110921,26
"17412","가버나움","2019-02-19","70",2253,113174,27
"17413","가버나움","2019-02-20","59",2030,115204,28
"17414","가버나움","2019-02-21","58",1652,116856,29
"17415","가버나움","2019-02-22","50",1248,118104,30
"17416","가버나움","2019-02-23","54",2175,120279,31
"17417","가버나움","2019-02-24","58",2083,122362,32
"17418","가버나움","2019-02-25","47",1022,123384,33
"17419","가버나움","2019-02-26","50",1135,124519,34
"17420","가버나움","2019-02-27","42",1230,125749,35
"17421","가버나움","2019-02-28","31",629,126378,36
"17422","가버나움","2019-03-01","38",1661,128039,37
"17423","가버나움","2019-03-02","40",1502,129541,38
"17424","가버나움","2019-03-03","32",1158,130699,39
"17425","가버나움","2019-03-04","26",502,131201,40
"17426","가버나움","2019-03-05","28",589,131790,41
"17427","가버나움","2019-03-06","29",533,132323,42
"17428","가버나움","2019-03-07","16",377,132700,43
"17429","가버나움","2019-03-08","17",356,133056,44
"17430","가버나움","2019-03-09","22",809,133865,45
"17431","가버나움","2019-03-10","24",1091,134956,46
"17432","가버나움","2019-03-11","14",304,135260,47
"17433","가버나움","2019-03-12","17",401,135661,48
"17434","가버나움","2019-03-13","21",396,136057,49
"17435","가버나움","2019-03-14","11",272,136329,50
"17436","가버나움","2019-03-15","16",317,136646,51
"17437","가버나움","2019-03-16","16",446,137092,52
"17438","가버나움","2019-03-17","19",472,137564,53
"17439","가버나움","2019-03-18","12",220,137784,54
"17440","가버나움","2019-03-19","13",157,137941,55
"17441","가버나움","2019-03-20","12",136,138077,56
"17442","가버나움","2019-03-21","11",227,138304,57
"17443","가버나움","2019-03-22","15",341,138645,58
"17444","가버나움","2019-03-23","15",365,139010,59
"17445","해리포터와 비밀의 방","2019-02-18","1",112,112,0
"17446","해리포터와 비밀의 방","2019-02-19","33",3892,4004,0
"17447","해리포터와 비밀의 방","2019-02-20","33",15433,19437,0
"17448","해리포터와 비밀의 방","2019-02-21","33",13537,32974,0
"17449","해리포터와 비밀의 방","2019-02-22","33",13715,46689,0
"17450","해리포터와 비밀의 방","2019-02-23","33",17148,63837,0
"17451","해리포터와 비밀의 방","2019-02-24","33",15464,79301,0
"17452","해리포터와 비밀의 방","2019-02-25","33",7600,86901,0
"17453","해리포터와 비밀의 방","2019-02-26","33",7034,93935,0
"17454","해리포터와 비밀의 방","2019-02-27","33",8661,102596,0
"17455","해리포터와 비밀의 방","2019-02-28","33",5984,108580,0
"17456","해리포터와 비밀의 방","2019-03-01","33",10225,118805,0
"17457","해리포터와 비밀의 방","2019-03-02","33",7953,126758,0
"17458","해리포터와 비밀의 방","2019-03-03","33",6072,132830,0
"17459","해리포터와 비밀의 방","2019-03-04","33",1779,134609,0
"17460","해리포터와 비밀의 방","2019-03-05","33",1787,136396,0
"17461","해리포터와 비밀의 방","2019-03-06","5",145,136541,0
"17462","해리포터와 비밀의 방","2019-03-07","5",194,136735,0
"17463","해리포터와 비밀의 방","2019-03-08","5",324,137059,0
"17464","해리포터와 비밀의 방","2019-03-09","4",237,137296,0
"17465","해리포터와 비밀의 방","2019-03-10","4",252,137548,0
"17466","해리포터와 비밀의 방","2019-03-11","2",82,137630,0
"17467","해리포터와 비밀의 방","2019-03-12","2",58,137688,0
"17468","해리포터와 비밀의 방","2019-03-13","2",100,137788,0
"17469","명탐정 코난:전율의 악보","2019-02-13","3",612,612,0
"17470","명탐정 코난:전율의 악보","2019-02-14","207",27534,28146,1
"17471","명탐정 코난:전율의 악보","2019-02-15","198",12279,40425,2
"17472","명탐정 코난:전율의 악보","2019-02-16","208",22683,63108,3
"17473","명탐정 코난:전율의 악보","2019-02-17","213",20268,83376,4
"17474","명탐정 코난:전율의 악보","2019-02-18","175",5377,88753,5
"17475","명탐정 코난:전율의 악보","2019-02-19","166",4723,93476,6
"17476","명탐정 코난:전율의 악보","2019-02-20","118",3081,96557,7
"17477","명탐정 코난:전율의 악보","2019-02-21","105",2822,99379,8
"17478","명탐정 코난:전율의 악보","2019-02-22","105",2370,101749,9
"17479","명탐정 코난:전율의 악보","2019-02-23","105",4622,106371,10
"17480","명탐정 코난:전율의 악보","2019-02-24","102",5100,111471,11
"17481","명탐정 코난:전율의 악보","2019-02-25","98",1823,113294,12
"17482","명탐정 코난:전율의 악보","2019-02-26","97",2268,115562,13
"17483","명탐정 코난:전율의 악보","2019-02-27","1",19,115581,14
"17484","명탐정 코난:전율의 악보","2019-03-04","20",416,115997,15
"17485","명탐정 코난:전율의 악보","2019-03-05","5",62,116059,16
"17486","미래의 미라이","2018-12-08","1",110,110,0
"17487","미래의 미라이","2018-12-21","1",332,442,0
"17488","미래의 미라이","2018-12-26","1",292,734,0
"17489","미래의 미라이","2018-12-27","2",613,1347,0
"17490","미래의 미라이","2018-12-28","1",224,1571,0
"17491","미래의 미라이","2019-01-09","5",1000,2571,0
"17492","미래의 미라이","2019-01-10","1",432,3003,0
"17493","미래의 미라이","2019-01-15","2",617,3620,0
"17494","미래의 미라이","2019-01-16","508",16169,19789,1
"17495","미래의 미라이","2019-01-17","483",11170,30959,2
"17496","미래의 미라이","2019-01-18","489",10241,41200,3
"17497","미래의 미라이","2019-01-19","490",19697,60897,4
"17498","미래의 미라이","2019-01-20","470",17088,77985,5
"17499","미래의 미라이","2019-01-21","429",6605,84590,6
"17500","미래의 미라이","2019-01-22","436",6591,91181,7
"17501","미래의 미라이","2019-01-23","152",2173,93354,8
"17502","미래의 미라이","2019-01-24","140",1955,95309,9
"17503","미래의 미라이","2019-01-25","141",1469,96778,10
"17504","미래의 미라이","2019-01-26","118",2405,99183,11
"17505","미래의 미라이","2019-01-27","112",2467,101650,12
"17506","미래의 미라이","2019-01-28","114",892,102542,13
"17507","미래의 미라이","2019-01-29","123",1263,103805,14
"17508","미래의 미라이","2019-01-30","11",165,103970,15
"17509","미래의 미라이","2019-01-31","8",114,104084,16
"17510","미래의 미라이","2019-02-01","8",80,104164,17
"17511","미래의 미라이","2019-02-02","5",86,104250,18
"17512","미래의 미라이","2019-02-03","3",64,104314,19
"17513","미래의 미라이","2019-02-04","5",102,104416,20
"17514","미래의 미라이","2019-02-05","10",155,104571,21
"17515","미래의 미라이","2019-02-06","4",62,104633,22
"17516","미래의 미라이","2019-02-07","2",35,104668,23
"17517","미래의 미라이","2019-02-08","1",1,104669,24
"17518","미래의 미라이","2019-02-09","3",92,104761,25
"17519","미래의 미라이","2019-02-10","4",97,104858,26
"17520","미래의 미라이","2019-02-11","7",128,104986,27
"17521","미래의 미라이","2019-02-12","1",4,104990,28
"17522","미래의 미라이","2019-02-13","2",34,105024,29
"17523","미래의 미라이","2019-02-14","2",24,105048,30
"17524","미래의 미라이","2019-02-15","1",8,105056,31
"17525","미래의 미라이","2019-02-16","1",9,105065,32
"17526","미래의 미라이","2019-02-17","1",7,105072,33
"17527","미래의 미라이","2019-02-18","1",3,105075,34
"17528","미래의 미라이","2019-02-20","2",18,105093,35
"17529","미래의 미라이","2019-02-23","1",1,105094,36
"17530","미래의 미라이","2019-02-24","1",10,105104,37
"17531","미래의 미라이","2019-03-04","5",39,105143,38
"17532","콜드 체이싱","2019-02-13","1",115,115,0
"17533","콜드 체이싱","2019-02-14","1",172,287,0
"17534","콜드 체이싱","2019-02-20","480",19775,20062,1
"17535","콜드 체이싱","2019-02-21","479",13161,33223,2
"17536","콜드 체이싱","2019-02-22","470",11867,45090,3
"17537","콜드 체이싱","2019-02-23","467",17615,62705,4
"17538","콜드 체이싱","2019-02-24","470",15598,78303,5
"17539","콜드 체이싱","2019-02-25","441",6281,84584,6
"17540","콜드 체이싱","2019-02-26","432",5721,90305,7
"17541","콜드 체이싱","2019-02-27","52",748,91053,8
"17542","콜드 체이싱","2019-02-28","47",429,91482,9
"17543","콜드 체이싱","2019-03-01","35",764,92246,10
"17544","콜드 체이싱","2019-03-02","36",526,92772,11
"17545","콜드 체이싱","2019-03-03","36",528,93300,12
"17546","콜드 체이싱","2019-03-04","33",180,93480,13
"17547","콜드 체이싱","2019-03-05","37",196,93676,14
"17548","콜드 체이싱","2019-03-06","5",57,93733,15
"17549","콜드 체이싱","2019-03-07","5",36,93769,16
"17550","콜드 체이싱","2019-03-08","6",71,93840,17
"17551","콜드 체이싱","2019-03-09","4",40,93880,18
"17552","콜드 체이싱","2019-03-10","6",64,93944,19
"17553","콜드 체이싱","2019-03-11","3",13,93957,20
"17554","콜드 체이싱","2019-03-12","3",15,93972,21
"17555","콜드 체이싱","2019-03-13","3",17,93989,22
"17556","콜드 체이싱","2019-03-14","2",14,94003,23
"17557","콜드 체이싱","2019-03-15","3",8,94011,24
"17558","콜드 체이싱","2019-03-16","4",23,94034,25
"17559","콜드 체이싱","2019-03-17","2",125,94159,26
"17560","콜드 체이싱","2019-03-18","2",206,94365,27
"17561","콜드 체이싱","2019-03-19","2",102,94467,28
"17562","콜드 체이싱","2019-03-20","3",304,94771,29
"17563","콜드 체이싱","2019-03-21","2",297,95068,30
"17564","콜드 체이싱","2019-03-22","2",301,95369,31
"17565","콜드 체이싱","2019-03-23","2",301,95670,32
"17566","구스 베이비","2018-12-26","1",30,30,0
"17567","구스 베이비","2018-12-31","1",30,60,0
"17568","구스 베이비","2019-01-02","5",1276,1336,0
"17569","구스 베이비","2019-01-15","2",202,1538,0
"17570","구스 베이비","2019-01-16","391",9482,11020,1
"17571","구스 베이비","2019-01-17","382",8754,19774,2
"17572","구스 베이비","2019-01-18","374",8254,28028,3
"17573","구스 베이비","2019-01-19","424",17673,45701,4
"17574","구스 베이비","2019-01-20","405",14804,60505,5
"17575","구스 베이비","2019-01-21","318",3395,63900,6
"17576","구스 베이비","2019-01-22","341",5336,69236,7
"17577","구스 베이비","2019-01-23","127",3121,72357,8
"17578","구스 베이비","2019-01-24","119",3219,75576,9
"17579","구스 베이비","2019-01-25","119",2745,78321,10
"17580","구스 베이비","2019-01-26","114",3710,82031,11
"17581","구스 베이비","2019-01-27","107",3079,85110,12
"17582","구스 베이비","2019-01-28","83",951,86061,13
"17583","구스 베이비","2019-01-29","80",1252,87313,14
"17584","구스 베이비","2019-01-30","14",822,88135,15
"17585","구스 베이비","2019-01-31","10",406,88541,16
"17586","구스 베이비","2019-02-01","7",366,88907,17
"17587","구스 베이비","2019-02-02","4",52,88959,18
"17588","구스 베이비","2019-02-03","4",37,88996,19
"17589","구스 베이비","2019-02-04","3",34,89030,20
"17590","구스 베이비","2019-02-05","2",12,89042,21
"17591","구스 베이비","2019-02-06","1",2,89044,22
"17592","구스 베이비","2019-02-07","2",170,89214,23
"17593","구스 베이비","2019-02-08","6",457,89671,24
"17594","구스 베이비","2019-02-11","5",393,90064,25
"17595","구스 베이비","2019-02-12","3",191,90255,26
"17596","구스 베이비","2019-02-13","6",382,90637,27
"17597","구스 베이비","2019-02-14","5",361,90998,28
"17598","구스 베이비","2019-02-15","3",304,91302,29
"17599","구스 베이비","2019-02-18","1",2,91304,30
"17600","구스 베이비","2019-02-20","2",120,91424,31
"17601","구스 베이비","2019-02-22","1",66,91490,32
"17602","라스트 미션","2019-02-28","1",172,172,0
"17603","라스트 미션","2019-03-06","1",255,427,0
"17604","라스트 미션","2019-03-07","4",880,1307,0
"17605","라스트 미션","2019-03-14","457",11599,12906,1
"17606","라스트 미션","2019-03-15","462",11582,24488,2
"17607","라스트 미션","2019-03-16","472",21534,46022,3
"17608","라스트 미션","2019-03-17","460",18292,64314,4
"17609","라스트 미션","2019-03-18","460",8243,72557,5
"17610","라스트 미션","2019-03-19","455",7829,80386,6
"17611","라스트 미션","2019-03-20","177",2010,82396,7
"17612","라스트 미션","2019-03-21","111",1915,84311,8
"17613","라스트 미션","2019-03-22","114",2032,86343,9
"17614","라스트 미션","2019-03-23","103",3801,90144,10
"17615","레고 무비2","2019-01-30","1",175,175,0
"17616","레고 무비2","2019-01-31","1",112,287,0
"17617","레고 무비2","2019-02-02","13",2242,2529,0
"17618","레고 무비2","2019-02-06","442",23045,25574,1
"17619","레고 무비2","2019-02-07","408",5639,31213,2
"17620","레고 무비2","2019-02-08","379",5610,36823,3
"17621","레고 무비2","2019-02-09","414",16994,53817,4
"17622","레고 무비2","2019-02-10","403",17213,71030,5
"17623","레고 무비2","2019-02-11","329",2764,73794,6
"17624","레고 무비2","2019-02-12","340",4116,77910,7
"17625","레고 무비2","2019-02-13","99",1457,79367,8
"17626","레고 무비2","2019-02-14","56",1052,80419,9
"17627","레고 무비2","2019-02-15","55",987,81406,10
"17628","레고 무비2","2019-02-16","53",1861,83267,11
"17629","레고 무비2","2019-02-17","52",2033,85300,12
"17630","레고 무비2","2019-02-18","38",543,85843,13
"17631","레고 무비2","2019-02-19","37",624,86467,14
"17632","레고 무비2","2019-02-20","7",157,86624,15
"17633","레고 무비2","2019-02-21","4",87,86711,16
"17634","레고 무비2","2019-02-22","4",187,86898,17
"17635","레고 무비2","2019-02-23","7",226,87124,18
"17636","레고 무비2","2019-02-24","9",283,87407,19
"17637","레고 무비2","2019-02-25","3",72,87479,20
"17638","레고 무비2","2019-02-26","5",106,87585,21
"17639","레고 무비2","2019-02-27","1",6,87591,22
"17640","레고 무비2","2019-03-01","1",105,87696,23
"17641","레고 무비2","2019-03-02","2",87,87783,24
"17642","레고 무비2","2019-03-03","1",74,87857,25
"17643","레고 무비2","2019-03-16","1",3,87860,26
"17644","레고 무비2","2019-03-17","1",2,87862,27
"17645","레고 무비2","2019-03-20","3",497,88359,28
"17834","슈퍼미니 2","2019-02-20","3",530,530,0
"17835","슈퍼미니 2","2019-02-25","1",100,630,0
"17836","슈퍼미니 2","2019-02-26","13",1626,2256,0
"17837","슈퍼미니 2","2019-02-27","309",7596,9852,1
"17838","슈퍼미니 2","2019-02-28","315",8047,17899,2
"17839","슈퍼미니 2","2019-03-01","345",11459,29358,3
"17840","슈퍼미니 2","2019-03-02","331",7595,36953,4
"17841","슈퍼미니 2","2019-03-03","328",6277,43230,5
"17842","슈퍼미니 2","2019-03-04","186",1284,44514,6
"17843","슈퍼미니 2","2019-03-05","137",625,45139,7
"17844","슈퍼미니 2","2019-03-06","25",82,45221,8
"17845","슈퍼미니 2","2019-03-07","15",52,45273,9
"17846","슈퍼미니 2","2019-03-08","16",98,45371,10
"17847","슈퍼미니 2","2019-03-09","49",753,46124,11
"17848","슈퍼미니 2","2019-03-10","47",652,46776,12
"17849","슈퍼미니 2","2019-03-11","8",14,46790,13
"17850","슈퍼미니 2","2019-03-12","13",42,46832,14
"17851","슈퍼미니 2","2019-03-13","12",39,46871,15
"17852","슈퍼미니 2","2019-03-14","7",1091,47962,16
"17853","슈퍼미니 2","2019-03-15","11",462,48424,17
"17854","슈퍼미니 2","2019-03-16","11",108,48532,18
"17855","슈퍼미니 2","2019-03-17","11",132,48664,19
"17856","슈퍼미니 2","2019-03-18","3",8,48672,20
"17857","슈퍼미니 2","2019-03-19","2",7,48679,21
"17858","슈퍼미니 2","2019-03-20","3",33,48712,22
"17859","슈퍼미니 2","2019-03-21","2",45,48757,23
"17860","슈퍼미니 2","2019-03-22","1",15,48772,24
"17861","슈퍼미니 2","2019-03-23","3",33,48805,25
"17862","쿠르스크","2019-01-02","10",2379,2379,0
"17863","쿠르스크","2019-01-03","10",2193,4572,0
"17864","쿠르스크","2019-01-07","1",414,4986,0
"17865","쿠르스크","2019-01-08","23",3122,8108,0
"17866","쿠르스크","2019-01-09","1",279,8387,0
"17867","쿠르스크","2019-01-10","2",450,8837,0
"17868","쿠르스크","2019-01-14","10",1968,10805,0
"17869","쿠르스크","2019-01-16","192",5950,16755,1
"17870","쿠르스크","2019-01-17","172",3741,20496,2
"17871","쿠르스크","2019-01-18","173",3727,24223,3
"17872","쿠르스크","2019-01-19","176",6085,30308,4
"17873","쿠르스크","2019-01-20","176",5009,35317,5
"17874","쿠르스크","2019-01-21","177",2255,37572,6
"17875","쿠르스크","2019-01-22","172",2148,39720,7
"17876","쿠르스크","2019-01-23","47",372,40092,8
"17877","쿠르스크","2019-01-24","37",338,40430,9
"17878","쿠르스크","2019-01-25","34",249,40679,10
"17879","쿠르스크","2019-01-26","21",270,40949,11
"17880","쿠르스크","2019-01-27","19",242,41191,12
"17881","쿠르스크","2019-01-28","23",199,41390,13
"17882","쿠르스크","2019-01-29","24",204,41594,14
"17883","쿠르스크","2019-01-30","3",38,41632,15
"17884","쿠르스크","2019-01-31","4",49,41681,16
"17885","쿠르스크","2019-02-01","4",34,41715,17
"17886","쿠르스크","2019-02-02","4",81,41796,18
"17887","쿠르스크","2019-02-03","4",96,41892,19
"17888","쿠르스크","2019-02-04","5",153,42045,20
"17889","쿠르스크","2019-02-05","3",69,42114,21
"17890","쿠르스크","2019-02-06","4",228,42342,22
"17891","쿠르스크","2019-02-07","1",15,42357,23
"17892","쿠르스크","2019-02-08","3",42,42399,24
"17893","쿠르스크","2019-02-09","2",30,42429,25
"17894","쿠르스크","2019-02-10","2",22,42451,26
"17895","쿠르스크","2019-02-11","1",17,42468,27
"17896","쿠르스크","2019-02-12","1",5,42473,28
"17897","쿠르스크","2019-02-13","1",5,42478,29
"17898","쿠르스크","2019-02-16","1",1,42479,30
"17899","쿠르스크","2019-02-17","1",3,42482,31
"17900","쿠르스크","2019-02-18","1",2,42484,32
"17901","일일시호일","2019-01-09","2",343,343,0
"17902","일일시호일","2019-01-10","1",0,343,0
"17903","일일시호일","2019-01-12","2",126,469,0
"17904","일일시호일","2019-01-13","2",163,632,0
"17905","일일시호일","2019-01-14","1",266,898,0
"17906","일일시호일","2019-01-15","1",93,991,0
"17907","일일시호일","2019-01-17","55",1979,2970,1
"17908","일일시호일","2019-01-18","51",1495,4465,2
"17909","일일시호일","2019-01-19","54",2619,7084,3
"17910","일일시호일","2019-01-20","51",2398,9482,4
"17911","일일시호일","2019-01-21","50",1564,11046,5
"17912","일일시호일","2019-01-22","53",1694,12740,6
"17913","일일시호일","2019-01-23","53",1622,14362,7
"17914","일일시호일","2019-01-24","53",1446,15808,8
"17915","일일시호일","2019-01-25","52",1537,17345,9
"17916","일일시호일","2019-01-26","52",2425,19770,10
"17917","일일시호일","2019-01-27","51",2255,22025,11
"17918","일일시호일","2019-01-28","46",776,22801,12
"17919","일일시호일","2019-01-29","52",1003,23804,13
"17920","일일시호일","2019-01-30","46",1395,25199,14
"17921","일일시호일","2019-01-31","35",739,25938,15
"17922","일일시호일","2019-02-01","39",905,26843,16
"17923","일일시호일","2019-02-02","40",1469,28312,17
"17924","일일시호일","2019-02-03","39",1302,29614,18
"17925","일일시호일","2019-02-04","28",820,30434,19
"17926","일일시호일","2019-02-05","26",650,31084,20
"17927","일일시호일","2019-02-06","33",1333,32417,21
"17928","일일시호일","2019-02-07","27",458,32875,22
"17929","일일시호일","2019-02-08","24",475,33350,23
"17930","일일시호일","2019-02-09","28",912,34262,24
"17931","일일시호일","2019-02-10","27",858,35120,25
"17932","일일시호일","2019-02-11","20",270,35390,26
"17933","일일시호일","2019-02-12","22",481,35871,27
"17934","일일시호일","2019-02-13","24",441,36312,28
"17935","일일시호일","2019-02-14","16",194,36506,29
"17936","일일시호일","2019-02-15","19",261,36767,30
"17937","일일시호일","2019-02-16","18",343,37110,31
"17938","일일시호일","2019-02-17","24",548,37658,32
"17939","일일시호일","2019-02-18","16",182,37840,33
"17940","일일시호일","2019-02-19","19",242,38082,34
"17941","일일시호일","2019-02-20","19",327,38409,35
"17942","일일시호일","2019-02-21","7",92,38501,36
"17943","일일시호일","2019-02-22","9",162,38663,37
"17944","일일시호일","2019-02-23","12",280,38943,38
"17945","일일시호일","2019-02-24","9",190,39133,39
"17946","일일시호일","2019-02-25","6",121,39254,40
"17947","일일시호일","2019-02-26","13",252,39506,41
"17948","일일시호일","2019-02-27","5",123,39629,42
"17949","일일시호일","2019-02-28","7",121,39750,43
"17950","일일시호일","2019-03-01","5",86,39836,44
"17951","일일시호일","2019-03-02","6",174,40010,45
"17952","일일시호일","2019-03-03","9",116,40126,46
"17953","일일시호일","2019-03-04","2",17,40143,47
"17954","일일시호일","2019-03-05","4",27,40170,48
"17955","일일시호일","2019-03-06","5",73,40243,49
"17956","일일시호일","2019-03-07","3",14,40257,50
"17957","일일시호일","2019-03-08","4",62,40319,51
"17958","일일시호일","2019-03-09","5",44,40363,52
"17959","일일시호일","2019-03-10","5",151,40514,53
"17960","일일시호일","2019-03-11","3",32,40546,54
"17961","일일시호일","2019-03-12","4",49,40595,55
"17962","일일시호일","2019-03-13","3",28,40623,56
"17963","일일시호일","2019-03-14","2",19,40642,57
"17964","일일시호일","2019-03-15","2",48,40690,58
"17965","일일시호일","2019-03-16","4",38,40728,59
"17966","일일시호일","2019-03-17","4",62,40790,60
"17967","일일시호일","2019-03-18","3",85,40875,61
"17968","일일시호일","2019-03-19","2",21,40896,62
"17969","일일시호일","2019-03-20","3",57,40953,63
"17970","일일시호일","2019-03-21","3",15,40968,64
"17971","일일시호일","2019-03-22","2",16,40984,65
"17972","일일시호일","2019-03-23","2",51,41035,66
"17973","몬스터 파크","2019-01-17","2",263,263,0
"17974","몬스터 파크","2019-01-18","3",506,769,0
"17975","몬스터 파크","2019-01-21","2",56,825,0
"17976","몬스터 파크","2019-01-22","1",103,928,0
"17977","몬스터 파크","2019-01-23","295",4217,5145,1
"17978","몬스터 파크","2019-01-24","295",3898,9043,2
"17979","몬스터 파크","2019-01-25","304",4291,13334,3
"17980","몬스터 파크","2019-01-26","344",9459,22793,4
"17981","몬스터 파크","2019-01-27","316",7778,30571,5
"17982","몬스터 파크","2019-01-28","222",1540,32111,6
"17983","몬스터 파크","2019-01-29","231",1880,33991,7
"17984","몬스터 파크","2019-01-30","34",1086,35077,8
"17985","몬스터 파크","2019-01-31","10",457,35534,9
"17986","몬스터 파크","2019-02-01","11",327,35861,10
"17987","몬스터 파크","2019-02-02","7",94,35955,11
"17988","몬스터 파크","2019-02-03","8",84,36039,12
"17989","몬스터 파크","2019-02-04","6",85,36124,13
"17990","몬스터 파크","2019-02-05","4",29,36153,14
"17991","몬스터 파크","2019-02-06","2",9,36162,15
"17992","몬스터 파크","2019-02-07","2",59,36221,16
"17993","몬스터 파크","2019-02-08","9",300,36521,17
"17994","몬스터 파크","2019-02-10","1",24,36545,18
"17995","몬스터 파크","2019-02-11","3",193,36738,19
"17996","몬스터 파크","2019-02-12","4",229,36967,20
"17997","몬스터 파크","2019-02-13","2",82,37049,21
"17998","몬스터 파크","2019-02-14","4",226,37275,22
"17999","몬스터 파크","2019-02-15","3",136,37411,23
"18000","몬스터 파크","2019-02-19","2",438,37849,24
"18001","몬스터 파크","2019-02-20","2",384,38233,25
"18002","몬스터 파크","2019-02-21","1",23,38256,26
"18003","몬스터 파크","2019-03-20","1",6,38262,27
"18004","더 와이프","2019-02-03","9",585,585,0
"18005","더 와이프","2019-02-04","10",598,1183,0
"18006","더 와이프","2019-02-20","3",392,1575,0
"18007","더 와이프","2019-02-21","1",255,1830,0
"18008","더 와이프","2019-02-22","1",158,1988,0
"18009","더 와이프","2019-02-24","1",190,2178,0
"18010","더 와이프","2019-02-25","1",290,2468,0
"18011","더 와이프","2019-02-26","2",458,2926,0
"18012","더 와이프","2019-02-27","75",2259,5185,1
"18013","더 와이프","2019-02-28","106",2543,7728,2
"18014","더 와이프","2019-03-01","98",3509,11237,3
"18015","더 와이프","2019-03-02","98",3013,14250,4
"18016","더 와이프","2019-03-03","92",2627,16877,5
"18017","더 와이프","2019-03-04","85",1318,18195,6
"18018","더 와이프","2019-03-05","92",1559,19754,7
"18019","더 와이프","2019-03-06","53",1138,20892,8
"18020","더 와이프","2019-03-07","44",1074,21966,9
"18021","더 와이프","2019-03-08","49",1271,23237,10
"18022","더 와이프","2019-03-09","43",1804,25041,11
"18023","더 와이프","2019-03-10","48",1843,26884,12
"18024","더 와이프","2019-03-11","45",1055,27939,13
"18025","더 와이프","2019-03-12","51",1063,29002,14
"18026","더 와이프","2019-03-13","51",1122,30124,15
"18027","더 와이프","2019-03-14","40",769,30893,16
"18028","더 와이프","2019-03-15","44",789,31682,17
"18029","더 와이프","2019-03-16","43",1276,32958,18
"18030","더 와이프","2019-03-17","41",959,33917,19
"18031","더 와이프","2019-03-18","42",735,34652,20
"18032","더 와이프","2019-03-19","43",638,35290,21
"18033","더 와이프","2019-03-20","37",655,35945,22
"18034","더 와이프","2019-03-21","24",507,36452,23
"18035","더 와이프","2019-03-22","22",400,36852,24
"18036","더 와이프","2019-03-23","25",815,37667,25
"18037","드래곤볼 슈퍼: 브로리","2019-02-11","2",391,391,0
"18038","드래곤볼 슈퍼: 브로리","2019-02-14","202",7720,8111,1
"18039","드래곤볼 슈퍼: 브로리","2019-02-15","202",4501,12612,2
"18040","드래곤볼 슈퍼: 브로리","2019-02-16","201",8084,20696,3
"18041","드래곤볼 슈퍼: 브로리","2019-02-17","195",7034,27730,4
"18042","드래곤볼 슈퍼: 브로리","2019-02-18","188",2711,30441,5
"18043","드래곤볼 슈퍼: 브로리","2019-02-19","182",2589,33030,6
"18044","드래곤볼 슈퍼: 브로리","2019-02-20","57",558,33588,7
"18045","드래곤볼 슈퍼: 브로리","2019-02-21","17",200,33788,8
"18046","드래곤볼 슈퍼: 브로리","2019-02-22","20",317,34105,9
"18047","드래곤볼 슈퍼: 브로리","2019-02-23","21",495,34600,10
"18048","드래곤볼 슈퍼: 브로리","2019-02-24","19",425,35025,11
"18049","드래곤볼 슈퍼: 브로리","2019-02-25","18",164,35189,12
"18050","드래곤볼 슈퍼: 브로리","2019-02-26","17",172,35361,13
"18051","드래곤볼 슈퍼: 브로리","2019-02-27","3",52,35413,14
"18052","드래곤볼 슈퍼: 브로리","2019-02-28","1",45,35458,15
"18053","드래곤볼 슈퍼: 브로리","2019-03-01","1",43,35501,16
"18054","드래곤볼 슈퍼: 브로리","2019-03-02","2",77,35578,17
"18055","드래곤볼 슈퍼: 브로리","2019-03-03","2",54,35632,18
"18056","드래곤볼 슈퍼: 브로리","2019-03-04","1",10,35642,19
"18057","드래곤볼 슈퍼: 브로리","2019-03-05","1",17,35659,20
"18058","드래곤볼 슈퍼: 브로리","2019-03-06","1",3,35662,21
"18059","드래곤볼 슈퍼: 브로리","2019-03-07","1",10,35672,22
"18060","드래곤볼 슈퍼: 브로리","2019-03-08","1",6,35678,23
"18061","드래곤볼 슈퍼: 브로리","2019-03-09","1",25,35703,24
"18062","드래곤볼 슈퍼: 브로리","2019-03-10","1",28,35731,25
"18063","드래곤볼 슈퍼: 브로리","2019-03-11","1",5,35736,26
"18064","드래곤볼 슈퍼: 브로리","2019-03-12","1",13,35749,27
"18065","드래곤볼 슈퍼: 브로리","2019-03-23","1",120,35869,28
"18066","인생 후르츠","2018-11-15","2",524,524,0
"18067","인생 후르츠","2018-11-29","4",454,978,0
"18068","인생 후르츠","2018-12-05","1",31,1009,0
"18069","인생 후르츠","2018-12-06","32",537,1546,1
"18070","인생 후르츠","2018-12-07","32",803,2349,2
"18071","인생 후르츠","2018-12-08","31",1244,3593,3
"18072","인생 후르츠","2018-12-09","33",1538,5131,4
"18073","인생 후르츠","2018-12-10","29",889,6020,5
"18074","인생 후르츠","2018-12-11","29",873,6893,6
"18075","인생 후르츠","2018-12-12","31",957,7850,7
"18076","인생 후르츠","2018-12-13","38",882,8732,8
"18077","인생 후르츠","2018-12-14","41",883,9615,9
"18078","인생 후르츠","2018-12-15","45",1487,11102,10
"18079","인생 후르츠","2018-12-16","45",1840,12942,11
"18080","인생 후르츠","2018-12-17","52",1255,14197,12
"18081","인생 후르츠","2018-12-18","51",1301,15498,13
"18082","인생 후르츠","2018-12-19","43",1212,16710,14
"18083","인생 후르츠","2018-12-20","44",1101,17811,15
"18084","인생 후르츠","2018-12-21","45",1118,18929,16
"18085","인생 후르츠","2018-12-22","46",1582,20511,17
"18086","인생 후르츠","2018-12-23","46",1952,22463,18
"18087","인생 후르츠","2018-12-24","43",1508,23971,19
"18088","인생 후르츠","2018-12-25","49",2397,26368,20
"18089","인생 후르츠","2018-12-26","47",1207,27575,21
"18090","인생 후르츠","2018-12-27","40",1210,28785,22
"18091","인생 후르츠","2018-12-28","42",1175,29960,23
"18092","인생 후르츠","2018-12-29","42",1432,31392,24
"18093","인생 후르츠","2018-12-30","39",1434,32826,25
"18094","인생 후르츠","2018-12-31","43",1463,34289,26
"18095","인생 후르츠","2019-01-01","41",2146,36435,27
"18096","인생 후르츠","2019-01-02","46",1266,37701,28
"18097","인생 후르츠","2019-01-03","32",993,38694,29
"18098","인생 후르츠","2019-01-04","31",831,39525,30
"18099","인생 후르츠","2019-01-05","30",1407,40932,31
"18100","인생 후르츠","2019-01-06","33",1396,42328,32
"18101","인생 후르츠","2019-01-07","26",940,43268,33
"18102","인생 후르츠","2019-01-08","64",1770,45038,34
"18103","인생 후르츠","2019-01-09","30",881,45919,35
"18104","인생 후르츠","2019-01-10","29",752,46671,36
"18105","인생 후르츠","2019-01-11","28",846,47517,37
"18106","인생 후르츠","2019-01-12","32",1386,48903,38
"18107","인생 후르츠","2019-01-13","22",982,49885,39
"18108","인생 후르츠","2019-01-14","26",572,50457,40
"18109","인생 후르츠","2019-01-15","27",644,51101,41
"18110","인생 후르츠","2019-01-16","25",711,51812,42
"18111","인생 후르츠","2019-01-17","21",534,52346,43
"18112","인생 후르츠","2019-01-18","19",552,52898,44
"18113","인생 후르츠","2019-01-19","20",1235,54133,45
"18114","인생 후르츠","2019-01-20","19",1040,55173,46
"18115","인생 후르츠","2019-01-21","17",447,55620,47
"18116","인생 후르츠","2019-01-22","17",597,56217,48
"18117","인생 후르츠","2019-01-23","20",657,56874,49
"18118","인생 후르츠","2019-01-24","17",443,57317,50
"18119","인생 후르츠","2019-01-25","18",509,57826,51
"18120","인생 후르츠","2019-01-26","18",723,58549,52
"18121","인생 후르츠","2019-01-27","19",824,59373,53
"18122","인생 후르츠","2019-01-28","16",362,59735,54
"18123","인생 후르츠","2019-01-29","17",446,60181,55
"18124","인생 후르츠","2019-01-30","15",381,60562,56
"18125","인생 후르츠","2019-01-31","15",400,60962,57
"18126","인생 후르츠","2019-02-01","18",404,61366,58
"18127","인생 후르츠","2019-02-02","19",614,61980,59
"18128","인생 후르츠","2019-02-03","22",765,62745,60
"18129","인생 후르츠","2019-02-04","17",466,63211,61
"18130","인생 후르츠","2019-02-05","16",456,63667,62
"18131","인생 후르츠","2019-02-06","19",926,64593,63
"18132","인생 후르츠","2019-02-07","9",196,64789,64
"18133","인생 후르츠","2019-02-08","10",217,65006,65
"18134","인생 후르츠","2019-02-09","12",432,65438,66
"18135","인생 후르츠","2019-02-10","11",420,65858,67
"18136","인생 후르츠","2019-02-11","10",198,66056,68
"18137","인생 후르츠","2019-02-12","9",225,66281,69
"18138","인생 후르츠","2019-02-13","11",225,66506,70
"18139","인생 후르츠","2019-02-14","8",119,66625,71
"18140","인생 후르츠","2019-02-15","9",170,66795,72
"18141","인생 후르츠","2019-02-16","12",295,67090,73
"18142","인생 후르츠","2019-02-17","10",243,67333,74
"18143","인생 후르츠","2019-02-18","7",144,67477,75
"18144","인생 후르츠","2019-02-19","9",223,67700,76
"18145","인생 후르츠","2019-02-20","7",107,67807,77
"18146","인생 후르츠","2019-02-21","7",109,67916,78
"18147","인생 후르츠","2019-02-22","8",126,68042,79
"18148","인생 후르츠","2019-02-23","8",214,68256,80
"18149","인생 후르츠","2019-02-24","5",147,68403,81
"18150","인생 후르츠","2019-02-25","6",111,68514,82
"18151","인생 후르츠","2019-02-26","5",75,68589,83
"18152","인생 후르츠","2019-02-27","4",84,68673,84
"18153","인생 후르츠","2019-02-28","6",92,68765,85
"18154","인생 후르츠","2019-03-01","5",127,68892,86
"18155","인생 후르츠","2019-03-02","5",74,68966,87
"18156","인생 후르츠","2019-03-03","3",34,69000,88
"18157","인생 후르츠","2019-03-04","4",24,69024,89
"18158","인생 후르츠","2019-03-05","4",74,69098,90
"18159","인생 후르츠","2019-03-06","3",23,69121,91
"18160","인생 후르츠","2019-03-07","5",75,69196,92
"18161","인생 후르츠","2019-03-08","4",23,69219,93
"18162","인생 후르츠","2019-03-09","3",49,69268,94
"18163","인생 후르츠","2019-03-10","5",163,69431,95
"18164","인생 후르츠","2019-03-11","2",10,69441,96
"18165","인생 후르츠","2019-03-12","3",19,69460,97
"18166","인생 후르츠","2019-03-13","5",58,69518,98
"18167","인생 후르츠","2019-03-14","3",25,69543,99
"18168","인생 후르츠","2019-03-15","3",5,69548,100
"18169","인생 후르츠","2019-03-16","3",63,69611,101
"18170","인생 후르츠","2019-03-17","2",24,69635,102
"18171","인생 후르츠","2019-03-18","1",2,69637,103
"18172","인생 후르츠","2019-03-19","2",9,69646,104
"18173","인생 후르츠","2019-03-20","2",36,69682,105
"18174","인생 후르츠","2019-03-21","2",11,69693,106
"18175","인생 후르츠","2019-03-22","2",18,69711,107
"18176","인생 후르츠","2019-03-23","2",18,69729,108
"18177","빠삐용","2019-02-14","1",126,126,0
"18178","빠삐용","2019-02-21","1",268,394,0
"18179","빠삐용","2019-02-22","1",155,549,0
"18180","빠삐용","2019-02-25","1",72,621,0
"18181","빠삐용","2019-02-26","3",424,1045,0
"18182","빠삐용","2019-02-27","191",6666,7711,1
"18183","빠삐용","2019-02-28","187",5135,12846,2
"18184","빠삐용","2019-03-01","189",6076,18922,3
"18185","빠삐용","2019-03-02","184",5400,24322,4
"18186","빠삐용","2019-03-03","178",4206,28528,5
"18187","빠삐용","2019-03-04","183",2176,30704,6
"18188","빠삐용","2019-03-05","183",2055,32759,7
"18189","빠삐용","2019-03-06","18",192,32951,8
"18190","빠삐용","2019-03-07","14",186,33137,9
"18191","빠삐용","2019-03-08","15",203,33340,10
"18192","빠삐용","2019-03-09","10",207,33547,11
"18193","빠삐용","2019-03-10","11",179,33726,12
"18194","빠삐용","2019-03-11","9",132,33858,13
"18195","빠삐용","2019-03-12","12",142,34000,14
"18196","빠삐용","2019-03-13","12",132,34132,15
"18197","빠삐용","2019-03-14","3",34,34166,16
"18198","빠삐용","2019-03-15","3",30,34196,17
"18199","빠삐용","2019-03-16","5",90,34286,18
"18200","빠삐용","2019-03-17","5",58,34344,19
"18201","빠삐용","2019-03-18","4",35,34379,20
"18202","빠삐용","2019-03-19","5",40,34419,21
"18203","빠삐용","2019-03-20","3",26,34445,22
"18204","빠삐용","2019-03-21","2",24,34469,23
"18205","빠삐용","2019-03-22","2",19,34488,24
"18206","빠삐용","2019-03-23","2",31,34519,25
"18207","신밧드와 마법 양탄자","2019-02-12","1",41,41,0
"18208","신밧드와 마법 양탄자","2019-02-13","206",3056,3097,1
"18209","신밧드와 마법 양탄자","2019-02-14","208",3697,6794,2
"18210","신밧드와 마법 양탄자","2019-02-15","222",4446,11240,3
"18211","신밧드와 마법 양탄자","2019-02-16","258",5689,16929,4
"18212","신밧드와 마법 양탄자","2019-02-17","244",5906,22835,5
"18213","신밧드와 마법 양탄자","2019-02-18","193",2237,25072,6
"18214","신밧드와 마법 양탄자","2019-02-19","192",2767,27839,7
"18215","신밧드와 마법 양탄자","2019-02-20","23",1007,28846,8
"18216","신밧드와 마법 양탄자","2019-02-21","14",498,29344,9
"18217","신밧드와 마법 양탄자","2019-02-22","9",272,29616,10
"18218","신밧드와 마법 양탄자","2019-02-23","9",326,29942,11
"18219","신밧드와 마법 양탄자","2019-02-24","7",60,30002,12
"18220","신밧드와 마법 양탄자","2019-02-25","8",131,30133,13
"18221","신밧드와 마법 양탄자","2019-02-26","7",155,30288,14
"18222","신밧드와 마법 양탄자","2019-02-27","1",6,30294,15
"18223","신밧드와 마법 양탄자","2019-03-01","1",6,30300,16
"18224","신밧드와 마법 양탄자","2019-03-02","5",200,30500,17
"18225","신밧드와 마법 양탄자","2019-03-03","1",2,30502,18
"18226","신밧드와 마법 양탄자","2019-03-09","1",8,30510,19
"18227","신밧드와 마법 양탄자","2019-03-16","1",9,30519,20
"18228","신밧드와 마법 양탄자","2019-03-18","1",15,30534,21
"18229","왕이 될 아이","2019-01-12","2",648,648,0
"18230","왕이 될 아이","2019-01-14","3",681,1329,0
"18231","왕이 될 아이","2019-01-16","264",4275,5604,1
"18232","왕이 될 아이","2019-01-17","254",3436,9040,2
"18233","왕이 될 아이","2019-01-18","246",3434,12474,3
"18234","왕이 될 아이","2019-01-19","224",5605,18079,4
"18235","왕이 될 아이","2019-01-20","224",4972,23051,5
"18236","왕이 될 아이","2019-01-21","207",1941,24992,6
"18237","왕이 될 아이","2019-01-22","211",2284,27276,7
"18238","왕이 될 아이","2019-01-23","23",206,27482,8
"18239","왕이 될 아이","2019-01-24","19",204,27686,9
"18240","왕이 될 아이","2019-01-25","21",303,27989,10
"18241","왕이 될 아이","2019-01-26","20",416,28405,11
"18242","왕이 될 아이","2019-01-27","17",262,28667,12
"18243","왕이 될 아이","2019-01-28","17",248,28915,13
"18244","왕이 될 아이","2019-01-29","16",102,29017,14
"18245","왕이 될 아이","2019-01-30","2",32,29049,15
"18246","왕이 될 아이","2019-01-31","2",14,29063,16
"18247","왕이 될 아이","2019-02-01","2",16,29079,17
"18248","왕이 될 아이","2019-02-02","2",43,29122,18
"18249","왕이 될 아이","2019-02-03","2",42,29164,19
"18250","왕이 될 아이","2019-02-04","2",34,29198,20
"18251","왕이 될 아이","2019-02-05","2",13,29211,21
"18252","왕이 될 아이","2019-02-06","2",25,29236,22
"18253","콜드 워","2019-01-25","1",149,149,0
"18254","콜드 워","2019-02-02","9",592,741,0
"18255","콜드 워","2019-02-07","65",2409,3150,1
"18256","콜드 워","2019-02-08","57",1658,4808,2
"18257","콜드 워","2019-02-09","60",2889,7697,3
"18258","콜드 워","2019-02-10","58",2391,10088,4
"18259","콜드 워","2019-02-11","47",1196,11284,5
"18260","콜드 워","2019-02-12","55",1270,12554,6
"18261","콜드 워","2019-02-13","52",1344,13898,7
"18262","콜드 워","2019-02-14","47",868,14766,8
"18263","콜드 워","2019-02-15","48",783,15549,9
"18264","콜드 워","2019-02-16","47",1594,17143,10
"18265","콜드 워","2019-02-17","50",1392,18535,11
"18266","콜드 워","2019-02-18","44",735,19270,12
"18267","콜드 워","2019-02-19","45",743,20013,13
"18268","콜드 워","2019-02-20","52",786,20799,14
"18269","콜드 워","2019-02-21","26",329,21128,15
"18270","콜드 워","2019-02-22","26",358,21486,16
"18271","콜드 워","2019-02-23","31",573,22059,17
"18272","콜드 워","2019-02-24","29",530,22589,18
"18273","콜드 워","2019-02-25","23",300,22889,19
"18274","콜드 워","2019-02-26","23",364,23253,20
"18275","콜드 워","2019-02-27","24",362,23615,21
"18276","콜드 워","2019-02-28","18",234,23849,22
"18277","콜드 워","2019-03-01","18",400,24249,23
"18278","콜드 워","2019-03-02","16",382,24631,24
"18279","콜드 워","2019-03-03","18",409,25040,25
"18280","콜드 워","2019-03-04","13",164,25204,26
"18281","콜드 워","2019-03-05","10",152,25356,27
"18282","콜드 워","2019-03-06","15",149,25505,28
"18283","콜드 워","2019-03-07","7",92,25597,29
"18284","콜드 워","2019-03-08","11",183,25780,30
"18285","콜드 워","2019-03-09","6",162,25942,31
"18286","콜드 워","2019-03-10","9",231,26173,32
"18287","콜드 워","2019-03-11","9",67,26240,33
"18288","콜드 워","2019-03-12","6",59,26299,34
"18289","콜드 워","2019-03-13","10",142,26441,35
"18290","콜드 워","2019-03-15","3",43,26484,36
"18291","콜드 워","2019-03-16","3",46,26530,37
"18292","콜드 워","2019-03-17","2",34,26564,38
"18293","콜드 워","2019-03-18","1",9,26573,39
"18294","콜드 워","2019-03-19","2",12,26585,40
"18295","콜드 워","2019-03-20","5",90,26675,41
"18296","콜드 워","2019-03-21","1",13,26688,42
"18297","콜드 워","2019-03-22","1",8,26696,43
"18298","콜드 워","2019-03-23","1",21,26717,44
"18299","극장판 포켓몬스터 모두의 이야기","2018-12-06","3",572,572,0
"18300","극장판 포켓몬스터 모두의 이야기","2018-12-14","4",1054,1626,0
"18301","극장판 포켓몬스터 모두의 이야기","2018-12-19","335",6992,8618,1
"18302","극장판 포켓몬스터 모두의 이야기","2018-12-20","324",3871,12489,2
"18303","극장판 포켓몬스터 모두의 이야기","2018-12-21","312",3625,16114,3
"18304","극장판 포켓몬스터 모두의 이야기","2018-12-22","465",35976,52090,4
"18305","극장판 포켓몬스터 모두의 이야기","2018-12-23","493",34907,86997,5
"18306","극장판 포켓몬스터 모두의 이야기","2018-12-24","420",8882,95879,6
"18307","극장판 포켓몬스터 모두의 이야기","2018-12-25","386",42160,138039,7
"18308","극장판 포켓몬스터 모두의 이야기","2018-12-26","129",2556,140595,8
"18309","극장판 포켓몬스터 모두의 이야기","2018-12-27","114",2406,143001,9
"18310","극장판 포켓몬스터 모두의 이야기","2018-12-28","113",2387,145388,10
"18311","극장판 포켓몬스터 모두의 이야기","2018-12-29","183",9551,154939,11
"18312","극장판 포켓몬스터 모두의 이야기","2018-12-30","188",8675,163614,12
"18313","극장판 포켓몬스터 모두의 이야기","2018-12-31","158",6063,169677,13
"18314","극장판 포켓몬스터 모두의 이야기","2019-01-01","162",9214,178891,14
"18315","극장판 포켓몬스터 모두의 이야기","2019-01-02","131",3347,182238,15
"18316","극장판 포켓몬스터 모두의 이야기","2019-01-03","48",1010,183248,16
"18317","극장판 포켓몬스터 모두의 이야기","2019-01-04","45",775,184023,17
"18318","극장판 포켓몬스터 모두의 이야기","2019-01-05","52",1415,185438,18
"18319","극장판 포켓몬스터 모두의 이야기","2019-01-06","52",1539,186977,19
"18320","극장판 포켓몬스터 모두의 이야기","2019-01-07","43",517,187494,20
"18321","극장판 포켓몬스터 모두의 이야기","2019-01-08","41",535,188029,21
"18322","극장판 포켓몬스터 모두의 이야기","2019-01-09","16",180,188209,22
"18323","극장판 포켓몬스터 모두의 이야기","2019-01-10","10",218,188427,23
"18324","극장판 포켓몬스터 모두의 이야기","2019-01-11","12",122,188549,24
"18325","극장판 포켓몬스터 모두의 이야기","2019-01-12","28",3048,191597,25
"18326","극장판 포켓몬스터 모두의 이야기","2019-01-13","28",2837,194434,26
"18327","극장판 포켓몬스터 모두의 이야기","2019-01-14","22",137,194571,27
"18328","극장판 포켓몬스터 모두의 이야기","2019-01-15","10",86,194657,28
"18329","극장판 포켓몬스터 모두의 이야기","2019-01-16","1",2,194659,29
"18330","극장판 포켓몬스터 모두의 이야기","2019-01-17","1",3,194662,30
"18331","극장판 포켓몬스터 모두의 이야기","2019-01-18","1",1,194663,31
"18332","극장판 포켓몬스터 모두의 이야기","2019-01-19","1",8,194671,32
"18333","극장판 포켓몬스터 모두의 이야기","2019-01-20","1",6,194677,33
"18334","극장판 포켓몬스터 모두의 이야기","2019-01-21","1",3,194680,34
"18335","극장판 포켓몬스터 모두의 이야기","2019-01-25","1",2,194682,35
"18336","극장판 포켓몬스터 모두의 이야기","2019-01-26","1",1,194683,36
"18337","극장판 포켓몬스터 모두의 이야기","2019-01-27","1",5,194688,37
"18338","극장판 포켓몬스터 모두의 이야기","2019-01-28","1",2,194690,38
"18339","극장판 포켓몬스터 모두의 이야기","2019-01-30","1",2,194692,39
"18340","모험왕 블링키","2019-02-13","1",247,247,0
"18341","모험왕 블링키","2019-02-14","2",426,673,0
"18342","모험왕 블링키","2019-02-18","2",200,873,0
"18343","모험왕 블링키","2019-02-19","6",932,1805,0
"18344","모험왕 블링키","2019-02-20","211",3049,4854,1
"18345","모험왕 블링키","2019-02-21","219",2896,7750,2
"18346","모험왕 블링키","2019-02-22","226",3150,10900,3
"18347","모험왕 블링키","2019-02-23","221",3616,14516,4
"18348","모험왕 블링키","2019-02-24","222",3565,18081,5
"18349","모험왕 블링키","2019-02-25","198",2535,20616,6
"18350","모험왕 블링키","2019-02-26","216",3030,23646,7
"18351","모험왕 블링키","2019-02-27","18",236,23882,8
"18352","모험왕 블링키","2019-02-28","16",137,24019,9
"18353","모험왕 블링키","2019-03-01","20",261,24280,10
"18354","모험왕 블링키","2019-03-02","20",259,24539,11
"18355","모험왕 블링키","2019-03-03","20",183,24722,12
"18356","모험왕 블링키","2019-03-04","7",19,24741,13
"18357","모험왕 블링키","2019-03-05","2",3,24744,14
"18358","모험왕 블링키","2019-03-06","1",9,24753,15
"18359","모험왕 블링키","2019-03-07","1",5,24758,16
"18360","모험왕 블링키","2019-03-08","1",2,24760,17
"18361","모험왕 블링키","2019-03-09","1",10,24770,18
"18362","모험왕 블링키","2019-03-10","1",14,24784,19
"18363","모험왕 블링키","2019-03-13","1",3,24787,20
"18364","러브라이브! 선샤인!! 더 스쿨 아이돌 무비 오버 더 레인보우","2019-01-31","5",1822,1822,0
"18365","러브라이브! 선샤인!! 더 스쿨 아이돌 무비 오버 더 레인보우","2019-02-14","65",3249,5071,1
"18366","러브라이브! 선샤인!! 더 스쿨 아이돌 무비 오버 더 레인보우","2019-02-15","65",1011,6082,2
"18367","러브라이브! 선샤인!! 더 스쿨 아이돌 무비 오버 더 레인보우","2019-02-16","66",1623,7705,3
"18368","러브라이브! 선샤인!! 더 스쿨 아이돌 무비 오버 더 레인보우","2019-02-17","65",1190,8895,4
"18369","러브라이브! 선샤인!! 더 스쿨 아이돌 무비 오버 더 레인보우","2019-02-18","60",360,9255,5
"18370","러브라이브! 선샤인!! 더 스쿨 아이돌 무비 오버 더 레인보우","2019-02-19","59",368,9623,6
"18371","러브라이브! 선샤인!! 더 스쿨 아이돌 무비 오버 더 레인보우","2019-02-20","38",275,9898,7
"18372","러브라이브! 선샤인!! 더 스쿨 아이돌 무비 오버 더 레인보우","2019-02-21","43",1521,11419,8
"18373","러브라이브! 선샤인!! 더 스쿨 아이돌 무비 오버 더 레인보우","2019-02-22","44",644,12063,9
"18374","러브라이브! 선샤인!! 더 스쿨 아이돌 무비 오버 더 레인보우","2019-02-23","49",1030,13093,10
"18375","러브라이브! 선샤인!! 더 스쿨 아이돌 무비 오버 더 레인보우","2019-02-24","46",752,13845,11
"18376","러브라이브! 선샤인!! 더 스쿨 아이돌 무비 오버 더 레인보우","2019-02-25","36",266,14111,12
"18377","러브라이브! 선샤인!! 더 스쿨 아이돌 무비 오버 더 레인보우","2019-02-26","35",226,14337,13
"18378","러브라이브! 선샤인!! 더 스쿨 아이돌 무비 오버 더 레인보우","2019-02-27","23",193,14530,14
"18379","러브라이브! 선샤인!! 더 스쿨 아이돌 무비 오버 더 레인보우","2019-02-28","27",1355,15885,15
"18380","러브라이브! 선샤인!! 더 스쿨 아이돌 무비 오버 더 레인보우","2019-03-01","30",875,16760,16
"18381","러브라이브! 선샤인!! 더 스쿨 아이돌 무비 오버 더 레인보우","2019-03-02","35",644,17404,17
"18382","러브라이브! 선샤인!! 더 스쿨 아이돌 무비 오버 더 레인보우","2019-03-03","31",403,17807,18
"18383","러브라이브! 선샤인!! 더 스쿨 아이돌 무비 오버 더 레인보우","2019-03-04","18",97,17904,19
"18384","러브라이브! 선샤인!! 더 스쿨 아이돌 무비 오버 더 레인보우","2019-03-05","17",82,17986,20
"18385","러브라이브! 선샤인!! 더 스쿨 아이돌 무비 오버 더 레인보우","2019-03-06","6",57,18043,21
"18386","러브라이브! 선샤인!! 더 스쿨 아이돌 무비 오버 더 레인보우","2019-03-07","16",790,18833,22
"18387","러브라이브! 선샤인!! 더 스쿨 아이돌 무비 오버 더 레인보우","2019-03-08","7",217,19050,23
"18388","러브라이브! 선샤인!! 더 스쿨 아이돌 무비 오버 더 레인보우","2019-03-09","22",663,19713,24
"18389","러브라이브! 선샤인!! 더 스쿨 아이돌 무비 오버 더 레인보우","2019-03-10","21",486,20199,25
"18390","러브라이브! 선샤인!! 더 스쿨 아이돌 무비 오버 더 레인보우","2019-03-11","4",53,20252,26
"18391","러브라이브! 선샤인!! 더 스쿨 아이돌 무비 오버 더 레인보우","2019-03-12","4",45,20297,27
"18392","러브라이브! 선샤인!! 더 스쿨 아이돌 무비 오버 더 레인보우","2019-03-13","5",64,20361,28
"18393","러브라이브! 선샤인!! 더 스쿨 아이돌 무비 오버 더 레인보우","2019-03-14","18",1647,22008,29
"18394","러브라이브! 선샤인!! 더 스쿨 아이돌 무비 오버 더 레인보우","2019-03-15","8",277,22285,30
"18395","러브라이브! 선샤인!! 더 스쿨 아이돌 무비 오버 더 레인보우","2019-03-16","17",506,22791,31
"18396","러브라이브! 선샤인!! 더 스쿨 아이돌 무비 오버 더 레인보우","2019-03-17","16",219,23010,32
"18397","러브라이브! 선샤인!! 더 스쿨 아이돌 무비 오버 더 레인보우","2019-03-18","6",26,23036,33
"18398","러브라이브! 선샤인!! 더 스쿨 아이돌 무비 오버 더 레인보우","2019-03-19","6",31,23067,34
"18399","러브라이브! 선샤인!! 더 스쿨 아이돌 무비 오버 더 레인보우","2019-03-20","4",16,23083,35
"18400","러브라이브! 선샤인!! 더 스쿨 아이돌 무비 오버 더 레인보우","2019-03-21","14",552,23635,36
"18401","러브라이브! 선샤인!! 더 스쿨 아이돌 무비 오버 더 레인보우","2019-03-22","10",241,23876,37
"18402","러브라이브! 선샤인!! 더 스쿨 아이돌 무비 오버 더 레인보우","2019-03-23","18",468,24344,38
"18467","드래곤 길들이기","2010-04-26","4",448,448,0
"18468","드래곤 길들이기","2010-05-03","8",1120,1568,0
"18469","드래곤 길들이기","2010-05-05","112",60604,62172,0
"18470","드래곤 길들이기","2010-05-06","1",182,62354,0
"18471","드래곤 길들이기","2010-05-07","4",723,63077,0
"18472","드래곤 길들이기","2010-05-10","2",162,63239,0
"18473","드래곤 길들이기","2010-05-11","4",348,63587,0
"18474","드래곤 길들이기","2010-05-12","1",0,63587,0
"18475","드래곤 길들이기","2010-05-14","2",136,63723,0
"18476","드래곤 길들이기","2010-05-17","1",88,63811,0
"18477","드래곤 길들이기","2010-05-19","1",5,63816,0
"18478","드래곤 길들이기","2010-05-20","521",51928,115744,1
"18479","드래곤 길들이기","2010-05-21","560",279373,395117,2
"18480","드래곤 길들이기","2010-05-22","558",261768,656885,3
"18481","드래곤 길들이기","2010-05-23","563",250797,907682,4
"18482","드래곤 길들이기","2010-05-24","505",31639,939321,5
"18483","드래곤 길들이기","2010-05-25","500",29120,968441,6
"18484","드래곤 길들이기","2010-05-26","506",35402,1003843,7
"18485","드래곤 길들이기","2010-05-27","367",22886,1026729,8
"18486","드래곤 길들이기","2010-05-28","376",34747,1061476,9
"18487","드래곤 길들이기","2010-05-29","434",147421,1208897,10
"18488","드래곤 길들이기","2010-05-30","436",201288,1410185,11
"18489","드래곤 길들이기","2010-05-31","365",25455,1435640,12
"18490","드래곤 길들이기","2010-06-01","380",42691,1478331,13
"18491","드래곤 길들이기","2010-06-02","386",226647,1704978,14
"18492","드래곤 길들이기","2010-06-03","276",17762,1722740,15
"18493","드래곤 길들이기","2010-06-04","286",27847,1750587,16
"18494","드래곤 길들이기","2010-06-05","384",118698,1869285,17
"18495","드래곤 길들이기","2010-06-06","387",155597,2024882,18
"18496","드래곤 길들이기","2010-06-07","274",20883,2045765,19
"18497","드래곤 길들이기","2010-06-08","274",17342,2063107,20
"18498","드래곤 길들이기","2010-06-09","275",20811,2083918,21
"18499","드래곤 길들이기","2010-06-10","231",14439,2098357,22
"18500","드래곤 길들이기","2010-06-11","236",22974,2121331,23
"18501","드래곤 길들이기","2010-06-12","310",83508,2204839,24
"18502","드래곤 길들이기","2010-06-13","301",81556,2286395,25
"18503","드래곤 길들이기","2010-06-14","228",13503,2299898,26
"18504","드래곤 길들이기","2010-06-15","226",12326,2312224,27
"18505","드래곤 길들이기","2010-06-16","163",8505,2320729,28
"18506","드래곤 길들이기","2010-06-17","160",4034,2324763,29
"18507","드래곤 길들이기","2010-06-18","174",11999,2336762,30
"18508","드래곤 길들이기","2010-06-19","230",43982,2380744,31
"18509","드래곤 길들이기","2010-06-20","228",54834,2435578,32
"18510","드래곤 길들이기","2010-06-21","171",8963,2444541,33
"18511","드래곤 길들이기","2010-06-22","168",7728,2452269,34
"18512","드래곤 길들이기","2010-06-23","155",7106,2459375,35
"18513","드래곤 길들이기","2010-06-24","95",5104,2464479,36
"18514","드래곤 길들이기","2010-06-25","105",8106,2472585,37
"18515","드래곤 길들이기","2010-06-26","143",30333,2502918,38
"18516","드래곤 길들이기","2010-06-27","142",29212,2532130,39
"18517","드래곤 길들이기","2010-06-28","95",5537,2537667,40
"18518","드래곤 길들이기","2010-06-29","97",5448,2543115,41
"18519","드래곤 길들이기","2010-06-30","102",7004,2550119,42
"18520","드래곤 길들이기","2010-07-01","3",543,2550662,43
"18521","드래곤 길들이기","2010-07-02","3",493,2551155,44
"18522","드래곤 길들이기","2010-07-03","3",271,2551426,45
"18523","드래곤 길들이기","2010-07-04","2",366,2551792,46
"18524","드래곤 길들이기","2010-07-06","1",32,2551824,47
"18525","드래곤 길들이기","2010-07-10","2",436,2552260,48
"18526","드래곤 길들이기","2010-07-11","2",442,2552702,49
"18527","드래곤 길들이기","2010-07-15","1",88,2552790,50
"18528","드래곤 길들이기","2010-07-16","1",6,2552796,51
"18529","드래곤 길들이기","2010-07-17","3",234,2553030,52
"18530","드래곤 길들이기","2010-07-18","3",387,2553417,53
"18531","드래곤 길들이기","2010-07-20","1",65,2553482,54
"18532","드래곤 길들이기","2010-07-21","2",331,2553813,55
"18533","드래곤 길들이기","2010-07-22","2",249,2554062,56
"18534","드래곤 길들이기","2010-07-23","2",369,2554431,57
"18535","드래곤 길들이기","2010-07-24","2",781,2555212,58
"18536","드래곤 길들이기","2010-07-25","2",715,2555927,59
"18537","드래곤 길들이기","2010-07-26","1",374,2556301,60
"18538","드래곤 길들이기","2010-07-27","2",433,2556734,61
"18539","드래곤 길들이기","2010-07-28","1",86,2556820,62
"18540","드래곤 길들이기","2010-07-29","1",74,2556894,63
"18541","드래곤 길들이기","2010-07-30","1",106,2557000,64
"18542","드래곤 길들이기","2010-07-31","1",215,2557215,65
"18543","드래곤 길들이기","2010-08-01","1",128,2557343,66
"18544","드래곤 길들이기","2010-08-03","1",199,2557542,67
"18545","드래곤 길들이기","2010-08-04","1",167,2557709,68
"18546","드래곤 길들이기","2010-08-05","1",97,2557806,69
"18547","드래곤 길들이기","2010-08-06","1",126,2557932,70
"18548","드래곤 길들이기","2010-08-07","1",242,2558174,71
"18549","드래곤 길들이기","2010-08-08","1",126,2558300,72
"18550","드래곤 길들이기","2010-08-10","1",29,2558329,73
"18551","드래곤 길들이기","2010-08-11","1",43,2558372,74
"18552","드래곤 길들이기","2010-08-12","1",29,2558401,75
"18553","드래곤 길들이기","2010-08-13","1",67,2558468,76
"18554","드래곤 길들이기","2010-08-14","1",168,2558636,77
"18555","드래곤 길들이기","2010-08-15","1",170,2558806,78
"18556","드래곤 길들이기","2010-08-17","1",90,2558896,79
"18557","드래곤 길들이기","2010-08-18","1",38,2558934,80
"18558","드래곤 길들이기","2010-08-19","1",62,2558996,81
"18559","드래곤 길들이기","2010-09-07","1",200,2559196,82
"18560","드래곤 길들이기","2010-09-27","1",407,2559603,83
"18561","드래곤 길들이기","2010-10-09","2",93,2559696,84
"18562","드래곤 길들이기","2010-10-10","2",145,2559841,85
"18563","드래곤 길들이기","2010-10-11","2",27,2559868,86
"18564","드래곤 길들이기","2010-10-12","2",73,2559941,87
"18565","드래곤 길들이기","2010-10-13","4",53,2559994,88
"18566","드래곤 길들이기","2010-10-14","4",72,2560066,89
"18567","드래곤 길들이기","2010-10-15","3",64,2560130,90
"18568","드래곤 길들이기","2010-10-16","2",161,2560291,91
"18569","드래곤 길들이기","2010-10-17","2",207,2560498,92
"18570","드래곤 길들이기","2010-10-18","2",57,2560555,93
"18571","드래곤 길들이기","2010-10-19","2",37,2560592,94
"18572","드래곤 길들이기","2010-10-20","2",48,2560640,95
"18573","드래곤 길들이기","2010-10-21","1",32,2560672,96
"18574","드래곤 길들이기","2010-10-22","1",29,2560701,97
"18575","드래곤 길들이기","2010-10-23","1",133,2560834,98
"18576","드래곤 길들이기","2010-10-24","1",194,2561028,99
"18577","드래곤 길들이기","2010-10-25","1",19,2561047,100
"18578","드래곤 길들이기","2010-10-26","1",41,2561088,101
"18579","드래곤 길들이기","2010-10-27","1",56,2561144,102
"18580","드래곤 길들이기","2010-10-29","1",49,2561193,103
"18581","드래곤 길들이기","2010-10-30","1",171,2561364,104
"18582","드래곤 길들이기","2010-10-31","1",202,2561566,105
"18583","드래곤 길들이기","2010-11-06","1",115,2561681,106
"18584","드래곤 길들이기","2010-11-07","1",134,2561815,107
"18585","드래곤 길들이기","2010-11-08","1",39,2561854,108
"18586","드래곤 길들이기","2010-11-09","1",81,2561935,109
"18587","드래곤 길들이기","2010-11-30","1",16,2561951,110
"18588","드래곤 길들이기","2010-12-02","1",35,2561986,111
"18589","드래곤 길들이기","2010-12-03","1",74,2562060,112
"18590","드래곤 길들이기","2010-12-15","1",352,2562412,113
"18591","드래곤 길들이기","2011-04-09","12",1494,2563906,114
"18592","드래곤 길들이기","2011-04-10","10",1532,2565438,115
"18593","드래곤 길들이기","2011-12-01","2",6,2565444,116
"18594","드래곤 길들이기","2011-12-02","4",48,2565492,117
"18595","드래곤 길들이기","2011-12-03","6",63,2565555,118
"18596","드래곤 길들이기","2011-12-04","4",92,2565647,119
"18597","드래곤 길들이기","2011-12-05","4",49,2565696,120
"18598","드래곤 길들이기","2011-12-06","2",0,2565696,121
"18599","드래곤 길들이기","2014-07-12","7",465,2566161,122
"18600","드래곤 길들이기","2014-07-13","7",620,2566781,123
"18601","드래곤 길들이기","2014-07-14","4",28,2566809,124
"18602","드래곤 길들이기","2014-07-15","5",46,2566855,125
"18603","드래곤 길들이기","2014-07-16","4",64,2566919,126
"18604","드래곤 길들이기","2014-07-17","10",131,2567050,127
"18605","드래곤 길들이기","2014-07-18","10",201,2567251,128
"18606","드래곤 길들이기","2014-07-19","12",1133,2568384,129
"18607","드래곤 길들이기","2014-07-20","12",1446,2569830,130
"18608","드래곤 길들이기","2014-07-21","9",187,2570017,131
"18609","드래곤 길들이기","2014-07-22","9",156,2570173,132
"18610","드래곤 길들이기","2014-07-23","1",4,2570177,133
"18611","드래곤 길들이기","2014-07-24","1",15,2570192,134
"18612","드래곤 길들이기","2014-07-25","1",46,2570238,135
"18613","드래곤 길들이기","2014-07-26","1",104,2570342,136
"18614","드래곤 길들이기","2014-07-27","1",69,2570411,137
"18615","드래곤 길들이기","2014-07-28","2",167,2570578,138
"18616","드래곤 길들이기","2014-07-29","1",165,2570743,139
"18617","드래곤 길들이기","2014-07-31","1",25,2570768,140
"18618","드래곤 길들이기","2014-08-02","1",266,2571034,141
"18619","드래곤 길들이기","2014-08-03","2",457,2571491,142
"18620","드래곤 길들이기","2014-08-04","2",191,2571682,143
"18621","드래곤 길들이기","2014-08-05","1",132,2571814,144
"18622","드래곤 길들이기","2019-01-15","16",955,2572769,145
"18623","드래곤 길들이기","2019-01-17","33",3157,2575926,146
"18624","드래곤 길들이기","2019-01-18","33",2564,2578490,147
"18625","드래곤 길들이기","2019-01-19","33",5008,2583498,148
"18626","드래곤 길들이기","2019-01-20","33",4175,2587673,149
"18627","드래곤 길들이기","2019-01-21","33",1246,2588919,150
"18628","드래곤 길들이기","2019-01-22","33",1160,2590079,151
"18629","드래곤 길들이기","2019-01-23","23",634,2590713,152
"18630","드래곤 길들이기","2019-01-24","20",630,2591343,153
"18631","드래곤 길들이기","2019-01-25","16",536,2591879,154
"18632","드래곤 길들이기","2019-01-26","13",660,2592539,155
"18633","드래곤 길들이기","2019-01-27","13",708,2593247,156
"18634","드래곤 길들이기","2019-01-28","14",306,2593553,157
"18635","드래곤 길들이기","2019-01-29","14",301,2593854,158
"18636","드래곤 길들이기","2019-02-21","1",0,2593854,159
"18637","로마","2018-12-10","1",451,451,0
"18638","로마","2018-12-12","28",1114,1565,1
"18639","로마","2018-12-13","32",1128,2693,2
"18640","로마","2018-12-14","27",933,3626,3
"18641","로마","2018-12-15","30",1780,5406,4
"18642","로마","2018-12-16","29",1649,7055,5
"18643","로마","2018-12-17","25",852,7907,6
"18644","로마","2018-12-18","31",1022,8929,7
"18645","로마","2018-12-19","17",633,9562,8
"18646","로마","2018-12-20","17",673,10235,9
"18647","로마","2018-12-21","17",783,11018,10
"18648","로마","2018-12-22","20",1326,12344,11
"18649","로마","2018-12-23","21",1391,13735,12
"18650","로마","2018-12-24","20",1204,14939,13
"18651","로마","2018-12-25","18",1881,16820,14
"18652","로마","2018-12-26","14",613,17433,15
"18653","로마","2018-12-27","15",465,17898,16
"18654","로마","2018-12-28","19",560,18458,17
"18655","로마","2018-12-29","20",1053,19511,18
"18656","로마","2018-12-30","17",1017,20528,19
"18657","로마","2018-12-31","14",873,21401,20
"18658","로마","2019-01-01","17",1219,22620,21
"18659","로마","2019-01-02","17",569,23189,22
"18660","로마","2019-01-03","14",387,23576,23
"18661","로마","2019-01-04","20",758,24334,24
"18662","로마","2019-01-05","17",984,25318,25
"18663","로마","2019-01-06","18",1055,26373,26
"18664","로마","2019-01-07","15",399,26772,27
"18665","로마","2019-01-08","13",432,27204,28
"18666","로마","2019-01-09","11",355,27559,29
"18667","로마","2019-01-10","13",329,27888,30
"18668","로마","2019-01-11","13",481,28369,31
"18669","로마","2019-01-12","17",784,29153,32
"18670","로마","2019-01-13","17",646,29799,33
"18671","로마","2019-01-14","12",216,30015,34
"18672","로마","2019-01-15","13",280,30295,35
"18673","로마","2019-01-16","15",430,30725,36
"18674","로마","2019-01-17","9",228,30953,37
"18675","로마","2019-01-18","12",254,31207,38
"18676","로마","2019-01-19","13",558,31765,39
"18677","로마","2019-01-20","16",567,32332,40
"18678","로마","2019-01-21","8",162,32494,41
"18679","로마","2019-01-22","9",183,32677,42
"18680","로마","2019-01-23","13",396,33073,43
"18681","로마","2019-01-24","7",178,33251,44
"18682","로마","2019-01-25","7",201,33452,45
"18683","로마","2019-01-26","11",480,33932,46
"18684","로마","2019-01-27","11",336,34268,47
"18685","로마","2019-01-28","7",187,34455,48
"18686","로마","2019-01-29","7",155,34610,49
"18687","로마","2019-01-30","8",320,34930,50
"18688","로마","2019-01-31","6",147,35077,51
"18689","로마","2019-02-01","8",203,35280,52
"18690","로마","2019-02-02","12",271,35551,53
"18691","로마","2019-02-03","10",336,35887,54
"18692","로마","2019-02-04","10",210,36097,55
"18693","로마","2019-02-05","7",214,36311,56
"18694","로마","2019-02-06","11",301,36612,57
"18695","로마","2019-02-07","6",103,36715,58
"18696","로마","2019-02-08","8",159,36874,59
"18697","로마","2019-02-09","7",216,37090,60
"18698","로마","2019-02-10","9",323,37413,61
"18699","로마","2019-02-11","5",106,37519,62
"18700","로마","2019-02-12","7",138,37657,63
"18701","로마","2019-02-13","7",81,37738,64
"18702","로마","2019-02-14","5",71,37809,65
"18703","로마","2019-02-15","5",58,37867,66
"18704","로마","2019-02-16","7",221,38088,67
"18705","로마","2019-02-17","4",104,38192,68
"18706","로마","2019-02-18","6",78,38270,69
"18707","로마","2019-02-19","6",145,38415,70
"18708","로마","2019-02-20","9",100,38515,71
"18709","로마","2019-02-21","4",39,38554,72
"18710","로마","2019-02-22","5",116,38670,73
"18711","로마","2019-02-23","7",130,38800,74
"18712","로마","2019-02-24","8",117,38917,75
"18713","로마","2019-02-25","7",149,39066,76
"18714","로마","2019-02-26","8",229,39295,77
"18715","로마","2019-02-27","5",123,39418,78
"18716","로마","2019-02-28","5",185,39603,79
"18717","로마","2019-03-01","7",277,39880,80
"18718","로마","2019-03-02","8",265,40145,81
"18719","로마","2019-03-03","6",196,40341,82
"18720","로마","2019-03-04","4",58,40399,83
"18721","로마","2019-03-05","6",115,40514,84
"18722","로마","2019-03-06","4",63,40577,85
"18723","로마","2019-03-07","4",97,40674,86
"18724","로마","2019-03-08","5",116,40790,87
"18725","로마","2019-03-09","8",174,40964,88
"18726","로마","2019-03-10","6",91,41055,89
"18727","로마","2019-03-11","6",78,41133,90
"18728","로마","2019-03-12","4",37,41170,91
"18729","로마","2019-03-13","7",129,41299,92
"18730","로마","2019-03-14","1",26,41325,93
"18731","로마","2019-03-15","6",102,41427,94
"18732","로마","2019-03-16","8",272,41699,95
"18733","로마","2019-03-17","8",176,41875,96
"18734","로마","2019-03-18","3",34,41909,97
"18735","로마","2019-03-19","5",118,42027,98
"18736","로마","2019-03-20","3",74,42101,99
"18737","로마","2019-03-21","3",188,42289,100
"18738","로마","2019-03-22","4",57,42346,101
"18739","로마","2019-03-23","2",53,42399,102
"18740","숲속왕국의 꿀벌 여왕","2019-02-21","2",509,509,0
"18741","숲속왕국의 꿀벌 여왕","2019-03-14","135",461,970,1
"18742","숲속왕국의 꿀벌 여왕","2019-03-15","156",668,1638,2
"18743","숲속왕국의 꿀벌 여왕","2019-03-16","372",8576,10214,3
"18744","숲속왕국의 꿀벌 여왕","2019-03-17","369",8092,18306,4
"18745","숲속왕국의 꿀벌 여왕","2019-03-18","119",505,18811,5
"18746","숲속왕국의 꿀벌 여왕","2019-03-19","112",460,19271,6
"18747","숲속왕국의 꿀벌 여왕","2019-03-20","70",562,19833,7
"18748","숲속왕국의 꿀벌 여왕","2019-03-21","10",151,19984,8
"18749","숲속왕국의 꿀벌 여왕","2019-03-22","9",248,20232,9
"18750","숲속왕국의 꿀벌 여왕","2019-03-23","25",418,20650,10
"18751","리노","2019-02-28","1",186,186,0
"18752","리노","2019-03-06","2",201,387,0
"18753","리노","2019-03-07","93",303,690,1
"18754","리노","2019-03-08","118",380,1070,2
"18755","리노","2019-03-09","322",6960,8030,3
"18756","리노","2019-03-10","320",8459,16489,4
"18757","리노","2019-03-11","83",233,16722,5
"18758","리노","2019-03-12","80",245,16967,6
"18759","리노","2019-03-13","96",261,17228,7
"18760","리노","2019-03-14","17",77,17305,8
"18761","리노","2019-03-15","17",114,17419,9
"18762","리노","2019-03-16","60",1066,18485,10
"18763","리노","2019-03-17","63",941,19426,11
"18764","리노","2019-03-18","7",15,19441,12
"18765","리노","2019-03-19","9",75,19516,13
"18766","리노","2019-03-20","10",306,19822,14
"18767","리노","2019-03-21","3",41,19863,15
"18768","리노","2019-03-22","5",136,19999,16
"18769","리노","2019-03-23","13",235,20234,17
"18770","철벽선생","2019-03-04","1",126,126,0
"18771","철벽선생","2019-03-07","3",651,777,0
"18772","철벽선생","2019-03-12","9",624,1401,0
"18773","철벽선생","2019-03-14","175",3689,5090,1
"18774","철벽선생","2019-03-15","170",3000,8090,2
"18775","철벽선생","2019-03-16","182",4440,12530,3
"18776","철벽선생","2019-03-17","182",3759,16289,4
"18777","철벽선생","2019-03-18","158",1352,17641,5
"18778","철벽선생","2019-03-19","164",1330,18971,6
"18779","철벽선생","2019-03-20","39",218,19189,7
"18780","철벽선생","2019-03-21","25",133,19322,8
"18781","철벽선생","2019-03-22","22",149,19471,9
"18782","철벽선생","2019-03-23","25",289,19760,10
"18783","레토","2018-12-07","1",35,35,0
"18784","레토","2018-12-09","1",93,128,0
"18785","레토","2018-12-13","1",126,254,0
"18786","레토","2018-12-16","1",10,264,0
"18787","레토","2018-12-18","3",625,889,0
"18788","레토","2018-12-21","1",59,948,0
"18789","레토","2018-12-24","2",71,1019,0
"18790","레토","2018-12-25","14",526,1545,0
"18791","레토","2018-12-27","2",297,1842,0
"18792","레토","2018-12-28","1",92,1934,0
"18793","레토","2018-12-29","3",94,2028,0
"18794","레토","2018-12-30","1",66,2094,0
"18795","레토","2018-12-31","1",13,2107,0
"18796","레토","2019-01-03","112",1610,3717,1
"18797","레토","2019-01-04","108",1526,5243,2
"18798","레토","2019-01-05","105",2683,7926,3
"18799","레토","2019-01-06","99",2410,10336,4
"18800","레토","2019-01-07","91",1163,11499,5
"18801","레토","2019-01-08","103",1055,12554,6
"18802","레토","2019-01-09","72",682,13236,7
"18803","레토","2019-01-10","59",660,13896,8
"18804","레토","2019-01-11","61",743,14639,9
"18805","레토","2019-01-12","59",928,15567,10
"18806","레토","2019-01-13","61",1302,16869,11
"18807","레토","2019-01-14","53",394,17263,12
"18808","레토","2019-01-15","59",514,17777,13
"18809","레토","2019-01-16","53",534,18311,14
"18810","레토","2019-01-17","25",186,18497,15
"18811","레토","2019-01-18","21",174,18671,16
"18812","레토","2019-01-19","25",327,18998,17
"18813","레토","2019-01-20","24",342,19340,18
"18814","레토","2019-01-21","16",141,19481,19
"18815","레토","2019-01-22","18",162,19643,20
"18816","레토","2019-01-23","16",166,19809,21
"18817","레토","2019-01-24","8",61,19870,22
"18818","레토","2019-01-25","7",124,19994,23
"18819","레토","2019-01-26","11",120,20114,24
"18820","레토","2019-01-27","8",165,20279,25
"18821","레토","2019-01-28","5",35,20314,26
"18822","레토","2019-01-29","5",40,20354,27
"18823","레토","2019-01-30","5",46,20400,28
"18824","레토","2019-01-31","3",33,20433,29
"18825","레토","2019-02-01","5",30,20463,30
"18826","레토","2019-02-02","6",85,20548,31
"18827","레토","2019-02-03","8",112,20660,32
"18828","레토","2019-02-04","5",78,20738,33
"18829","레토","2019-02-06","4",63,20801,34
"18830","레토","2019-02-07","3",21,20822,35
"18831","레토","2019-02-08","2",30,20852,36
"18832","레토","2019-02-09","2",37,20889,37
"18833","레토","2019-02-10","3",62,20951,38
"18834","레토","2019-02-11","2",32,20983,39
"18835","레토","2019-02-13","3",25,21008,40
"18836","레토","2019-02-14","2",8,21016,41
"18837","레토","2019-02-15","1",7,21023,42
"18838","레토","2019-02-16","3",56,21079,43
"18839","레토","2019-02-17","2",28,21107,44
"18840","레토","2019-02-18","3",28,21135,45
"18841","레토","2019-02-20","1",3,21138,46
"18842","레토","2019-02-21","1",2,21140,47
"18843","레토","2019-02-22","1",13,21153,48
"18844","레토","2019-02-23","2",4,21157,49
"18845","레토","2019-02-26","2",80,21237,50
"18846","레토","2019-02-27","2",39,21276,51
"18847","레토","2019-02-28","1",1,21277,52
"18848","레토","2019-03-01","1",6,21283,53
"18849","레토","2019-03-07","1",4,21287,54
"18850","레토","2019-03-10","1",11,21298,55
"18851","레토","2019-03-15","1",7,21305,56
"18852","레토","2019-03-16","1",23,21328,57
"18853","페이트 스테이 나이트 헤븐즈필 제2장 로스트 버터플라이","2019-03-13","2",1332,1332,0
"18854","페이트 스테이 나이트 헤븐즈필 제2장 로스트 버터플라이","2019-03-21","79",5963,7295,1
"18855","페이트 스테이 나이트 헤븐즈필 제2장 로스트 버터플라이","2019-03-22","80",4447,11742,2
"18856","페이트 스테이 나이트 헤븐즈필 제2장 로스트 버터플라이","2019-03-23","90",7306,19048,3
"18857","빌리어네어 보이즈클럽","2019-01-03","1",124,124,0
"18858","빌리어네어 보이즈클럽","2019-01-10","166",4146,4270,1
"18859","빌리어네어 보이즈클럽","2019-01-11","162",2687,6957,2
"18860","빌리어네어 보이즈클럽","2019-01-12","163",3621,10578,3
"18861","빌리어네어 보이즈클럽","2019-01-13","144",2269,12847,4
"18862","빌리어네어 보이즈클럽","2019-01-14","125",1090,13937,5
"18863","빌리어네어 보이즈클럽","2019-01-15","137",1014,14951,6
"18864","빌리어네어 보이즈클럽","2019-01-16","75",489,15440,7
"18865","빌리어네어 보이즈클럽","2019-01-17","49",189,15629,8
"18866","빌리어네어 보이즈클럽","2019-01-18","38",209,15838,9
"18867","빌리어네어 보이즈클럽","2019-01-19","35",197,16035,10
"18868","빌리어네어 보이즈클럽","2019-01-20","30",167,16202,11
"18869","빌리어네어 보이즈클럽","2019-01-21","30",100,16302,12
"18870","빌리어네어 보이즈클럽","2019-01-22","32",142,16444,13
"18871","빌리어네어 보이즈클럽","2019-01-23","2",28,16472,14
"18872","빌리어네어 보이즈클럽","2019-01-24","2",40,16512,15
"18873","빌리어네어 보이즈클럽","2019-01-25","1",12,16524,16
"18874","빌리어네어 보이즈클럽","2019-01-26","1",35,16559,17
"18875","빌리어네어 보이즈클럽","2019-01-27","1",37,16596,18
"18876","빌리어네어 보이즈클럽","2019-01-28","40",438,17034,19
"18877","빌리어네어 보이즈클럽","2019-01-29","7",29,17063,20
"18878","빌리어네어 보이즈클럽","2019-01-30","10",325,17388,21
"18879","빌리어네어 보이즈클럽","2019-01-31","2",2,17390,22
"18880","빌리어네어 보이즈클럽","2019-02-01","2",2,17392,23
"18881","빌리어네어 보이즈클럽","2019-02-02","2",2,17394,24
"18882","빌리어네어 보이즈클럽","2019-02-03","2",2,17396,25
"18883","빌리어네어 보이즈클럽","2019-02-04","2",2,17398,26
"18884","빌리어네어 보이즈클럽","2019-02-05","2",2,17400,27
"18885","빌리어네어 보이즈클럽","2019-02-06","2",2,17402,28
"18886","빌리어네어 보이즈클럽","2019-02-07","2",2,17404,29
"18887","빌리어네어 보이즈클럽","2019-02-08","2",2,17406,30
"18888","빌리어네어 보이즈클럽","2019-02-09","2",2,17408,31
"18889","빌리어네어 보이즈클럽","2019-02-10","2",2,17410,32
"18890","빌리어네어 보이즈클럽","2019-03-20","1",3,17413,33
"18891","아이스","2018-12-11","1",147,147,0
"18892","아이스","2018-12-12","1",147,294,0
"18893","아이스","2018-12-13","2",307,601,0
"18894","아이스","2018-12-20","1",204,805,0
"18895","아이스","2018-12-24","1",5,810,0
"18896","아이스","2018-12-26","1",160,970,0
"18897","아이스","2018-12-27","5",1002,1972,0
"18898","아이스","2018-12-28","2",203,2175,0
"18899","아이스","2018-12-30","1",12,2187,0
"18900","아이스","2019-01-07","2",572,2759,0
"18901","아이스","2019-01-08","3",732,3491,0
"18902","아이스","2019-01-10","2",572,4063,0
"18903","아이스","2019-01-11","1",1,4064,0
"18904","아이스","2019-01-14","1",332,4396,0
"18905","아이스","2019-01-15","2",330,4726,0
"18906","아이스","2019-01-16","1",306,5032,0
"18907","아이스","2019-01-22","8",1775,6807,0
"18908","아이스","2019-01-23","2",475,7282,0
"18909","아이스","2019-01-24","10",1999,9281,0
"18910","아이스","2019-01-25","1",35,9316,0
"18911","아이스","2019-01-26","1",5,9321,0
"18912","아이스","2019-01-28","3",801,10122,0
"18913","아이스","2019-01-29","3",1030,11152,0
"18914","아이스","2019-01-30","5",884,12036,0
"18915","아이스","2019-01-31","4",939,12975,0
"18916","아이스","2019-02-04","2",81,13056,0
"18917","아이스","2019-02-05","1",11,13067,0
"18918","아이스","2019-02-06","1",100,13167,0
"18919","아이스","2019-02-07","110",1157,14324,1
"18920","아이스","2019-02-08","110",856,15180,2
"18921","아이스","2019-02-09","99",1038,16218,3
"18922","아이스","2019-02-10","86",876,17094,4
"18923","아이스","2019-02-11","84",410,17504,5
"18924","아이스","2019-02-12","92",482,17986,6
"18925","아이스","2019-02-13","29",205,18191,7
"18926","아이스","2019-02-14","10",83,18274,8
"18927","아이스","2019-02-15","8",69,18343,9
"18928","아이스","2019-02-16","12",125,18468,10
"18929","아이스","2019-02-17","14",127,18595,11
"18930","아이스","2019-02-18","8",59,18654,12
"18931","아이스","2019-02-19","9",60,18714,13
"18932","아이스","2019-02-20","9",59,18773,14
"18933","아이스","2019-02-21","3",18,18791,15
"18934","아이스","2019-02-22","2",6,18797,16
"18935","아이스","2019-02-23","3",11,18808,17
"18936","아이스","2019-02-24","2",13,18821,18
"18937","아이스","2019-02-25","2",10,18831,19
"18938","아이스","2019-02-26","4",14,18845,20
"18939","아이스","2019-02-27","1",4,18849,21
"18940","아이스","2019-03-01","2",7,18856,22
"18941","아이스","2019-03-02","1",2,18858,23
"18942","아이스","2019-03-03","2",16,18874,24
"18943","아이스","2019-03-06","2",1,18875,25
"18944","아이스","2019-03-08","1",1,18876,26
"18945","아이스","2019-03-10","1",6,18882,27
"18946","크리드2","2019-02-12","3",1189,1189,0
"18947","크리드2","2019-02-21","298",2713,3902,1
"18948","크리드2","2019-02-22","288",2417,6319,2
"18949","크리드2","2019-02-23","273",2768,9087,3
"18950","크리드2","2019-02-24","265",2652,11739,4
"18951","크리드2","2019-02-25","250",1337,13076,5
"18952","크리드2","2019-02-26","249",1463,14539,6
"18953","크리드2","2019-02-27","43",189,14728,7
"18954","크리드2","2019-02-28","9",47,14775,8
"18955","크리드2","2019-03-01","9",74,14849,9
"18956","크리드2","2019-03-02","11",58,14907,10
"18957","크리드2","2019-03-03","10",67,14974,11
"18958","크리드2","2019-03-04","4",18,14992,12
"18959","크리드2","2019-03-05","5",18,15010,13
"18960","크리드2","2019-03-06","1",6,15016,14
"18961","크리드2","2019-03-08","1",2,15018,15
"18962","크리드2","2019-03-10","1",3,15021,16
"18963","크리드2","2019-03-12","1",2,15023,17
